COG,commune,population,subvention_commune,subvention_EPCI_distributed,total_subventions,total_subventions_parHab
13055,Marseille,877215,83244200,24655468,107899668,123
69123,Lyon,520774,74438615,37655756,112094371,215.2
31555,Toulouse,511684,39755903,12509662,52265565,102.1
6088,Nice,353701,25889909,6963637,32853546,92.9
44109,Nantes,325070,57668830,14146864,71815694,220.9
34172,Montpellier,307101,11542352,24348622,35890974,116.9
67482,Strasbourg,291709,44589001,113322935,157911936,541.3
33063,Bordeaux,265328,44503965,6783221,51287186,193.3
59350,Lille,238695,24826931,3952749,28779680,120.6
75115,Paris 15e,228754,33536292,0,33536292,146.6
35238,Rennes,227830,39506204,11674971,51181175,224.6
75120,Paris 20e,187694,27516724,0,27516724,146.6
75118,Paris 18e,185825,27242721,0,27242721,146.6
83137,Toulon,180834,5775447,7792798,13568245,75
51454,Reims,178478,18352284,3171899,21524183,120.6
75119,Paris 19e,178371,26149934,0,26149934,146.6
75113,Paris 13e,177735,26056693,0,26056693,146.6
42218,Saint-Étienne,172569,11550018,4043340,15593358,90.4
76351,Le Havre,166462,8843539,1501471,10345010,62.1
69266,Villeurbanne,162207,11602263,11728748,23331011,143.8
75117,Paris 17e,161206,23633473,0,23633473,146.6
21231,Dijon,159941,14516724,4641374,19158098,119.8
75116,Paris 16e,159733,23417525,0,23417525,146.6
49007,Angers,157555,14676676,2550527,17227203,109.3
38185,Grenoble,156389,18469680,6041364,24511044,156.7
97411,Saint-Denis,156149,18273651,3971642,22245293,142.5
30189,Nîmes,150444,10933436,554105,11487541,76.4
13001,Aix-en-Provence,147933,18860804,4157883,23018687,155.6
63113,Clermont-Ferrand,147751,10572200,5602885,16175085,109.5
72181,Le Mans,145182,5255097,2970110,8225207,56.7
29019,Brest,140993,14978952,6491600,21470552,152.3
75111,Paris 11e,139983,20522093,0,20522093,146.6
75112,Paris 12e,139788,20493505,0,20493505,146.6
37261,Tours,138668,6447631,1640628,8088259,58.3
75114,Paris 14e,137581,20169949,0,20169949,146.6
80021,Amiens,134780,2995100,8640932,11636032,86.3
74010,Annecy,131272,13676947,1014015,14690962,111.9
87085,Limoges,129754,3450050,1839986,5290036,40.8
57463,Metz,121695,10485488,6033709,16519197,135.7
66136,Perpignan,120996,4037629,1007797,5045426,41.7
92012,Boulogne-Billancourt,120205,10712839,980044,11692883,97.3
25056,Besançon,120057,7235502,2115354,9350856,77.9
45234,Orléans,116344,10761643,1701723,12463366,107.1
76540,Rouen,116331,6509926,3322833,9832759,84.5
93066,Saint-Denis,115237,5920392,939539,6859931,59.5
93048,Montreuil,110758,4162556,903022,5065578,45.7
14118,Caen,108398,10908652,2412087,13320739,122.9
95018,Argenteuil,107135,4276873,873483,5150356,48.1
97415,Saint-Paul,106220,5731648,700241,6431889,60.6
68224,Mulhouse,104924,12418577,7309233,19727810,188
54395,Nancy,104387,9705966,3485980,13191946,126.4
59512,Roubaix,99507,12090701,1647819,13738520,138.1
59599,Tourcoing,99160,8459181,1642073,10101254,101.9
92050,Nanterre,98119,5177781,799975,5977756,60.9
94081,Vitry-sur-Seine,95282,3876404,776844,4653248,48.8
94028,Créteil,92859,8669164,757089,9426253,101.5
84007,Avignon,91760,8106302,1722091,9828393,107.1
92004,Asnières-sur-Seine,91457,3354611,745659,4100270,44.8
92025,Colombes,90692,3692101,739421,4431522,48.9
93001,Aubervilliers,89489,4402506,729613,5132119,57.3
86194,Poitiers,89472,12896160,5330651,18226811,203.7
59183,Dunkerque,87013,9847593,10624751,20472344,235.3
93005,Aulnay-sous-Bois,86360,7488527,704102,8192629,94.9
97416,Saint-Pierre,85254,4816427,417708,5234135,61.4
78646,Versailles,83918,2593666,695544,3289210,39.2
97422,Le Tampon,81964,3299066,137046,3436112,41.9
92026,Courbevoie,81945,4055270,668106,4723376,57.6
75110,Paris 10e,81926,12010694,0,12010694,146.6
92063,Rueil-Malmaison,80842,3360278,659113,4019391,49.7
34032,Béziers,80815,2862054,468161,3330215,41.2
17300,La Rochelle,79961,6939253,2218930,9158183,114.5
64445,Pau,78620,5874334,2321300,8195634,104.2
94017,Champigny-sur-Marne,78367,1366072,638934,2005006,25.6
50129,Cherbourg-en-Cotentin,78028,6428106,2454334,8882440,113.8
33281,Mérignac,77136,8505239,1972014,10477253,135.8
6004,Antibes,76612,5228777,928376,6157153,80.4
94068,Saint-Maur-des-Fossés,76010,2513566,619718,3133284,41.2
2A004,Ajaccio,75343,2095762,755410,2851172,37.8
97209,Fort-de-France,75165,1513243,3285979,4799222,63.8
6029,Cannes,74040,17254929,359681,17614610,237.9
44184,Saint-Nazaire,73111,8807020,2694136,11501156,157.3
93051,Noisy-le-Grand,71632,1009919,584023,1593942,22.3
97611,Mamoudzou,71437,1671250,19122,1690372,23.7
93029,Drancy,71312,1711241,581414,2292655,32.1
95127,Cergy,69578,1881185,2074469,3955654,56.9
92044,Levallois-Perret,68412,12114631,557770,12672401,185.2
92040,Issy-les-Moulineaux,67695,14237284,551924,14789208,218.5
62193,Calais,67585,7346236,2031329,9377565,138.8
68066,Colmar,67360,5293245,1384351,6677596,99.1
33318,Pessac,66874,3391770,1709662,5101432,76.3
69259,Vénissieux,66701,4682043,4822968,9505011,142.5
91228,Évry-Courcouronnes,66700,2125385,1322435,3447820,51.7
92024,Clichy,65102,3135501,530783,3666284,56.3
29232,Quimper,64530,9135369,2071468,11206837,173.7
94041,Ivry-sur-Seine,64526,3890169,526087,4416256,68.4
26362,Valence,64288,3037514,1303172,4340686,67.5
18033,Bourges,64238,5002420,1230422,6232842,97
92002,Antony,64026,2726895,522011,3248906,50.7
97302,Cayenne,63956,1965611,426914,2392525,37.4
83126,La Seyne-sur-Mer,62905,2278914,2710806,4989720,79.3
82121,Montauban,62487,2273205,544091,2817296,45.1
10387,Troyes,62443,2263141,891685,3154826,50.5
59009,Villeneuve-d'Ascq,62342,6872811,1032373,7905184,126.8
93055,Pantin,60954,2045557,496964,2542521,41.7
73065,Chambéry,60251,7988965,765845,8754810,145.3
79191,Niort,60074,4874297,809655,5683952,94.6
93007,Le Blanc-Mesnil,59912,1400732,488469,1889201,31.5
92051,Neuilly-sur-Seine,59200,2675393,482664,3158057,53.3
95585,Sarcelles,58576,2827289,726429,3553718,60.7
83061,Fréjus,58499,4322416,2073444,6395860,109.3
75109,Paris 9e,58419,8564469,0,8564469,146.6
56121,Lorient,58202,3502163,1316387,4818550,82.8
94076,Villejuif,58142,1590446,474038,2064484,35.5
97409,Saint-André,57546,2255547,327800,2583347,44.9
94046,Maisons-Alfort,57422,2969135,468168,3437303,59.9
92023,Clamart,56882,1913416,463765,2377181,41.8
11262,Narbonne,56692,3211137,876714,4087851,72.1
77284,Meaux,56659,1971277,772685,2743962,48.4
75105,Paris 5e,55925,8198839,0,8198839,146.6
60057,Beauvais,55906,4387658,2192239,6579897,117.7
83069,Hyères,55384,2787653,2386699,5174352,93.4
93008,Bobigny,55270,2892858,450622,3343480,60.5
56260,Vannes,54955,3904242,508397,4412639,80.3
85191,La Roche-sur-Yon,54699,5816767,2585439,8402206,153.6
97414,Saint-Louis,54478,1147347,266919,1414266,26
77108,Chelles,54372,1100720,581225,1681945,30.9
49099,Cholet,54074,1907360,2246941,4154301,76.8
91174,Corbeil-Essonnes,53712,1854050,1064927,2918977,54.3
93031,Épinay-sur-Seine,53564,713170,436713,1149883,21.5
64102,Bayonne,53312,3728335,1385354,5113689,95.9
93070,Saint-Ouen-sur-Seine,53041,2864487,432449,3296936,62.2
2691,Saint-Quentin,52995,4567254,7574170,12141424,229.1
6027,Cagnes-sur-Mer,52852,1068950,1040546,2109496,39.9
94033,Fontenay-sous-Bois,52646,1519275,429228,1948503,37
69256,Vaulx-en-Velin,52448,5042131,3792373,8834504,168.4
97101,Les Abymes,51760,934164,284926,1219090,23.6
97311,Saint-Laurent-du-Maroni,51732,4561200,243273,4804473,92.9
93071,Sevran,51640,2024191,421026,2445217,47.4
78586,Sartrouville,51570,2644917,72969,2717886,52.7
13004,Arles,51156,2723822,964414,3688236,72.1
93010,Bondy,51066,1034450,416346,1450796,28.4
92036,Gennevilliers,50874,6677378,414781,7092159,139.4
81004,Albi,50605,5003413,491237,5494650,108.6
91377,Massy,50597,6845625,525563,7371188,145.7
44162,Saint-Herblain,50561,2778222,2200386,4978608,98.5
53130,Laval,49474,2601071,2153121,4754192,96.1
69290,Saint-Priest,49193,4467302,3557012,8024314,163.1
92073,Suresnes,48932,1963654,398948,2362602,48.3
13056,Martigues,48818,9829464,1372104,11201568,229.5
85194,Les Sables-d'Olonne,48740,2525028,2845090,5370118,110.2
6069,Grasse,48669,2802804,1242607,4045411,83.1
94080,Vincennes,48368,2012345,394349,2406694,49.8
27229,Évreux,48335,4022722,568458,4591180,95
75107,Paris 7e,48196,7065735,0,7065735,146.6
13005,Aubagne,47724,1636044,1341356,2977400,62.4
2B033,Bastia,47459,1990750,710406,2701156,56.9
35288,Saint-Malo,47255,4276043,1120383,5396426,114.2
41018,Blois,47092,4221989,1804845,6026834,128
93027,La Courneuve,47086,984385,383897,1368282,29.1
19031,Brive-la-Gaillarde,46769,2449894,746426,3196320,68.3
92048,Meudon,46722,1690525,380929,2071454,44.3
93046,Livry-Gargan,46507,1114547,379176,1493723,32.1
11069,Carcassonne,46429,1969386,301149,2270535,48.9
92049,Montrouge,46273,1099589,377269,1476858,31.9
94022,Choisy-le-Roi,46122,673629,376038,1049667,22.8
93064,Rosny-sous-Bois,45947,1969416,374611,2344027,51
93053,Noisy-le-Sec,45915,1020789,374350,1395139,30.4
33522,Talence,45869,2399800,1172660,3572460,77.9
90010,Belfort,45646,3313809,1592497,4906306,107.5
8105,Charleville-Mézières,45634,2325493,1048268,3373761,73.9
94002,Alfortville,45569,1611525,371529,1983054,43.5
78551,Saint-Germain-en-Laye,45286,2808043,64077,2872120,63.4
34301,Sète,45090,2962160,1771167,4733327,105
30007,Alès,45025,2069487,1407365,3476852,77.2
22278,Saint-Brieuc,44607,5440959,707478,6148437,137.8
71076,Chalon-sur-Saône,44592,1697329,1226051,2923380,65.6
13103,Salon-de-Provence,44553,3595157,1252230,4847387,108.8
65440,Tarbes,44529,4114269,425406,4539675,101.9
78361,Mantes-la-Jolie,44246,2054700,411791,2466491,55.7
92062,Puteaux,44198,1244720,360351,1605071,36.3
13047,Istres,44044,6253014,1237924,7490938,170.1
77288,Melun,43685,1358389,608663,1967052,45
92007,Bagneux,43647,1529620,355859,1885479,43.2
69034,Caluire-et-Cuire,43479,1508364,3143849,4652213,107
44143,Rezé,43349,4988700,1886524,6875224,158.6
51108,Châlons-en-Champagne,43218,1886294,2196672,4082966,94.5
36044,Châteauroux,43079,1638007,1596656,3234663,75.1
59606,Valenciennes,42979,1216865,827955,2044820,47.6
69029,Bron,42850,5261553,3098367,8359920,195.1
57672,Thionville,42778,2009438,449601,2459039,57.5
81065,Castres,42700,1102187,449144,1551331,36.3
62041,Arras,42621,3626722,1198777,4825499,113.2
95268,Garges-lès-Gonesse,42388,673158,525674,1198832,28.3
64024,Anglet,42288,2116841,1098887,3215728,76
33550,Villenave-d'Ornon,42185,863945,1078477,1942422,46
1053,Bourg-en-Bresse,42065,2978072,813221,3791293,90.1
93006,Bagnolet,41776,1330566,340604,1671170,40
16015,Angoulême,41423,5353446,1076926,6430372,155.2
62160,Boulogne-sur-Mer,41039,2355927,1387306,3743233,91.2
31149,Colomiers,40916,2345407,1000315,3345722,81.8
59650,Wattrelos,40881,2191152,676983,2868135,70.2
60159,Compiègne,40808,3618616,367542,3986158,97.7
78498,Poissy,40792,2146460,379645,2526105,61.9
93032,Gagny,40790,1135977,332565,1468542,36
83050,Draguignan,40789,1518812,508096,2026908,49.7
5061,Gap,40656,2259156,57632,2316788,57
93072,Stains,40600,1066897,331016,1397913,34.4
75106,Paris 6e,40432,5927500,0,5927500,146.6
26198,Montélimar,40356,1112053,388827,1500880,37.2
6030,Le Cannet,40198,1864310,195279,2059589,51.2
59378,Marcq-en-Barœul,39943,3048347,661449,3709796,92.9
59178,Douai,39833,4285745,555010,4840755,121.5
93078,Villepinte,39647,1310568,323246,1633814,41.2
97213,Le Lamentin,39346,7476801,1720084,9196885,233.7
97412,Saint-Joseph,38992,2532000,65195,2597195,66.6
77373,Pontault-Combault,38941,2297103,416271,2713374,69.7
93050,Neuilly-sur-Marne,38799,941537,316332,1257869,32.4
37122,Joué-lès-Tours,38432,1827325,454702,2282027,59.4
93073,Tremblay-en-France,38210,10229526,311530,10541056,275.9
95252,Franconville,38024,1199697,115271,1314968,34.6
38421,Saint-Martin-d'Hères,38022,1185281,1468804,2654085,69.8
28085,Chartres,37990,5334188,1106981,6441169,169.5
69149,Oullins-Pierre-Bénite,37928,3033727,2742471,5776198,152.3
91589,Savigny-sur-Orge,37775,890972,307984,1198956,31.7
74281,Thonon-les-Bains,37689,4543925,1640852,6184777,164.1
13028,La Ciotat,37599,1551295,1056777,2608072,69.4
74012,Annemasse,37595,5518038,600792,6118830,162.8
97410,Saint-Benoît,37585,2478391,214096,2692487,71.6
83129,Six-Fours-les-Plages,36843,799186,1587700,2386886,64.8
38151,Échirolles,36708,2548860,1418043,3966903,108.1
83118,Saint-Raphaël,36632,2360916,1298388,3659304,99.9
13117,Vitrolles,36612,2141743,1029036,3170779,86.6
60175,Creil,36494,1027498,375338,1402836,38.4
91027,Athis-Mons,36451,539650,297189,836839,23
69282,Meyzieu,36437,1782937,2634661,4417598,121.2
97408,La Possession,36390,1541298,239896,1781194,48.9
78172,Conflans-Sainte-Honorine,36306,2118543,337894,2456437,67.7
69264,Villefranche-sur-Saône,36224,2778734,769064,3547798,97.9
92020,Châtillon,36224,1987980,295338,2283318,63
94078,Villeneuve-Saint-Georges,36170,284463,294898,579361,16
67180,Haguenau,36070,3757187,438582,4195769,116.3
91477,Palaiseau,36067,1314242,374637,1688879,46.8
91549,Sainte-Geneviève-des-Bois,35714,981990,358777,1340767,37.5
97413,Saint-Leu,35597,1509567,234669,1744236,49
42207,Saint-Chamond,35586,2081939,833790,2915729,81.9
97418,Sainte-Marie,35584,1119411,905077,2024488,56.9
97307,Matoury,35551,530275,237307,767582,21.6
92019,Châtenay-Malabry,35490,3559585,289354,3848939,108.5
75108,Paris 8e,35418,5192427,0,5192427,146.6
42187,Roanne,35364,1610707,1043575,2654282,75.1
93063,Romainville,35314,385520,287919,673439,19.1
89024,Auxerre,35236,2696085,689325,3385410,96.1
71270,Mâcon,34759,3155069,887850,4042919,116.3
94058,Le Perreux-sur-Marne,34654,570249,282538,852787,24.6
67447,Schiltigheim,34382,1625910,13356698,14982608,435.8
95063,Bezons,34314,632279,48552,680831,19.8
78621,Trappes,34276,721348,854360,1575708,46
78440,Les Mureaux,34151,1105609,317838,1423447,41.7
93059,Pierrefitte-sur-Seine,33670,1060201,0,1060201,31.5
97407,Le Port,33670,5249650,221965,5471615,162.5
78311,Houilles,33617,654153,47566,701719,20.9
3185,Montluçon,33317,1613860,784236,2398096,72
58194,Nevers,33172,982954,1784187,2767141,83.4
13054,Marignane,33164,826770,932125,1758895,53
26281,Romans-sur-Isère,33139,1863173,671755,2534928,76.5
94052,Nogent-sur-Marne,32998,1003584,269036,1272620,38.6
75103,Paris 3e,32772,4804512,0,4804512,146.6
33449,Saint-Médard-en-Jalles,32749,1496956,837242,2334198,71.3
62498,Lens,32697,678032,880862,1558894,47.7
94079,Villiers-sur-Marne,32547,627610,265359,892969,27.4
88160,Épinal,32296,2859342,812158,3671500,113.7
47001,Agen,32193,1547385,736959,2284344,71
73008,Aix-les-Bains,32175,2027945,178004,2205949,68.6
97610,Koungou,32156,376126,0,376126,11.7
78423,Montigny-le-Bretonneux,32150,950122,801368,1751490,54.5
94073,Thiais,32006,1284710,260948,1545658,48.3
78490,Plaisir,31971,473140,796906,1270046,39.7
95306,Herblay-sur-Seine,31818,416220,96457,512677,16.1
6123,Saint-Laurent-du-Var,31645,858400,623024,1481424,46.8
95500,Pontoise,31623,2129824,942840,3072664,97.2
59122,Cambrai,31568,2142595,410326,2552921,80.9
38544,Vienne,31555,1313136,242776,1555912,49.3
69286,Rillieux-la-Pape,31479,3317269,2276161,5593430,177.7
40192,Mont-de-Marsan,31455,0,389292,389292,12.4
94038,L'Haÿ-les-Roses,31338,683947,255502,939449,30
91657,Vigneux-sur-Seine,31233,210500,352814,563314,18
28134,Dreux,31205,1545134,41737,1586871,50.9
91687,Viry-Châtillon,31112,1432686,253659,1686345,54.2
86066,Châtellerault,31105,1933578,707931,2641509,84.9
78158,Le Chesnay-Rocquencourt,31064,1079022,257470,1336492,43
33039,Bègles,30968,2397782,791710,3189492,103
95280,Goussainville,30952,761690,383851,1145541,37
97103,Baie-Mahault,30943,538325,170334,708659,22.9
84031,Carpentras,30854,1821564,1007469,2829033,91.7
77445,Savigny-le-Temple,30630,771627,607289,1378916,45
94016,Cachan,30526,1526074,248882,1774956,58.1
6083,Menton,30326,814925,170203,985128,32.5
91521,Ris-Orangis,30283,1064553,600409,1664962,55
92046,Malakoff,30183,678600,246085,924685,30.6
62510,Liévin,30113,1286977,811249,2098226,69.7
78146,Chatou,30054,921632,42525,964157,32.1
93077,Villemomble,29973,1625706,244373,1870079,62.4
69275,Décines-Charpieu,29905,2211538,2162349,4373887,146.3
24322,Périgueux,29876,2043812,166854,2210666,74
92064,Saint-Cloud,29859,3339839,243444,3583283,120
92035,La Garenne-Colombes,29828,1439300,243191,1682491,56.4
91201,Draveil,29824,758700,336898,1095598,36.7
38053,Bourgoin-Jallieu,29816,1113391,362304,1475695,49.5
78297,Guyancourt,29758,243251,741745,984996,33.1
31557,Tournefeuille,29724,1045126,726693,1771819,59.6
54547,Vandœuvre-lès-Nancy,29697,3251213,991725,4242938,142.9
34003,Agde,29612,1492198,328897,1821095,61.5
93014,Clichy-sous-Bois,29551,2046554,240932,2287486,77.4
92009,Bois-Colombes,29376,2396970,239506,2636476,89.7
84087,Orange,29357,653551,29492,683043,23.3
94034,Fresnes,29298,937470,238870,1176340,40.2
95680,Villiers-le-Bel,29238,1055432,362595,1418027,48.5
95219,Ermont,29189,480636,88488,569124,19.5
76681,Sotteville-lès-Rouen,29039,1962509,829459,2791968,96.1
92060,Le Plessis-Robinson,28893,2532257,235568,2767825,95.8
59392,Maubeuge,28879,2707642,1030132,3737774,129.4
94018,Charenton-le-Pont,28756,785149,234451,1019600,35.5
2722,Soissons,28667,1005910,239827,1245737,43.5
76575,Saint-Étienne-du-Rouvray,28653,843742,818433,1662175,58
76217,Dieppe,28599,3400088,347565,3747653,131
6155,Vallauris,28579,711600,346317,1057917,37
92075,Vanves,28507,949935,232421,1182356,41.5
44190,Saint-Sébastien-sur-Loire,28373,1376758,1234777,2611535,92
91691,Yerres,28349,314554,320236,634790,22.4
44114,Orvault,28341,1285597,1233384,2518981,88.9
93047,Montfermeil,28257,356947,230382,587329,20.8
75104,Paris 4e,28039,4110635,0,4110635,146.6
94044,Limeil-Brévannes,27806,273457,226705,500162,18
94071,Sucy-en-Brie,27593,1117562,224969,1342531,48.7
67218,Illkirch-Graffenstaden,27339,3161266,10620638,13781904,504.1
31069,Blagnac,27314,2915543,667773,3583316,131.2
89387,Sens,27275,921139,181255,1102394,40.4
97113,Le Gosier,27205,259487,489726,749213,27.5
78517,Rambouillet,27145,1045530,52886,1098416,40.5
33529,La Teste-de-Buch,27141,536497,620756,1157253,42.6
59328,Lambersart,27105,1647545,448854,2096399,77.3
95176,Cormeilles-en-Parisis,27086,611540,82112,693652,25.6
95607,Taverny,27065,739528,82049,821577,30.4
97309,Remire-Montjoly,27037,898908,180475,1079383,39.9
95277,Gonesse,26959,584427,334332,918759,34.1
24037,Bergerac,26852,912807,597786,1510593,56.3
77514,Villeparisis,26794,673192,332285,1005477,37.5
33119,Cenon,26784,1842530,684744,2527274,94.4
95582,Sannois,26772,415243,81160,496403,18.5
77083,Champs-sur-Marne,26661,730938,285000,1015938,38.1
91103,Brétigny-sur-Orge,26658,831798,267802,1099600,41.2
91223,Étampes,26601,305390,66994,372384,14
91286,Grigny,26500,567348,525405,1092753,41.2
34145,Lunel,26380,956640,288412,1245052,47.2
78208,Élancourt,26348,430989,656748,1087737,41.3
77058,Bussy-Saint-Georges,26334,180580,65101,245681,9.3
83062,La Garde,26316,672354,1134053,1806407,68.6
15014,Aurillac,26189,1851083,887325,2738408,104.6
33192,Gradignan,26186,497570,669456,1167026,44.6
59017,Armentières,26107,1707923,432328,2140251,82
49328,Saumur,26074,1321127,254035,1575162,60.4
44215,Vertou,26048,805335,1133594,1938929,74.4
76322,Le Grand-Quevilly,25954,1017504,741340,1758844,67.8
95203,Eaubonne,25934,476549,78620,555169,21.4
13063,Miramas,25891,2858269,727706,3585975,138.5
84035,Cavaillon,25890,1399540,252348,1651888,63.8
64122,Biarritz,25810,5149133,670693,5819826,225.5
91114,Brunoy,25792,242162,291351,533513,20.7
49301,Sèvremoine,25764,2342412,244579,2586991,100.4
62427,Hénin-Beaumont,25764,1200149,408539,1608688,62.4
3310,Vichy,25702,1042710,704102,1746812,68
61001,Alençon,25667,1983699,758543,2742242,106.8
31395,Muret,25653,781374,31862,813236,31.7
91692,Les Ulis,25633,838778,266256,1105034,43.1
95572,Saint-Ouen-l'Aumône,25614,750042,763682,1513724,59.1
92078,Villeneuve-la-Garenne,25566,2166835,208442,2375277,92.9
25388,Montbéliard,25516,1870490,1615257,3485747,136.6
34057,Castelnau-le-Lez,25404,737009,2014166,2751175,108.3
62119,Béthune,25342,1980271,418200,2398471,94.6
17415,Saintes,25312,2520795,802219,3323014,131.3
18279,Vierzon,25254,1001145,364872,1366017,54.1
93057,Les Pavillons-sous-Bois,24872,1211836,202784,1414620,56.9
97420,Sainte-Suzanne,24855,1661480,632186,2293666,92.3
27681,Vernon,24841,621425,130524,751949,30.3
33243,Libourne,24668,1058076,481176,1539252,62.4
33249,Lormont,24654,1394939,630290,2025229,82.1
92032,Fontenay-aux-Roses,24586,664802,200452,865254,35.2
94054,Orly,24488,745347,199653,945000,38.6
97304,Kourou,24470,464302,200911,665213,27.2
33162,Eysines,24436,363896,624717,988613,40.5
97128,Sainte-Anne,24415,248388,439502,687890,28.2
97118,Petit-Bourg,24299,392988,66416,459404,18.9
33069,Le Bouscat,24262,938822,620268,1559090,64.3
12202,Rodez,24136,1211693,369893,1581586,65.5
2408,Laon,24066,1648965,919073,2568038,106.7
91421,Montgeron,23890,217550,269866,487416,20.4
49023,Beaupréau-en-Mauges,23887,1377242,226760,1604002,67.1
34108,Frontignan,23788,658220,934410,1592630,67
39198,Dole,23784,1054569,482717,1537286,64.6
94043,Le Kremlin-Bicêtre,23678,650951,193049,844000,35.6
83144,La Valette-du-Var,23660,447600,1019596,1467196,62
44047,Couëron,23541,1069327,1024491,2093818,88.9
77390,Roissy-en-Brie,23521,282744,251435,534179,22.7
93045,Les Lilas,23262,755824,189658,945482,40.6
77152,Dammarie-les-Lys,23252,684150,323970,1008120,43.4
17299,Rochefort,23188,1632722,381852,2014574,86.9
56098,Lanester,23188,1000857,524456,1525313,65.8
45232,Olivet,22988,544889,336237,881126,38.3
59360,Loos,22948,462167,380015,842182,36.7
77468,Torcy,22939,1109722,245213,1354935,59.1
97117,Le Moule,22924,854135,325605,1179740,51.5
95197,Deuil-la-Barre,22903,226183,39940,266123,11.6
85047,Challans,22890,1121514,152842,1274356,55.7
78358,Maisons-Laffitte,22855,1356744,32338,1389082,60.8
32013,Auch,22825,960772,804238,1765010,77.3
69244,Tassin-la-Demi-Lune,22819,560740,1649980,2210720,96.9
52448,Saint-Dizier,22811,898610,206591,1105201,48.5
4112,Manosque,22807,952380,265110,1217490,53.4
92072,Sèvres,22782,705675,185744,891419,39.1
77122,Combs-la-Ville,22712,385474,450302,835776,36.8
33199,Gujan-Mestras,22643,621338,517880,1139218,50.3
91272,Gif-sur-Yvette,22578,746196,234523,980719,43.4
68297,Saint-Louis,22530,1433785,437911,1871696,83.1
78640,Vélizy-Villacoublay,22481,2213697,186331,2400028,106.8
14327,Hérouville-Saint-Clair,22473,1657455,500072,2157527,96
38169,Fontaine,22471,640313,868063,1508376,67.1
13071,Les Pennes-Mirabeau,22423,1280054,630233,1910287,85.2
80001,Abbeville,22406,741160,68355,809515,36.1
95424,Montigny-lès-Cormeilles,22390,434610,67876,502486,22.4
1283,Oyonnax,22378,700663,846513,1547176,69.1
59368,La Madeleine,22161,918694,366982,1285676,58
45284,Saint-Jean-de-Braye,22088,1650303,323073,1973376,89.3
51230,Épernay,22022,3102982,437637,3540619,160.8
47323,Villeneuve-sur-Lot,22004,619175,168624,787799,35.8
62178,Bruay-la-Buissière,21997,557722,363000,920722,41.9
76498,Le Petit-Quevilly,21935,235720,626543,862263,39.3
93049,Neuilly-Plaisance,21914,415260,178667,593927,27.1
69202,Sainte-Foy-lès-Lyon,21893,1323466,1583023,2906489,132.8
78362,Mantes-la-Ville,21874,563732,203578,767310,35.1
57480,Montigny-lès-Metz,21869,1551847,1084278,2636125,120.5
94003,Arcueil,21868,761445,178292,939737,43
12145,Millau,21859,1584787,225908,1810695,82.8
60463,Nogent-sur-Oise,21859,822695,224818,1047513,47.9
77305,Montereau-Fault-Yonne,21840,818041,15436,833477,38.2
59295,Hazebrouck,21785,1320315,133096,1453411,66.7
40088,Dax,21716,704070,185903,889973,41
95428,Montmorency,21677,319369,37802,357171,16.5
45147,Fleury-les-Aubrais,21664,413760,316872,730632,33.7
78005,Achères,21663,462495,201614,664109,30.7
38563,Voiron,21604,854814,367016,1221830,56.6
49092,Chemillé-en-Anjou,21550,1634015,204575,1838590,85.3
91570,Saint-Michel-sur-Orge,21536,480668,216347,697015,32.4
13041,Gardanne,21534,592895,605246,1198141,55.6
97222,Le Robert,21490,819100,194572,1013672,47.2
77243,Lagny-sur-Marne,21433,521774,52985,574759,26.8
52121,Chaumont,21418,2243740,2352616,4596356,214.6
13002,Allauch,21404,313153,601592,914745,42.7
59410,Mons-en-Barœul,21368,994393,353851,1348244,63.1
69204,Saint-Genis-Laval,21329,2320778,1542242,3863020,181.1
95555,Saint-Gratien,21297,643542,37140,680682,32
94067,Saint-Mandé,21223,496679,173033,669712,31.6
6079,Mandelieu-la-Napoule,21201,549250,102993,652243,30.8
91434,Morsang-sur-Orge,21161,145191,212580,357771,16.9
92014,Bourg-la-Reine,21140,989069,172357,1161426,54.9
57227,Forbach,21111,2046819,385936,2432755,115.2
94059,Le Plessis-Trévise,21096,915382,171998,1087380,51.5
77350,Ozoir-la-Ferrière,20969,624492,127678,752170,35.9
59163,Croix,20956,640910,347028,987938,47.1
69091,Givors,20943,1267360,1514332,2781692,132.8
94077,Villeneuve-le-Roi,20871,173188,170163,343351,16.5
59155,Coudekerque-Branche,20833,309842,2543820,2853662,137
94042,Joinville-le-Pont,20784,966109,169454,1135563,54.6
85146,Montaigu-Vendée,20754,1009929,347762,1357691,65.4
92071,Sceaux,20740,1233940,169095,1403035,67.6
59279,Halluin,20684,992340,342524,1334864,64.5
67267,Lingolsheim,20683,1059706,8034919,9094625,439.7
59646,Wasquehal,20674,1934925,342358,2277283,110.2
29039,Concarneau,20632,636713,227212,863925,41.9
59172,Denain,20622,572750,775814,1348564,65.4
35115,Fougères,20602,2036058,252262,2288320,111.1
44020,Bouguenais,20590,575944,896065,1472009,71.5
71153,Le Creusot,20536,1483320,329977,1813297,88.3
44026,Carquefou,20535,1501377,893672,2395049,116.6
22113,Lannion,20525,683055,407745,1090800,53.1
44035,La Chapelle-sur-Erdre,20483,1094498,891409,1985907,97
31424,Plaisance-du-Touch,20471,212265,6259,218524,10.7
91345,Longjumeau,20470,1106700,212627,1319327,64.5
78545,Saint-Cyr-l'École,20451,226164,169506,395670,19.3
78126,La Celle-Saint-Cloud,20440,705966,169414,875380,42.8
75102,Paris 2e,20433,2995563,0,2995563,146.6
77294,Mitry-Mory,20393,503400,252903,756303,37.1
33075,Bruges,20382,546065,521074,1067139,52.4
59271,Grande-Synthe,20347,4198754,2484477,6683231,328.5
57631,Sarreguemines,20324,1871138,277758,2148896,105.7
84054,L'Isle-sur-la-Sorgue,20315,637809,169394,807203,39.7
31157,Cugnaux,20239,246834,494804,741638,36.6
21054,Beaune,20233,863239,87983,951222,47
92022,Chaville,20198,893277,164676,1057953,52.4
76451,Mont-Saint-Aignan,20188,275801,576642,852443,42.2
63124,Cournon-d'Auvergne,20020,888322,759181,1647503,82.3
91161,Chilly-Mazarin,19981,552909,207548,760457,38.1
78383,Maurepas,19960,285271,497521,782792,39.2
78123,Carrières-sous-Poissy,19951,369304,185681,554985,27.8
46042,Cahors,19902,794236,168044,962280,48.4
26058,Bourg-lès-Valence,19872,527893,402822,930715,46.8
79049,Bressuire,19860,918043,564949,1482992,74.7
6157,Vence,19856,487280,390923,878203,44.2
94021,Chevilly-Larue,19813,1726034,161537,1887571,95.3
84089,Pertuis,19764,543045,555497,1098542,55.6
73011,Albertville,19706,700222,464842,1165064,59.1
35047,Bruz,19667,1071651,1007820,2079471,105.7
69199,Saint-Fons,19549,1711208,1413535,3124743,159.8
14366,Lisieux,19540,732274,217506,949780,48.6
77285,Le Mée-sur-Seine,19527,619571,272069,891640,45.7
67462,Sélestat,19523,1365749,375599,1741348,89.2
6085,Mougins,19481,609950,94637,704587,36.2
59507,Ronchin,19436,639721,321857,961578,49.5
83047,La Crau,19416,799893,836706,1636599,84.3
50502,Saint-Lô,19352,742679,286222,1028901,53.2
3190,Moulins,19344,743986,260389,1004375,51.9
97229,Schœlcher,19342,90750,845572,936322,48.4
88413,Saint-Dié-des-Vosges,19324,834691,187877,1022568,52.9
17306,Royan,19322,1500055,304298,1804353,93.4
84129,Sorgues,19030,1516646,75839,1592485,83.7
38553,Villefontaine,19018,161359,231094,392453,20.6
77053,Brie-Comte-Robert,18999,406923,134168,541091,28.5
43157,Le Puy-en-Velay,18989,741693,790118,1531811,80.7
91326,Juvisy-sur-Orge,18978,343361,154730,498091,26.2
35360,Vitré,18892,2499515,283832,2783347,147.3
94037,Gentilly,18883,652577,153955,806532,42.7
56162,Ploemeur,18873,251017,426861,677878,35.9
97305,Macouria,18807,603412,125539,728951,38.8
38229,Meylan,18790,916795,725865,1642660,87.4
95218,Éragny,18723,229001,558227,787228,42
63300,Riom,18680,567192,141269,708461,37.9
59299,Hem,18579,0,307665,307665,16.6
49244,Mauges-sur-Loire,18514,802705,175754,978459,52.8
77296,Moissy-Cramayel,18498,315282,366753,682035,36.9
16102,Cognac,18466,146200,690916,837116,45.3
97115,Lamentin,18437,257958,50393,308351,16.7
44131,Pornic,18382,1178646,560346,1738992,94.6
41194,Romorantin-Lanthenay,18377,701048,387235,1088283,59.2
13026,Châteauneuf-les-Martigues,18364,1083787,516148,1599935,87.1
27375,Louviers,18347,0,544092,544092,29.7
94011,Bonneuil-sur-Marne,18340,643193,149528,792721,43.2
59220,Faches-Thumesnil,18310,562155,303211,865366,47.3
94019,Chennevières-sur-Marne,18295,297401,149161,446562,24.4
67043,Bischheim,18289,828646,7104900,7933546,433.8
30028,Bagnols-sur-Cèze,18124,724905,264470,989375,54.6
94015,Bry-sur-Marne,18095,305770,147530,453300,25.1
35051,Cesson-Sévigné,18076,732370,926291,1658661,91.8
64260,Hendaye,18074,1074066,469667,1543733,85.4
95598,Soisy-sous-Montmorency,18068,720153,31509,751662,41.6
69081,Écully,18019,376395,1302905,1679300,93.2
84092,Le Pontet,17985,764479,337531,1102010,61.3
62215,Carvin,17966,313486,284886,598372,33.3
76259,Fécamp,17961,1263267,116546,1379813,76.8
33167,Floirac,17939,767211,458618,1225829,68.3
83123,Sanary-sur-Mer,17938,575090,11143,586233,32.7
38382,Saint-Égrève,17930,760725,692642,1453367,81.1
25462,Pontarlier,17928,1169966,512440,1682406,93.8
54329,Lunéville,17920,828899,79174,908073,50.7
97107,Capesterre-Belle-Eau,17882,288350,80643,368993,20.6
83023,Brignoles,17846,377771,668621,1046392,58.6
97207,Ducos,17837,249300,87636,336936,18.9
97608,Dzaoudzi,17831,67000,3046,70046,3.9
92033,Garches,17705,635843,144351,780194,44.1
4070,Digne-les-Bains,17694,768783,741643,1510426,85.4
83116,Saint-Maximin-la-Sainte-Baume,17691,260825,662814,923639,52.2
49331,Segré-en-Anjou Bleu,17617,593285,17571,610856,34.7
34129,Lattes,17592,944262,1394789,2339051,133
63075,Chamalières,17591,603237,667071,1270308,72.2
78335,Limay,17584,172452,163652,336104,19.1
62065,Avion,17571,383042,473365,856407,48.7
57757,Yutz,17497,768522,183895,952417,54.4
97129,Sainte-Rose,17494,20000,47816,67816,3.9
95476,Osny,17471,121123,520898,642021,36.7
31044,Balma,17431,649010,426153,1075163,61.7
14762,Vire Normandie,17411,1805297,7954,1813251,104.1
95323,Jouy-le-Moutier,17411,99231,519109,618340,35.5
74081,Cluses,17366,554686,158005,712691,41
47157,Marmande,17361,935235,179620,1114855,64.2
94004,Boissy-Saint-Léger,17335,144031,141334,285365,16.5
33003,Ambarès-et-Lagrave,17298,462787,442231,905018,52.3
7010,Annonay,17222,1125851,88727,1214578,70.5
42095,Firminy,17128,1033763,401314,1435077,83.8
38193,L'Isle-d'Abeau,17096,167785,207739,375524,22
74256,Sallanches,17041,952304,178457,1130761,66.4
49126,Orée d'Anjou,16975,727564,161144,888708,52.4
71306,Montceau-les-Mines,16946,605213,272292,877505,51.8
78686,Viroflay,16943,207718,140430,348148,20.5
39300,Lons-le-Saunier,16942,1324086,533919,1858005,109.7
78165,Les Clayes-sous-Bois,16940,342567,422245,764812,45.1
22093,Lamballe-Armor,16911,207134,204111,411245,24.3
45302,Saran,16866,1083780,246693,1330473,78.9
33056,Blanquefort,16786,1179579,429141,1608720,95.8
37214,Saint-Cyr-sur-Loire,16766,427298,198364,625662,37.3
33122,Cestas,16757,1758402,77895,1836297,109.6
93061,Le Pré-Saint-Gervais,16733,427239,136426,563665,33.7
6161,Villeneuve-Loubet,16729,804575,202720,1007295,60.2
8409,Sedan,16727,1142661,384239,1526900,91.3
44069,Guérande,16684,1237477,231065,1468542,88
13027,Châteaurenard,16668,859426,86837,946263,56.8
91471,Orsay,16655,753914,173000,926914,55.7
78372,Marly-le-Roi,16619,368400,23515,391915,23.6
44055,La Baule-Escoublac,16613,1699130,230082,1929212,116.1
55545,Verdun,16610,291700,1029529,1321229,79.5
45285,Saint-Jean-de-la-Ruelle,16608,286602,242919,529521,31.9
85109,Les Herbiers,16589,694741,70961,765702,46.2
49307,Loire-Authion,16588,1162124,268529,1430653,86.2
53062,Château-Gontier-sur-Mayenne,16539,390963,742497,1133460,68.5
9225,Pamiers,16512,715927,74340,790267,47.9
97224,Saint-Joseph,16470,280879,720017,1000896,60.8
34154,Mauguio,16417,688261,122334,810595,49.4
29103,Landerneau,16327,1211360,126542,1337902,81.9
44172,Sainte-Luce-sur-Loire,16227,829145,706190,1535335,94.6
78073,Bois-d'Arcy,16225,281188,134479,415667,25.6
1033,Valserhône,16162,616534,194632,811166,50.2
13077,Port-de-Bouc,16138,1812038,453583,2265621,140.4
78642,Verneuil-sur-Seine,16112,136491,149952,286443,17.8
42147,Montbrison,16098,1323508,144231,1467739,91.2
74225,Rumilly,16082,1351081,217784,1568865,97.6
81099,Gaillac,16080,497669,883480,1381149,85.9
95637,Vauréal,16079,167970,479396,647366,40.3
95199,Domont,16075,391036,28033,419069,26.1
91386,Mennecy,16071,375756,23614,399370,24.9
95563,Saint-Leu-la-Forêt,16047,478950,48647,527597,32.9
59526,Saint-Amand-les-Eaux,16042,1378849,603511,1982360,123.6
57306,Hayange,16013,945692,329075,1274767,79.6
77337,Noisiel,15927,1271988,170256,1442244,90.6
74243,Saint-Julien-en-Genevois,15925,1013267,62406,1075673,67.5
59569,Sin-le-Noble,15916,325655,221764,547419,34.4
78481,Le Pecq,15858,523981,22438,546419,34.5
97210,Le François,15858,166210,77913,244123,15.4
97607,Dembeni,15848,0,4242,4242,0.3
97116,Morne-à-l'Eau,15839,259862,224972,484834,30.6
56083,Hennebont,15831,856905,358059,1214964,76.7
77186,Fontainebleau,15787,283941,131440,415381,26.3
76231,Elbeuf,15774,2010094,450562,2460656,156
59648,Wattignies,15756,522854,260917,783771,49.7
78650,Le Vésinet,15712,596318,22232,618550,39.4
37233,Saint-Pierre-des-Corps,15698,488028,185728,673756,42.9
77131,Coulommiers,15696,496435,61128,557563,35.5
30032,Beaucaire,15695,518734,109845,628579,40
13039,Fos-sur-Mer,15694,6426242,441104,6867346,437.6
49218,Montrevault-sur-Èvre,15684,295498,148889,444387,28.3
76447,Montivilliers,15671,661629,141351,802980,51.2
69089,Francheville,15664,374095,1132621,1506716,96.2
28218,Lucé,15658,257587,456254,713841,45.6
49353,Trélazé,15620,417309,252859,670168,42.9
42279,Saint-Just-Saint-Rambert,15579,968022,139581,1107603,71.1
54528,Toul,15570,558408,32481,590889,38
41269,Vendôme,15566,357179,192529,549708,35.3
1004,Ambérieu-en-Bugey,15554,518685,265448,784133,50.4
13108,Tarascon,15525,513155,292684,805839,51.9
54323,Longwy,15492,446083,144655,590738,38.1
68376,Wittenheim,15491,778362,1079137,1857499,119.9
75101,Paris 1e,15475,2268700,0,2268700,146.6
42186,Rive-de-Gier,15457,747656,362162,1109818,71.8
40046,Biscarrosse,15412,906950,420612,1327562,86.1
29075,Guipavas,15401,236160,709093,945253,61.4
13015,Bouc-Bel-Air,15367,404318,431913,836231,54.4
70550,Vesoul,15306,280117,791773,1071890,70
31113,Castanet-Tolosan,15264,681809,248866,930675,61
60612,Senlis,15238,350450,0,350450,23
49015,Avrillé,15225,453249,246465,699714,46
29151,Morlaix,15220,824766,912577,1737343,114.1
95539,Saint-Brice-sous-Forêt,15209,254750,26523,281273,18.5
31446,Ramonville-Saint-Agne,15172,660929,247366,908295,59.9
54304,Laxou,15126,250807,505129,755936,50
77407,Saint-Fargeau-Ponthierry,15117,124563,210625,335188,22.2
68154,Illzach,15115,2352526,1052944,3405470,225.3
72154,La Flèche,15081,763175,109326,872501,57.9
63178,Issoire,15078,1074308,98014,1172322,77.8
37208,Saint-Avertin,15075,417723,178357,596080,39.5
2168,Château-Thierry,15068,541041,348286,889327,59
93013,Le Bourget,15052,625613,122721,748334,49.7
83107,Roquebrune-sur-Argens,15006,529377,531874,1061251,70.7
78124,Carrières-sur-Seine,15002,121000,21227,142227,9.5
22050,Dinan,14966,456696,398700,855396,57.2
54578,Villers-lès-Nancy,14938,719067,498851,1217918,81.5
59286,Haubourdin,14922,150435,247106,397541,26.6
95019,Arnouville,14898,457691,184757,642448,43.1
97120,Pointe-à-Pitre,14855,219990,81773,301763,20.3
77307,Montévrain,14847,157601,36704,194305,13.1
57606,Saint-Avold,14828,1561615,253185,1814800,122.4
97228,Sainte-Marie,14827,365290,134245,499535,33.7
45208,Montargis,14819,1065152,199641,1264793,85.3
93062,Le Raincy,14778,0,120487,120487,8.2
91645,Verrières-le-Buisson,14772,349084,153440,502524,34
57206,Fameck,14759,1276516,303305,1579821,107
10323,Romilly-sur-Seine,14751,519291,150750,670041,45.4
59043,Bailleul,14734,527561,90018,617579,41.9
64483,Saint-Jean-de-Luz,14690,2011332,381731,2393063,162.9
77258,Lognes,14678,463726,156905,620631,42.3
44154,Saint-Brevin-les-Pins,14645,433438,408716,842154,57.5
95427,Montmagny,14632,327384,25517,352901,24.1
55029,Bar-le-Duc,14615,852530,176203,1028733,70.4
78418,Montesson,14606,216120,20667,236787,16.2
1354,Saint-Genis-Pouilly,14584,301466,187730,489196,33.5
56178,Pontivy,14547,423353,101284,524637,36.1
22187,Plérin,14527,602823,230402,833225,57.4
76108,Bois-Guillaume,14497,491958,414087,906045,62.5
94074,Valenton,14453,264629,117837,382466,26.5
30258,Saint-Gilles,14427,592821,53137,645958,44.8
76157,Canteleu,14420,669602,411887,1081489,75
56007,Auray,14417,836707,557853,1394560,96.7
94069,Saint-Maurice,14411,142873,117494,260367,18.1
57751,Woippy,14394,864149,713663,1577812,109.6
83115,Sainte-Maxime,14394,862287,115341,977628,67.9
54431,Pont-à-Mousson,14383,605140,157147,762287,53
62765,Saint-Omer,14358,1632174,1277864,2910038,202.7
95487,Persan,14348,545966,51113,597079,41.6
82033,Castelsarrasin,14335,467370,184102,651472,45.4
97404,L'Étang-Salé,14329,466316,70206,536522,37.4
83090,Ollioules,14320,953521,617101,1570622,109.7
61169,Flers,14308,554518,383214,937732,65.5
21166,Chenôve,14299,952600,414947,1367547,95.6
60176,Crépy-en-Valois,14243,694964,55767,750731,52.7
31506,Saint-Orens-de-Gameville,14229,215797,347871,563668,39.6
59291,Hautmont,14197,765722,506416,1272138,89.6
29046,Douarnenez,14188,619703,450068,1069771,75.4
68278,Rixheim,14125,913763,983978,1897741,134.4
40279,Saint-Paul-lès-Dax,14114,278398,120825,399223,28.3
77251,Lieusaint,14096,192587,279476,472063,33.5
60395,Méru,14091,281520,45336,326856,23.2
64129,Billère,14037,713783,414450,1128233,80.4
59139,Caudry,14032,616089,96417,712506,50.8
25031,Audincourt,14009,774616,886822,1661438,118.6
97602,Bandraboua,13989,223350,0,223350,16
59367,Lys-lez-Lannoy,13987,561501,231622,793123,56.7
13097,Saint-Martin-de-Crau,13962,1209140,263218,1472358,105.5
79329,Thouars,13949,844270,217036,1061306,76.1
60414,Montataire,13944,1076804,143413,1220217,87.5
13014,Berre-l'Étang,13941,3805479,391833,4197312,301.1
97617,Tsingoni,13934,0,59196,59196,4.2
26235,Pierrelatte,13909,445820,215045,660865,47.5
59508,Roncq,13873,166996,229735,396731,28.6
84019,Bollène,13871,278127,127609,405736,29.3
91235,Fleury-Mérogis,13816,169250,138793,308043,22.3
85092,Fontenay-le-Comte,13806,581891,90583,672474,48.7
77479,Vaires-sur-Marne,13791,151625,147423,299048,21.7
34123,Juvignac,13776,79584,1092235,1171819,85.1
91432,Morangis,13773,459482,112293,571775,41.5
69019,Belleville-en-Beaujolais,13767,0,0,0,0
6033,Carros,13729,987369,270295,1257664,91.6
69283,Mions,13716,220133,991767,1211900,88.4
64348,Lons,13708,255970,404736,660706,48.2
78015,Andrésy,13663,85270,127159,212429,15.5
82112,Moissac,13652,380554,175331,555885,40.7
78242,Fontenay-le-Fleury,13640,915351,113053,1028404,75.4
19272,Tulle,13602,695545,258101,953646,70.1
35281,Saint-Jacques-de-la-Lande,13593,616296,696563,1312859,96.6
77014,Avon,13526,216055,112615,328670,24.3
61006,Argentan,13494,767725,28502,796227,59
67365,Ostwald,13492,270986,5241364,5512350,408.6
1173,Gex,13455,443556,173197,616753,45.8
69277,Genas,13446,433497,39741,473238,35.2
29212,Plouzané,13437,507241,618666,1125907,83.8
45004,Amilly,13432,323575,180955,504530,37.6
29189,Plougastel-Daoulas,13431,412169,618390,1030559,76.7
45155,Gien,13431,677897,173824,851721,63.4
59014,Anzin,13417,225547,258467,484014,36.1
62643,Outreau,13398,485410,452914,938324,70
3095,Cusset,13329,465496,365146,830642,62.3
74042,Bonneville,13320,427215,403344,830559,62.4
34270,Saint-Jean-de-Védas,13300,154910,1054496,1209406,90.9
81105,Graulhet,13275,643540,729366,1372906,103.4
65286,Lourdes,13266,765340,126736,892076,67.2
68166,Kingersheim,13265,1242690,924069,2166759,163.3
2738,Tergnier,13261,468597,238266,706863,53.3
97125,Saint-François,13249,0,238499,238499,18
59421,Mouvaux,13239,181854,219236,401090,30.3
84080,Monteux,13159,392471,52442,444913,33.8
71014,Autun,13144,608888,294082,902970,68.7
37003,Amboise,13132,465061,356443,821504,62.6
97402,Bras-Panon,13131,587889,74798,662687,50.5
77333,Nemours,13118,314060,6705,320765,24.5
57240,Freyming-Merlebach,13069,1511941,416659,1928600,147.6
31187,Fonsorbes,13048,139500,16206,155706,11.9
59560,Seclin,13011,283315,215460,498775,38.3
66037,Canet-en-Roussillon,13005,675007,108321,783328,60.2
13007,Auriol,12986,157065,364991,522056,40.2
62108,Berck,12967,921446,137950,1059396,81.7
45068,Châlette-sur-Loing,12958,395891,174569,570460,44
30351,Villeneuve-lès-Avignon,12950,12765,243037,255802,19.8
27701,Val-de-Reuil,12939,1147193,383714,1530907,118.3
85226,Saint-Hilaire-de-Riez,12923,202168,28112,230280,17.8
97405,Petite-Île,12920,508983,63302,572285,44.3
59527,Saint-André-lez-Lille,12909,543340,213771,757111,58.6
40312,Tarnos,12900,531837,366403,898240,69.6
28088,Châteaudun,12898,570162,704792,1274954,98.8
49246,Les Ponts-de-Cé,12863,361739,208228,569967,44.3
53147,Mayenne,12854,722730,477668,1200398,93.4
83049,Cuers,12841,139784,11128,150912,11.8
23096,Guéret,12814,360269,209266,569535,44.4
60471,Noyon,12810,184360,0,184360,14.4
50218,Granville,12799,476574,309760,786334,61.4
33366,Saint-André-de-Cubzac,12786,290067,72202,362269,28.3
35024,Betton,12775,832282,654645,1486927,116.4
14047,Bayeux,12754,438119,491562,929681,72.9
83148,Vidauban,12712,214900,158349,373249,29.4
34157,Mèze,12711,198890,499297,698187,54.9
10333,Saint-André-les-Vergers,12695,243892,181284,425176,33.5
3321,Yzeure,12670,314201,170550,484751,38.3
59152,Comines,12649,662696,209465,872161,69
33005,Andernos-les-Bains,12614,225251,42018,267269,21.2
10081,La Chapelle-Saint-Luc,12603,258963,179971,438934,34.8
77316,Moret-Loing-et-Orvanne,12576,288950,43740,332690,26.5
78029,Aubergenville,12540,380994,116708,497702,39.7
44132,Pornichet,12530,371885,461730,833615,66.5
28404,Vernouillet,12491,556078,16707,572785,45.9
7019,Aubenas,12488,832280,213149,1045429,83.7
29233,Quimperlé,12444,304710,427529,732239,58.8
93079,Villetaneuse,12432,208610,101359,309969,24.9
6012,Beausoleil,12430,441750,69763,511513,41.2
63284,Pont-du-Château,12422,134450,471056,605506,48.7
6104,Roquebrune-Cap-Martin,12419,337400,69701,407101,32.8
31561,L'Union,12410,763554,303400,1066954,86
27284,Gisors,12395,356450,10100,366550,29.6
6152,Valbonne,12389,860782,150129,1010911,81.6
57160,Creutzwald,12389,696230,76833,773063,62.4
78624,Triel-sur-Seine,12386,77200,115275,192475,15.5
77118,Claye-Souilly,12381,291914,153543,445457,36
60509,Pont-Sainte-Maxence,12343,304865,18038,322903,26.2
13081,Rognac,12335,588904,346694,935598,75.8
69027,Brignais,12330,1347797,333121,1680918,136.3
48095,Mende,12322,390592,486085,876677,71.1
42044,Le Chambon-Feugerolles,12307,406201,288356,694557,56.4
67348,Obernai,12303,889821,249661,1139482,92.6
95313,L'Isle-Adam,12302,237800,79986,317786,25.8
76484,Oissel,12287,448233,350961,799194,65
57630,Sarrebourg,12274,694144,79907,774051,63.1
62413,Harnes,12264,510563,330394,840957,68.6
56078,Guidel,12236,509482,276749,786231,64.3
44036,Châteaubriant,12231,290364,205137,495501,40.5
76057,Barentin,12227,172427,40834,213261,17.4
95351,Louvres,12226,367352,151621,518973,42.4
11076,Castelnaudary,12212,728640,107307,835947,68.5
67046,Bischwiller,12211,1078895,148476,1227371,100.5
83130,Solliès-Pont,12210,63120,203093,266213,21.8
72264,Sablé-sur-Sarthe,12194,1330435,283593,1614028,132.4
56206,Saint-Avé,12173,151389,112614,264003,21.7
62186,Bully-les-Mines,12172,218526,327915,546441,44.9
69069,Craponne,12170,125917,879980,1005897,82.7
73179,La Motte-Servolex,12167,469856,154654,624510,51.3
68271,Riedisheim,12154,620902,846674,1467576,120.7
59491,Raismes,12140,645033,456715,1101748,90.8
83042,Cogolin,12076,192255,96766,289021,23.9
94060,La Queue-en-Brie,12074,81100,98441,179541,14.9
91573,Saint-Pierre-du-Perray,12071,76174,239327,315501,26.1
12176,Onet-le-Château,12062,775997,184855,960852,79.7
13106,Septèmes-les-Vallons,12018,442026,337784,779810,64.9
66171,Saint-Cyprien,11995,273700,1172,274872,22.9
21617,Talant,11986,179904,347825,527729,44
59383,Marly,11980,392464,230785,623249,52
59574,Somain,11902,117223,143116,260339,21.9
57221,Florange,11891,1031185,244366,1275551,107.3
37050,Chambray-lès-Tours,11877,339806,140521,480327,40.4
31483,Saint-Gaudens,11869,616904,245849,862753,72.7
14341,Ifs,11868,247340,264088,511428,43.1
29235,Le Relecq-Kerhuon,11837,189952,544999,734951,62.1
77379,Provins,11824,252247,42634,294881,24.9
97221,Rivière-Salée,11818,104250,58064,162314,13.7
35210,Pacé,11815,587914,605450,1193364,101
84141,Vedène,11799,304255,221436,525691,44.6
97220,Rivière-Pilote,11797,410800,57961,468761,39.7
38485,Seyssinet-Pariset,11784,270795,455220,726015,61.6
91215,Épinay-sous-Sénart,11783,176792,133103,309895,26.3
30341,Vauvert,11772,380352,38598,418950,35.6
33284,Mios,11756,0,39160,39160,3.3
49018,Baugé-en-Anjou,11747,509630,41048,550678,46.9
68063,Cernay,11737,414204,197525,611729,52.1
57433,Maizières-lès-Metz,11725,247830,23800,271630,23.2
93030,Dugny,11723,222045,95579,317624,27.1
59386,Marquette-lez-Lille,11709,963586,193899,1157485,98.9
63430,Thiers,11686,581659,270946,852605,73
66172,Saint-Estève,11673,194695,97226,291921,25
83112,Saint-Cyr-sur-Mer,11668,199772,7248,207020,17.7
62570,Méricourt,11651,45035,313880,358915,30.8
94075,Villecresnes,11650,161185,94984,256169,22
97230,La Trinité,11622,82495,105226,187721,16.2
76114,Bolbec,11618,652780,88540,741320,63.8
95210,Enghien-les-Bains,11594,469727,20219,489946,42.3
59112,Bruay-sur-l'Escaut,11584,117240,223156,340396,29.4
38474,Sassenage,11579,358601,447301,805902,69.6
91552,Saint-Germain-lès-Arpajon,11577,109845,116301,226146,19.5
78674,Villepreux,11568,167564,288343,455907,39.4
76758,Yvetot,11548,342274,21362,363636,31.5
2A247,Porto-Vecchio,11536,726608,169190,895798,77.7
1160,Ferney-Voltaire,11530,350658,148418,499076,43.3
59249,Fourmies,11528,1105934,189113,1295047,112.3
77153,Dammartin-en-Goële,11508,174620,142716,317336,27.6
13075,Plan-de-Cuques,11504,800881,323337,1124218,97.7
91021,Arpajon,11503,71871,115557,187428,16.3
12300,Villefranche-de-Rouergue,11502,678434,33546,711980,61.9
33200,Le Haillan,11499,326807,293977,620784,54
2173,Chauny,11456,0,205835,205835,18
59273,Gravelines,11451,6150415,1398228,7548643,659.2
97401,Les Avirons,11445,291700,56076,347776,30.4
50041,La Hague,11444,2531777,359966,2891743,252.7
97615,Pamandzi,11442,12500,1954,14454,1.3
67204,Hœnheim,11413,447943,4433715,4881658,427.7
62617,Nœux-les-Mines,11384,181085,187862,368947,32.4
87154,Saint-Junien,11382,544667,248923,793590,69.7
77487,Vaux-le-Pénil,11378,136566,158530,295096,25.9
97306,Mana,11364,229236,53440,282676,24.9
51649,Vitry-le-François,11349,1158753,179016,1337769,117.9
22215,Ploufragan,11347,109931,179966,289897,25.5
44003,Ancenis-Saint-Géréon,11346,248290,138621,386911,34.1
67437,Saverne,11323,783304,798645,1581949,139.7
33051,Biganos,11303,358220,37651,395871,35
7324,Tournon-sur-Rhône,11302,472875,497297,970172,85.8
7102,Guilherand-Granges,11277,226430,220318,446748,39.6
37156,Montlouis-sur-Loire,11261,332364,201155,533519,47.4
44129,Pontchâteau,11249,247332,116789,364121,32.4
31488,Saint-Jean,11239,244868,274771,519639,46.2
74224,La Roche-sur-Foron,11239,878533,81919,960452,85.5
49125,Doué-en-Anjou,11227,368766,109383,478149,42.6
69271,Chassieu,11214,265457,810854,1076311,96
87114,Panazol,11207,341069,158922,499991,44.6
69273,Corbas,11196,795004,809552,1604556,143.3
66141,Pia,11174,223100,17202,240302,21.5
97616,Sada,11156,44800,47394,92194,8.3
77067,Cesson,11141,55200,220888,276088,24.8
83073,Le Luc,11124,104517,47604,152121,13.7
59544,Saint-Saulve,11121,922755,214237,1136992,102.2
68112,Guebwiller,11090,843478,273671,1117149,100.7
67130,Erstein,11076,257106,204782,461888,41.7
91200,Dourdan,11068,135808,64335,200143,18.1
74133,Gaillard,11054,149753,176650,326403,29.5
57660,Stiring-Wendel,11048,915483,201972,1117455,101.1
62758,Saint-Martin-Boulogne,11036,1076043,373067,1449110,131.3
42184,Riorges,11034,399563,325608,725171,65.7
31116,Castelginest,11033,123757,269735,393492,35.7
83071,La Londe-les-Maures,11010,357575,9542,367117,33.3
76410,Maromme,11005,230819,314342,545161,49.5
49050,Brissac Loire Aubance,11000,443816,218375,662191,60.2
59636,Wambrechies,10984,313662,181893,495555,45.1
33519,Le Taillan-Médoc,10966,116647,280350,396997,36.2
44204,Thouaré-sur-Loire,10956,81380,476799,558179,50.9
36088,Issoudun,10953,271850,258611,530461,48.4
28229,Mainvilliers,10950,289992,319069,609061,55.6
13110,Trets,10933,174878,307289,482167,44.1
37109,Fondettes,10917,600422,129163,729585,66.8
21171,Chevigny-Saint-Sauveur,10895,520625,316165,836790,76.8
33009,Arcachon,10895,956698,249185,1205883,110.7
59011,Annœullin,10887,275258,180287,455545,41.8
81140,Lavaur,10884,375789,35549,411338,37.8
69243,Tarare,10881,1033101,128613,1161714,106.8
92077,Ville-d'Avray,10871,548228,88632,636860,58.6
11203,Lézignan-Corbières,10855,584886,147073,731959,67.4
57019,Amnéville,10853,509381,2719,512100,47.2
74208,Passy,10852,905375,113645,1019020,93.9
6084,Mouans-Sartoux,10847,664255,276943,941198,86.8
38317,Le Pont-de-Claix,10846,715434,418985,1134419,104.6
64430,Orthez,10836,465032,291771,756803,69.8
91086,Bondoufle,10833,211512,214782,426294,39.4
13069,Pélissanne,10799,130725,303522,434247,40.2
78138,Chanteloup-les-Vignes,10793,514900,100449,615349,57
63032,Beaumont,10787,271914,409055,680969,63.1
66008,Argelès-sur-Mer,10779,647561,44513,692074,64.2
30202,Pont-Saint-Esprit,10759,207806,156998,364804,33.9
5023,Briançon,10748,460050,766732,1226782,114.1
60141,Chantilly,10740,360000,215243,575243,53.6
72003,Allonnes,10740,1035841,219717,1255558,116.9
78688,Voisins-le-Bretonneux,10740,344421,267704,612125,57
33238,Léognan,10723,83936,96844,180780,16.9
31588,Villeneuve-Tolosane,10704,96253,261692,357945,33.4
60157,Clermont,10704,470910,56773,527683,49.3
62318,Étaples,10693,226568,113758,340326,31.8
76216,Déville-lès-Rouen,10690,142774,305345,448119,41.9
35069,Châteaugiron,10688,179445,307581,487026,45.6
51573,Tinqueux,10662,252178,189484,441662,41.4
64422,Oloron-Sainte-Marie,10658,898128,229521,1127649,105.8
24053,Boulazac Isle Manoire,10628,1110090,59356,1169446,110
91216,Épinay-sur-Orge,10626,138241,110375,248616,23.4
25580,Valentigney,10624,942683,672539,1615222,152
64545,Urrugne,10594,316180,275293,591473,55.8
94055,Ormesson-sur-Marne,10589,239750,86333,326083,30.8
83098,Le Pradet,10582,293778,456017,749795,70.9
78190,Croissy-sur-Seine,10580,120204,14970,135174,12.8
91312,Igny,10571,328471,109804,438275,41.5
62525,Longuenesse,10559,734071,939752,1673823,158.5
34255,Saint-Gély-du-Fesc,10530,97320,196202,293522,27.9
70285,Héricourt,10525,751608,68738,820346,77.9
45075,La Chapelle-Saint-Mesmin,10492,129225,153463,282688,26.9
6149,La Trinité,10485,195261,206428,401689,38.3
62548,Marck,10468,467736,314625,782361,74.7
38085,Charvieu-Chavagneux,10459,300095,11687,311782,29.8
10362,Sainte-Savine,10457,181082,149326,330408,31.6
59616,Vieux-Condé,10455,478852,201407,680259,65.1
1249,Miribel,10450,401088,336898,737986,70.6
84088,Pernes-les-Fontaines,10433,353307,41578,394885,37.8
97124,Saint-Claude,10432,86710,47045,133755,12.8
97223,Saint-Esprit,10422,105000,51205,156205,15
44209,Treillières,10414,411546,62004,473550,45.5
66028,Cabestany,10414,113671,86740,200411,19.2
76165,Caudebec-lès-Elbeuf,10414,167896,297461,465357,44.7
74298,Vétraz-Monthoux,10412,212389,166390,378779,36.4
33312,Parempuyre,10407,33246,266059,299305,28.8
35093,Dinard,10407,587418,347204,934622,89.8
34337,Villeneuve-lès-Maguelone,10406,146831,825044,971875,93.4
77464,Thorigny-sur-Marne,10405,115570,25723,141293,13.6
76476,Port-Jérôme-sur-Seine,10392,1980420,79197,2059617,198.2
35055,Chantepie,10378,167709,531813,699522,67.4
2810,Villers-Cotterêts,10376,126801,9986,136787,13.2
26252,Portes-lès-Valence,10369,573650,210188,783838,75.6
67067,Brumath,10369,600988,126079,727067,70.1
68375,Wittelsheim,10364,600739,721979,1322718,127.6
91661,Villebon-sur-Yvette,10353,1352356,107539,1459895,141
44015,Blain,10352,164094,131710,295804,28.6
37195,La Riche,10349,150116,122443,272559,26.3
11206,Limoux,10339,920192,136096,1056288,102.2
42005,Andrézieux-Bouthéon,10312,1483188,241613,1724801,167.3
1143,Divonne-les-Bains,10300,536045,132585,668630,64.9
84003,Apt,10297,443550,209890,653440,63.5
31033,Auterive,10291,339576,54131,393707,38.3
14437,Mondeville,10286,1274196,228885,1503081,146.1
97603,Bandrele,10282,213860,102798,316658,30.8
68256,Pfastatt,10275,604907,715779,1320686,128.5
59324,Jeumont,10273,812713,366444,1179157,114.8
63014,Aubière,10273,401860,389564,791424,77
63164,Gerzat,10268,228654,389374,618028,60.2
62637,Oignies,10260,246249,162692,408941,39.9
86041,Buxerolles,10253,370166,610863,981029,95.7
95250,Fosses,10249,426506,127103,553609,54
13040,Fuveau,10235,103150,287670,390820,38.2
95488,Pierrelaye,10230,124695,31013,155708,15.2
50025,Avranches,10225,384210,251579,635789,62.2
50099,Carentan-les-Marais,10220,167030,55385,222415,21.8
85003,Aizenay,10218,202242,87252,289494,28.3
29058,Fouesnant,10204,168947,111306,280253,27.5
97614,Ouangani,10203,68000,43345,111345,10.9
62516,Lillers,10200,492434,168323,660757,64.8
6018,Biot,10196,381900,123554,505454,49.6
31547,Seysses,10167,68900,12628,81528,8
62250,Courrières,10160,201030,161107,362137,35.6
13019,Cabriès,10143,224930,285085,510015,50.3
59426,Neuville-en-Ferrain,10125,596607,167668,764275,75.5
62048,Auchel,10124,104448,167069,271517,26.8
81163,Mazamet,10123,530212,106480,636692,62.9
79202,Parthenay,10121,380919,265352,646271,63.9
59179,Douchy-les-Mines,10112,528466,380420,908886,89.9
2B042,Borgo,10102,142161,188367,330528,32.7
54482,Saint-Max,10100,68020,337287,405307,40.1
83016,Le Beausset,10098,125000,6273,131273,13
38158,Eybens,10095,907439,389974,1297413,128.5
54580,Villerupt,10086,379299,86962,466261,46.2
97360,Apatou,10059,373400,47303,420703,41.8
16374,Soyaux,10057,904968,261465,1166433,116
33433,Saint-Loubès,10057,176155,21108,197263,19.6
13043,Gignac-la-Nerthe,10030,212427,281908,494335,49.3
56165,Ploërmel,10021,1145804,150902,1296706,129.4
95394,Méry-sur-Oise,10015,143143,65116,208259,20.8
54357,Maxéville,10014,483496,334415,817911,81.7
87050,Couzeix,10011,119368,141962,261330,26.1
77183,La Ferté-sous-Jouarre,10004,381288,38960,420248,42
59008,Aniche,10001,440325,120257,560582,56.1
40281,Saint-Pierre-du-Mont,9996,336580,123712,460292,46
35278,Saint-Grégoire,9992,571444,512032,1083476,108.4
77449,Serris,9988,192554,283960,476514,47.7
78643,Vernouillet,9953,169214,92631,261845,26.3
13050,Lambesc,9951,190250,279688,469938,47.2
27467,Pont-Audemer,9950,226059,224758,450817,45.3
66180,Saint-Laurent-de-la-Salanque,9941,101802,82800,184602,18.6
69096,Grigny,9941,740414,718807,1459221,146.8
57447,Marly,9937,327134,492682,819816,82.5
95052,Beaumont-sur-Oise,9931,511837,35378,547215,55.1
81060,Carmaux,9927,415645,227111,642756,64.7
60139,Chambly,9909,1369579,41157,1410736,142.4
83086,Le Muy,9882,113960,123097,237057,24
22136,Loudéac,9875,222616,0,222616,22.5
42189,Roche-la-Molière,9853,291845,230859,522704,53.1
38565,Voreppe,9845,315584,167250,482834,49
45169,Ingré,9838,315087,143897,458984,46.7
35240,Le Rheu,9823,385767,503372,889139,90.5
74282,Fillière,9812,68030,75793,143823,14.7
31203,Frouzins,9808,71110,12182,83292,8.5
83072,Lorgues,9803,319172,122113,441285,45
27056,Bernay,9801,155249,42253,197502,20.2
31433,Portet-sur-Garonne,9798,353241,12170,365411,37.3
95229,Ézanville,9789,153600,17071,170671,17.4
58086,Cosne-Cours-sur-Loire,9786,298322,195107,493429,50.4
26057,Bourg-de-Péage,9777,291620,198188,489808,50.1
31499,Saint-Lys,9776,318228,12142,330370,33.8
17028,Aytré,9759,861349,270814,1132163,116
46102,Figeac,9757,556042,288131,844173,86.5
97212,Gros-Morne,9752,51881,88295,140176,14.4
83054,La Farlède,9745,363605,162091,525696,53.9
9122,Foix,9731,396182,261550,657732,67.6
59400,Merville,9729,250942,159698,410640,42.2
69276,Feyzin,9727,1509031,703333,2212364,227.4
76319,Grand-Couronne,9722,343148,277695,620843,63.9
31291,Léguevin,9710,304477,2969,307446,31.7
33422,Saint-Jean-d'Illac,9702,322117,45100,367217,37.8
18197,Saint-Amand-Montrond,9690,416584,42698,459282,47.4
31451,Revel,9686,544464,196918,741382,76.5
14431,Mézidon Vallée d'Auge,9678,150246,107729,257975,26.7
81271,Saint-Sulpice-la-Pointe,9674,273360,31597,304957,31.5
62587,Montigny-en-Gohelle,9667,153776,153289,307065,31.8
59090,Bondues,9666,502411,160067,662478,68.5
80016,Albert,9658,228715,10799,239514,24.8
76212,Darnétal,9652,150380,275696,426076,44.1
18205,Saint-Doulchard,9650,283200,184837,468037,48.5
62771,Sallaumines,9633,89418,259514,348932,36.2
13051,Lançon-Provence,9627,193617,270582,464199,48.2
76618,Petit-Caux,9626,263050,60886,323936,33.7
44009,Basse-Goulaine,9617,232550,418526,651076,67.7
91191,Crosne,9606,128686,108511,237197,24.7
31022,Aucamville,9578,165668,234163,399831,41.7
62014,Aire-sur-la-Lys,9568,885437,851553,1736990,181.5
59339,Leers,9555,153222,158229,311451,32.6
33019,Audenge,9550,25800,31812,57612,6
13100,Saint-Rémy-de-Provence,9547,649028,17574,666602,69.8
34198,Pérols,9541,183175,756462,939637,98.5
64335,Lescar,9540,347905,281674,629579,66
45286,Saint-Jean-le-Blanc,9534,155157,139450,294607,30.9
57591,Rombas,9534,991611,2388,993999,104.3
54159,Dombasle-sur-Meurthe,9528,382946,75819,458765,48.1
62040,Arques,9526,1007053,847815,1854868,194.7
44212,Vallet,9524,234891,98631,333522,35
95051,Beauchamp,9506,149300,28818,178118,18.7
32160,L'Isle-Jourdain,9499,337733,675739,1013472,106.7
49267,Saint-Barthélemy-d'Anjou,9496,429491,153723,583214,61.4
91514,Quincy-sous-Sénart,9491,75715,107212,182927,19.3
91122,Bures-sur-Yvette,9481,134604,98481,233085,24.6
66065,Elne,9479,0,39145,39145,4.1
44195,Savenay,9465,155590,210392,365982,38.7
47310,Tonneins,9461,466522,97885,564407,59.7
85128,Luçon,9450,296224,199721,495945,52.5
44110,Nort-sur-Erdre,9448,141346,56253,197599,20.9
97105,Basse-Terre,9419,179780,42477,222257,23.6
83034,Carqueiranne,9412,272716,405597,678313,72.1
44188,Saint-Philbert-de-Grand-Lieu,9392,186865,44518,231383,24.6
97357,Grand-Santi,9390,390125,44157,434282,46.2
34079,Clermont-l'Hérault,9372,309148,10678,319826,34.1
54274,Jarville-la-Malgrange,9362,1152561,312642,1465203,156.5
47201,Le Passage,9360,154949,214268,369217,39.4
59343,Lesquin,9356,150400,154934,305334,32.6
78356,Magny-les-Hameaux,9353,222982,233132,456114,48.8
35236,Redon,9336,705402,133188,838590,89.8
67300,Molsheim,9328,351180,24033,375213,40.2
28280,Nogent-le-Rotrou,9305,376295,3624,379919,40.8
57283,Hagondange,9300,520497,18878,539375,58
59153,Condé-sur-l'Escaut,9297,237140,179099,416239,44.8
84138,Valréas,9285,722576,249967,972543,104.7
54382,Mont-Saint-Martin,9282,657601,86670,744271,80.2
97227,Sainte-Luce,9275,245900,45570,291470,31.4
26165,Livron-sur-Drôme,9272,147389,112314,259703,28
1034,Belley,9270,402375,103318,505693,54.6
34090,Le Crès,9267,143015,734738,877753,94.7
56243,Séné,9265,230844,85712,316556,34.2
14488,Ouistreham,9261,369875,206077,575952,62.2
71342,Paray-le-Monial,9256,578868,35887,614755,66.4
91425,Montlhéry,9238,113410,95957,209367,22.7
74119,Évian-les-Bains,9224,1197678,477903,1675581,181.7
40065,Capbreton,9218,262640,207101,469741,51
69043,Chaponost,9217,899015,249017,1148032,124.6
31282,Launaguet,9216,69672,225313,294985,32
33527,Le Teich,9213,78938,210715,289653,31.4
35126,Guichen,9203,444651,83051,527702,57.3
29105,Landivisiau,9197,685706,67923,753629,81.9
74305,Ville-la-Grand,9196,186593,146958,333551,36.3
19275,Ussel,9174,202833,125767,328600,35.8
58303,Varennes-Vauzelles,9166,120526,493002,613528,66.9
44198,Les Sorinières,9163,102774,398769,501543,54.7
73213,La Ravoire,9154,135325,116356,251681,27.5
66164,Rivesaltes,9151,173834,76220,250054,27.3
60346,Lamorlaye,9097,361108,182315,543423,59.7
78092,Bougival,9083,542729,75283,618012,68
1313,Prévessin-Moëns,9081,175307,116894,292201,32.2
62126,Beuvry,9078,98936,149807,248743,27.4
74264,Scionzier,9074,207565,82560,290125,32
56240,Sarzeau,9068,196350,83889,280239,30.9
34116,Grabels,9060,215084,718326,933410,103
59205,Escaudain,9060,177490,340843,518333,57.2
77268,Magny-le-Hongre,9058,111474,257520,368994,40.7
77495,Vert-Saint-Denis,9057,87375,179570,266945,29.5
89206,Joigny,9055,228391,70975,299366,33.1
54526,Tomblaine,9040,93941,301889,395830,43.8
31232,Grenade,9039,190797,75613,266410,29.5
21278,Fontaine-lès-Dijon,9032,239755,262102,501857,55.6
74213,Poisy,9032,161907,69768,231675,25.7
91105,Breuillet,9023,67970,90644,158614,17.6
78401,Meulan-en-Yvelines,8996,24000,83724,107724,12
84081,Morières-lès-Avignon,8996,192648,168831,361479,40.2
35152,Liffré,8987,627727,35007,662734,73.7
42323,Veauche,8984,271742,162843,434585,48.4
45252,Pithiviers,8981,189777,11164,200941,22.4
69072,Dardilly,8980,557130,649319,1206449,134.3
13037,La Fare-les-Oliviers,8953,136218,251638,387856,43.3
63063,Cébazat,8949,156738,339356,496094,55.4
45089,Chécy,8948,281809,130879,412688,46.1
76305,Gonfreville-l'Orcher,8939,1808884,80629,1889513,211.4
60282,Gouvieux,8934,234889,179048,413937,46.3
64140,Boucau,8934,329130,232157,561287,62.8
97606,Chirongui,8920,70550,89181,159731,17.9
69100,Irigny,8909,1009353,644186,1653539,185.6
56185,Quéven,8906,121188,201432,322620,36.2
3023,Bellerive-sur-Allier,8898,130716,243759,374475,42.1
21515,Quetigny,8897,537330,258185,795515,89.4
84043,Entraigues-sur-la-Sorgue,8888,250899,166804,417703,47
84132,Le Thor,8887,135408,74103,209511,23.6
77327,Nangis,8883,272500,114362,386862,43.6
43137,Monistrol-sur-Loire,8874,593609,801368,1394977,157.2
31417,Pibrac,8828,322479,215827,538306,61
13112,Velaux,8827,182020,248096,430116,48.7
88209,Golbey,8827,591518,221975,813493,92.2
62667,Le Portel,8824,731383,298292,1029675,116.7
13086,Roquevaire,8823,201019,247984,449003,50.9
7319,Le Teil,8812,205743,188667,394410,44.8
49248,Ombrée d'Anjou,8811,375925,8788,384713,43.7
85234,Saint-Jean-de-Monts,8809,488068,135863,623931,70.8
17274,Périgny,8802,472572,244257,716829,81.4
21355,Longvic,8787,405117,254993,660110,75.1
24520,Sarlat-la-Canéda,8786,449979,55353,505332,57.5
59143,La Chapelle-d'Armentières,8782,234513,145428,379941,43.3
26324,Saint-Paul-Trois-Châteaux,8776,727684,135685,863369,98.4
72132,La Ferté-Bernard,8769,316381,53498,369879,42.2
76497,Petit-Couronne,8738,278575,249589,528164,60.4
62895,Wingles,8734,72916,235295,308211,35.3
54184,Essey-lès-Nancy,8733,54735,291637,346372,39.7
26108,Crest,8712,213675,236802,450477,51.7
49080,Les Hauts-d'Anjou,8712,85769,252484,338253,38.8
76384,Lillebonne,8708,1313625,66363,1379988,158.5
30003,Aigues-Mortes,8707,168598,55939,224537,25.8
60382,Margny-lès-Compiègne,8700,106600,78357,184957,21.3
33138,Coutras,8695,202000,169605,371605,42.7
30011,Les Angles,8694,136084,163163,299247,34.4
77215,Gretz-Armainvilliers,8682,140794,52864,193658,22.3
93039,L'Île-Saint-Denis,8682,432084,70785,502869,57.9
35066,Chartres-de-Bretagne,8678,568245,444697,1012942,116.7
62724,Rouvroy,8675,115630,137559,253189,29.2
59033,Aulnoye-Aymeries,8674,1319757,309407,1629164,187.8
74056,Chamonix-Mont-Blanc,8673,1516242,3841934,5358176,617.8
13092,Saint-Chamas,8669,217747,243655,461402,53.2
3101,Domérat,8665,194420,203962,398382,46
62473,Isbergues,8653,450169,142794,592963,68.5
63193,Lempdes,8646,102840,327866,430706,49.8
14061,Souleuvre en Bocage,8643,118372,3948,122320,14.2
74112,Epagny Metz-Tessy,8642,253040,66755,319795,37
85178,Le Poiré-sur-Vie,8637,493137,73752,566889,65.6
29160,Plabennec,8633,156027,67603,223630,25.9
35334,Thorigné-Fouillard,8631,142286,442289,584575,67.7
33013,Artigues-près-Bordeaux,8623,48658,220451,269109,31.2
35136,Janzé,8618,127758,167768,295526,34.3
91363,Marcoussis,8597,257002,89299,346301,40.3
62842,Vendin-le-Vieil,8596,66876,231577,298453,34.7
44084,Le Loroux-Bottereau,8595,335622,89010,424632,49.4
79079,Mauléon,8585,171550,244214,415764,48.4
38344,Roussillon,8584,574524,219437,793961,92.5
29051,Ergué-Gabéric,8576,137203,275297,412500,48.1
31150,Cornebarrieu,8571,172710,209544,382254,44.6
59447,Onnaing,8567,239774,165036,404810,47.3
2381,Hirson,8565,622023,168129,790152,92.3
38545,Vif,8557,65243,330560,395803,46.3
39478,Saint-Claude,8556,285936,31498,317434,37.1
7186,Privas,8552,328437,28535,356972,41.7
44194,Sautron,8534,691013,371395,1062408,124.5
97217,Le Marin,8526,255300,41890,297190,34.9
95060,Bessancourt,8521,86554,25832,112386,13.2
85051,Chantonnay,8518,800,43365,44165,5.2
30133,Le Grau-du-Roi,8513,1477007,54692,1531699,179.9
13078,Port-Saint-Louis-du-Rhône,8510,947282,239187,1186469,139.4
34344,La Grande-Motte,8508,407400,63399,470799,55.3
71486,Saint-Vallier,8508,136891,136708,273599,32.2
92076,Vaucresson,8506,252508,69350,321858,37.8
42316,Unieux,8495,466977,199040,666017,78.4
6095,Peymeinade,8491,161200,216791,377991,44.5
59457,Pérenchies,8487,1012283,140543,1152826,135.8
97232,Le Vauclin,8481,150033,41669,191702,22.6
31526,La Salvetat-Saint-Gilles,8477,67080,2592,69672,8.2
56251,Theix-Noyalo,8476,93414,78413,171827,20.3
83099,Puget-sur-Argens,8473,520317,300318,820635,96.9
45082,Châteauneuf-sur-Loire,8470,201850,16467,218317,25.8
38140,Crolles,8463,1015370,157251,1172621,138.6
22360,Trégueux,8462,384669,134209,518878,61.3
29260,Saint-Renan,8454,157102,15228,172330,20.4
49261,Gennes-Val-de-Loire,8452,1700,82347,84047,9.9
40310,Soustons,8445,178814,189734,368548,43.6
34299,Sérignan,8437,97000,48875,145875,17.3
88465,Thaon-les-Vosges,8433,479507,212067,691574,82
76561,Saint-Aubin-lès-Elbeuf,8429,696901,240763,937664,111.2
97353,Maripasoula,8423,119434,39610,159044,18.9
13113,Venelles,8420,341845,236657,578502,68.7
29220,Pont-l'Abbé,8403,248592,315390,563982,67.1
59449,Orchies,8390,438853,143191,582044,69.4
53097,Évron,8380,152409,59944,212353,25.3
95288,Groslay,8378,214059,14610,228669,27.3
50147,Coutances,8372,90245,242236,332481,39.7
30156,Marguerittes,8370,142210,30828,173038,20.7
42094,Feurs,8370,755977,151714,907691,108.4
56107,Larmor-Plage,8368,153292,189264,342556,40.9
83019,Bormes-les-Mimosas,8361,377414,7246,384660,46
30334,Uzès,8360,528382,64241,592623,70.9
13032,Éguilles,8349,77800,234661,312461,37.4
37018,Ballan-Miré,8347,273559,98756,372315,44.6
33096,Carbon-Blanc,8342,259482,213267,472749,56.7
95491,Le Plessis-Bouchard,8333,73794,25262,99056,11.9
85288,Talmont-Saint-Hilaire,8327,134063,167181,301244,36.2
34202,Pignan,8326,123502,660130,783632,94.1
77470,Tournan-en-Brie,8324,332800,50684,383484,46.1
38524,Varces-Allières-et-Risset,8314,82121,321173,403294,48.5
76095,Bihorel,8299,431262,237049,668311,80.5
76341,Harfleur,8296,176171,74829,251000,30.3
76640,Saint-Pierre-lès-Elbeuf,8295,159096,236935,396031,47.7
97605,Chiconi,8295,0,35240,35240,4.2
44018,Bouaye,8281,84739,360384,445123,53.8
35352,Vern-sur-Seiche,8272,541092,423892,964984,116.7
59588,Téteghem-Coudekerque-Village,8272,233472,1010055,1243527,150.3
83009,Bandol,8263,370013,5133,375146,45.4
17449,Tonnay-Charente,8248,324724,135825,460549,55.8
44210,Trignac,8234,275620,303422,579042,70.3
29069,Guilers,8221,417408,378511,795919,96.8
66210,Thuir,8215,383566,110112,493678,60.1
97119,Petit-Canal,8206,169223,116555,285778,34.8
1244,Meximieux,8198,24365,139909,164274,20
31056,Beauzelle,8184,206940,200083,407023,49.7
67471,Souffelweyersheim,8182,821265,3178538,3999803,488.9
59352,Linselles,8177,422205,135410,557615,68.2
68056,Brunstatt-Didenheim,8176,304186,569558,873744,106.9
62563,Mazingarbe,8164,542691,219939,762630,93.4
42183,La Ricamarie,8162,560895,191238,752133,92.2
71105,Charnay-lès-Mâcon,8154,217753,208278,426031,52.2
6044,La Colle-sur-Loup,8143,117150,98676,215826,26.5
6090,Pégomas,8143,79498,207905,287403,35.3
85222,Saint-Gilles-Croix-de-Vie,8140,990344,17707,1008051,123.8
91665,La Ville-du-Bois,8140,193501,84552,278053,34.2
69009,Anse,8139,187374,73349,260723,32
33032,Bassens,8132,348508,207898,556406,68.4
33498,Salles,8128,200113,28890,229003,28.2
38509,La Tour-du-Pin,8123,230359,71232,301591,37.1
37072,Chinon,8121,122013,445754,567767,69.9
44052,Donges,8117,302955,299111,602066,74.2
74220,Reignier-Ésery,8112,314491,34943,349434,43.1
54273,Jarny,8090,239952,75115,315067,38.9
38486,Seyssins,8087,453944,312404,766348,94.8
56184,Questembert,8081,120766,57260,178026,22
42302,Sorbiers,8071,358125,189106,547231,67.8
30217,Rochefort-du-Gard,8067,97676,151396,249072,30.9
33236,Lège-Cap-Ferret,8051,321825,26818,348643,43.3
40284,Saint-Vincent-de-Tyrosse,8051,202822,180882,383704,47.7
41295,Vineuil,8050,268833,308524,577357,71.7
72095,Coulaines,8049,708695,164665,873360,108.5
34150,Marseillan,8047,416450,316092,732542,91
62907,Libercourt,8047,84174,127601,211775,26.3
56101,Languidic,8046,82596,181981,264577,32.9
68374,Wintzenheim,8045,182663,165337,348000,43.3
57663,Talange,8044,571044,16328,587372,73
39097,Champagnole,8035,301436,81352,382788,47.6
65047,Aureilhan,8033,328192,76743,404935,50.4
37159,Monts,8031,103300,127840,231140,28.8
62133,Billy-Montigny,8027,0,216249,216249,26.9
45191,Le Malesherbois,8022,321839,60798,382637,47.7
62249,Courcelles-lès-Lens,8015,170730,127094,297824,37.2
76429,Le Mesnil-Esnard,7998,157060,228452,385512,48.2
31490,Saint-Jory,7996,0,195486,195486,24.4
19123,Malemort,7995,124077,127599,251676,31.5
35206,Noyal-Châtillon-sur-Seiche,7995,309042,409698,718740,89.9
91097,Boussy-Saint-Antoine,7986,49500,90211,139711,17.5
78322,Jouy-en-Josas,7985,118931,66183,185114,23.2
33273,Martignas-sur-Jalle,7959,269675,203475,473150,59.4
91479,Paray-Vieille-Poste,7956,200500,64866,265366,33.4
22106,Langueux,7947,270318,126041,396359,49.9
49323,Verrières-en-Anjou,7946,538153,128631,666784,83.9
38507,Tignieu-Jameyzieu,7944,30486,41012,71498,9
30034,Bellegarde,7929,307975,55493,363468,45.8
12208,Saint-Affrique,7924,175720,16602,192322,24.3
57269,Guénange,7922,142063,50760,192823,24.3
87075,Isle,7915,286081,112239,398320,50.3
70310,Lure,7912,205179,347795,552974,69.9
59317,Houplines,7907,282448,130939,413387,52.3
54099,Val de Briey,7906,111555,73406,184961,23.4
63307,Romagnat,7905,309740,299767,609507,77.1
62004,Achicourt,7899,426210,222171,648381,82.1
66195,Le Soler,7896,116243,65767,182010,23.1
83036,Cavalaire-sur-Mer,7895,1434358,63264,1497622,189.7
59131,Cappelle-la-Grande,7865,343465,960358,1303823,165.8
74250,Saint-Pierre-en-Faucigny,7848,156214,57203,213417,27.2
78267,Gargenville,7848,121560,73040,194600,24.8
83004,Les Arcs,7844,145310,97710,243020,31
38111,Claix,7840,343417,302862,646279,82.4
35196,Mordelles,7831,710078,401293,1111371,141.9
69092,Gleizé,7824,245556,166110,411666,52.6
27016,Les Andelys,7822,260150,41100,301250,38.5
54339,Malzéville,7818,108190,261080,369270,47.2
45028,Beaugency,7811,163817,32185,196002,25.1
49214,Montreuil-Juigné,7811,412223,126446,538669,69
69143,Neuville-sur-Saône,7807,934730,564503,1499233,192
91045,Ballancourt-sur-Essonne,7795,67282,11454,78736,10.1
34022,Baillargues,7793,116600,617871,734471,94.2
74218,Publier,7793,398000,403762,801762,102.9
34199,Pézenas,7789,230581,86512,317093,40.7
59653,Wavrin,7777,95749,128786,224535,28.9
4209,Sisteron,7776,382788,231820,614608,79
61214,L'Aigle,7771,210866,80108,290974,37.4
68334,Thann,7769,592014,130746,722760,93
44169,Saint-Julien-de-Concelles,7768,82093,80445,162538,20.9
45274,Saint-Denis-en-Val,7768,269529,113620,383149,49.3
57323,Hettange-Grande,7768,129650,189120,318770,41
33376,Saint-Aubin-de-Médoc,7764,107528,198490,306018,39.4
16113,La Couronne,7759,584472,201721,786193,101.3
67152,Geispolsheim,7759,1919476,3014212,4933688,635.9
78575,Saint-Rémy-lès-Chevreuse,7747,173358,9769,183127,23.6
14258,Falaise,7744,298655,121310,419965,54.2
78350,Louveciennes,7744,449885,10957,460842,59.5
93074,Vaujours,7743,110085,63129,173214,22.4
44158,Saint-Étienne-de-Montluc,7739,190048,172026,362074,46.8
2B096,Corte,7737,259900,133663,393563,50.9
31032,Aussonne,7731,156667,189008,345675,44.7
6048,Contes,7722,548230,217750,765980,99.2
49373,Lys-Haut-Layon,7722,295311,320873,616184,79.8
66021,Bompas,7712,87677,64235,151912,19.7
38416,Saint-Marcellin,7705,266819,124518,391337,50.8
42330,Villars,7705,167105,180530,347635,45.1
97612,Mtsamboro,7705,98595,0,98595,12.8
35012,Bain-de-Bretagne,7704,429239,112121,541360,70.3
38022,Les Avenières Veyrins-Thuellin,7699,239159,39747,278906,36.2
59431,Nieppe,7685,288410,46952,335362,43.6
88196,Gérardmer,7685,783596,12931,796527,103.6
64547,Ustaritz,7684,292973,199675,492648,64.1
52269,Langres,7683,364791,35253,400044,52.1
64125,Bidart,7674,206169,199415,405584,52.9
44087,Machecoul-Saint-Même,7665,137723,100802,238525,31.1
38517,Tullins,7657,257805,130080,387885,50.7
56177,Pluvigner,7644,154910,295778,450688,59
38537,La Verpillière,7643,34000,92872,126872,16.6
97114,Goyave,7640,131978,20882,152860,20
2B037,Biguglia,7638,145500,142422,287922,37.7
78062,Beynes,7635,83730,3296,87026,11.4
36063,Déols,7618,622151,282349,904500,118.7
64256,Hasparren,7615,162386,197882,360268,47.3
57666,Terville,7609,608489,79971,688460,90.5
78455,Noisy-le-Roi,7597,123049,62967,186016,24.5
86115,Jaunay-Marigny,7597,224705,452622,677327,89.2
17200,Lagord,7594,215095,210735,425830,56.1
21038,Auxonne,7592,90599,0,90599,11.9
7281,Saint-Péray,7591,101154,148305,249459,32.9
95574,Saint-Prix,7588,162502,13233,175735,23.2
29241,Rosporden,7580,307708,83475,391183,51.6
38239,Moirans,7573,540955,128653,669608,88.4
13104,Sausset-les-Pins,7556,113095,212373,325468,43.1
16358,Saint-Yrieix-sur-Charente,7556,269725,196443,466168,61.7
66049,Céret,7544,308452,312884,621336,82.4
67544,Wissembourg,7541,219995,830889,1050884,139.4
74123,Faverges-Seythenex,7540,452250,62172,514422,68.2
24138,Coulounieix-Chamiers,7537,215153,42093,257246,34.1
77169,Émerainville,7536,28310,80558,108868,14.4
73248,Saint-Jean-de-Maurienne,7524,186747,202051,388798,51.7
33227,Langon,7523,245130,76932,322062,42.8
35068,Châteaubourg,7523,174260,113025,287285,38.2
97132,Trois-Rivières,7519,121350,33908,155258,20.6
21540,Saint-Apollinaire,7517,327973,218138,546111,72.7
44213,Loireauxence,7509,354294,91742,446036,59.4
7042,Bourg-Saint-Andéol,7506,43201,598353,641554,85.5
88383,Remiremont,7500,227869,19144,247013,32.9
74094,Cranves-Sales,7476,0,119471,119471,16
59253,Fresnes-sur-Escaut,7473,317640,143961,461601,61.8
29124,Lesneven,7471,258363,188251,446614,59.8
91553,Saint-Germain-lès-Corbeil,7471,72750,148125,220875,29.6
40217,Parentis-en-Born,7463,125891,203674,329565,44.2
44043,Clisson,7459,333981,137716,471697,63.2
44201,Sucé-sur-Erdre,7457,436365,44398,480763,64.5
40184,Mimizan,7449,151760,40757,192517,25.8
38547,Villard-Bonnot,7445,136972,138336,275308,37
8362,Rethel,7435,0,142189,142189,19.1
79270,Saint-Maixent-l'École,7433,112795,41316,154111,20.7
29042,Crozon,7410,495647,95776,591423,79.8
68149,Huningue,7410,673383,144027,817410,110.3
69194,Saint-Didier-au-Mont-d'Or,7405,108967,535435,644402,87
35173,Melesse,7400,125063,158960,284023,38.4
16291,Ruelle-sur-Touvre,7396,81428,192283,273711,37
22251,Pordic,7393,141503,117255,258758,35
53201,Saint-Berthevin,7384,131714,321354,453068,61.4
43268,Yssingeaux,7380,104819,172991,277810,37.6
71176,Digoin,7380,245939,28613,274552,37.2
97109,Gourbeyre,7378,185017,33273,218290,29.6
66213,Toulouges,7375,74143,61428,135571,18.4
38314,Pontcharra,7373,99560,136998,236558,32.1
91600,Soisy-sur-Seine,7370,62362,146122,208484,28.3
54483,Saint-Nicolas-de-Port,7363,211605,58591,270196,36.7
68082,Ensisheim,7362,151732,58102,209834,28.5
38179,Gières,7353,199576,284049,483625,65.8
97421,Salazie,7333,864035,41771,905806,123.5
62083,Barlin,7330,158541,120961,279502,38.1
29024,Carhaix-Plouguer,7326,221969,247748,469717,64.1
1202,Lagnieu,7321,414749,124942,539691,73.7
57491,Moyeuvre-Grande,7320,326279,1834,328113,44.8
24557,Trélissac,7319,0,40876,40876,5.6
45146,La Ferté-Saint-Aubin,7317,209041,63125,272166,37.2
38562,Vizille,7316,172850,282620,455470,62.3
33229,Lanton,7315,163943,24367,188310,25.7
17421,Saujon,7314,135503,115187,250690,34.3
59654,Waziers,7312,648914,101881,750795,102.7
91339,Linas,7310,140735,75931,216666,29.6
86214,Saint-Benoît,7306,248080,435284,683364,93.5
91340,Lisses,7295,221393,144635,366028,50.2
44103,Montoir-de-Bretagne,7289,985017,268599,1253616,172
44005,Chaumes-en-Retz,7288,484866,222163,707029,97
6105,Roquefort-les-Pins,7284,64300,88267,152567,20.9
57038,Audun-le-Tiche,7268,217146,62665,279811,38.5
22162,Paimpol,7266,260799,130108,390907,53.8
14654,Saint-Pierre-en-Auge,7265,311556,80869,392425,54
27679,Verneuil d'Avre et d'Iton,7262,446480,204235,650715,89.6
22168,Perros-Guirec,7260,260710,144225,404935,55.8
42127,Mably,7246,278049,213826,491875,67.9
35176,Guipry-Messac,7243,277681,65364,343045,47.4
77111,Chessy,7242,148300,205891,354191,48.9
64495,Saint-Pée-sur-Nivelle,7238,322530,188085,510615,70.5
67118,Eckbolsheim,7237,19601,2811425,2831026,391.2
73054,Bourg-Saint-Maurice,7228,440252,153565,593817,82.2
91667,Villemoisson-sur-Orge,7226,55787,72591,128378,17.8
44186,Sainte-Pazanne,7209,121348,219755,341103,47.3
34142,Lodève,7202,159960,80889,240849,33.4
34095,Fabrègues,7200,140200,570855,711055,98.8
30243,Saint-Christol-lez-Alès,7199,127947,225022,352969,49
33322,Le Pian-Médoc,7198,70664,2045,72709,10.1
6065,La Gaude,7194,225476,141635,367111,51
44072,Herbignac,7178,157514,99412,256926,35.8
79081,Chauray,7173,115607,96675,212282,29.6
95205,Écouen,7173,271754,88956,360710,50.3
59028,Auby,7171,836956,99917,936873,130.6
73303,Ugine,7162,450182,168944,619126,86.4
44029,Divatte-sur-Loire,7158,64653,74128,138781,19.4
34327,Vendargues,7157,311092,567446,878538,122.8
80620,Péronne,7139,155120,51148,206268,28.9
34023,Balaruc-les-Bains,7136,458367,280307,738674,103.5
85008,Aubigny-Les Clouzeaux,7129,56470,336964,393434,55.2
22070,Guingamp,7127,225671,127619,353290,49.6
59032,Aulnoy-lez-Valenciennes,7125,106156,137257,243413,34.2
62497,Leforest,7120,113615,112902,226517,31.8
97403,Entre-Deux,7115,233600,11896,245496,34.5
97423,Les Trois-Bassins,7113,489755,46892,536647,75.4
95183,Courdimanche,7111,87630,212015,299645,42.1
56036,Caudan,7110,148717,160811,309528,43.5
77139,Courtry,7107,33650,75972,109622,15.4
42305,La Talaudière,7103,513589,166425,680014,95.7
78397,Le Mesnil-Saint-Denis,7103,296196,8957,305153,43
93033,Gournay-sur-Marne,7101,127003,57895,184898,26
40133,Labenne,7095,97975,159403,257378,36.3
29293,Trégunc,7094,758655,78123,836778,118
78466,Orgeval,7092,285636,66004,351640,49.6
30155,Manduel,7087,112950,26102,139052,19.6
38397,Saint-Ismier,7087,119893,131684,251577,35.5
67021,Barr,7086,301230,219138,520368,73.4
56094,Kervignac,7085,105010,25299,130309,18.4
91207,Égly,7078,188750,71104,259854,36.7
35228,Pleurtuit,7064,91289,235673,326962,46.3
64284,Jurançon,7063,142262,208539,350801,49.7
65059,Bagnères-de-Bigorre,7060,425995,52993,478988,67.8
56023,Brech,7057,47210,273064,320274,45.4
77330,Nanteuil-lès-Meaux,7054,106690,96199,202889,28.8
77018,Bailly-Romainvilliers,7049,112095,200404,312499,44.3
78531,Rosny-sur-Seine,7041,171410,65530,236940,33.7
97134,Vieux-Habitants,7040,37193,31748,68941,9.8
69292,Sathonay-Camp,7039,129752,508971,638723,90.7
86070,Chauvigny,7037,242848,419257,662105,94.1
51055,Bétheny,7030,356360,124937,481297,68.5
22055,Binic-Étables-sur-Mer,7020,287291,111339,398630,56.8
34088,Cournonterral,7019,121744,556504,678248,96.6
68315,Soultz-Haut-Rhin,7019,168059,173210,341269,48.6
14167,Colombelles,7015,214291,156099,370390,52.8
76552,Sainte-Adresse,7015,489337,63275,552612,78.8
77249,Lésigny,7015,165845,42714,208559,29.7
69088,Fontaines-sur-Saône,7005,177831,506513,684344,97.7
76474,Notre-Dame-de-Bondeville,7004,55630,200059,255689,36.5
57683,Uckange,7001,909471,143874,1053345,150.5
31169,Escalquens,6990,158784,113966,272750,39
62457,Houdain,6990,124627,115351,239978,34.3
69287,Saint-Bonnet-de-Mure,6988,367993,20654,388647,55.6
59586,Templeuve-en-Pévèle,6979,212320,119110,331430,47.5
34120,Jacou,6964,150559,552143,702702,100.9
59094,Bourbourg,6958,798832,849609,1648441,236.9
1451,Viriat,6955,103867,134457,238324,34.3
44151,Saint-André-des-Eaux,6949,69338,256070,325408,46.8
26325,Saint-Rambert-d'Albon,6947,52456,114360,166816,24
44130,Pont-Saint-Martin,6942,84890,32905,117795,17
47195,Nérac,6937,124279,33634,157913,22.8
1427,Trévoux,6931,423521,109773,533294,76.9
45338,Villemandeur,6931,87480,93374,180854,26.1
91226,Étréchy,6926,87833,46902,134735,19.5
91689,Wissous,6924,292557,71921,364478,52.6
97406,La Plaine-des-Palmistes,6920,507797,39418,547215,79.1
13035,Eyguières,6915,0,194357,194357,28.1
31118,Castelnau-d'Estrétefonds,6915,98250,13892,112142,16.2
35001,Acigné,6911,173825,354149,527974,76.4
44066,Grandchamp-des-Fontaines,6910,274254,41142,315396,45.6
22176,Plédran,6909,258433,109578,368011,53.3
25411,Morteau,6905,589622,82194,671816,97.3
50615,Valognes,6896,112644,216910,329554,47.8
42071,Le Coteau,6893,680086,203409,883495,128.2
49021,Beaufort-en-Anjou,6893,124578,24086,148664,21.6
60360,Liancourt,6884,0,2883,2883,0.4
1262,Montluel,6879,202909,93665,296574,43.1
89257,Migennes,6878,420399,240384,660783,96.1
87187,Saint-Yrieix-la-Perche,6873,144864,210484,355348,51.7
13119,Carnoux-en-Provence,6872,143960,193148,337108,49.1
59482,Quesnoy-sur-Deûle,6863,362926,113650,476576,69.4
17434,Surgères,6861,220616,283888,504504,73.5
26064,Chabeuil,6860,400128,139058,539186,78.6
82037,Caussade,6858,232803,202770,435573,63.5
62528,Loos-en-Gohelle,6850,0,184540,184540,26.9
59136,Le Cateau-Cambrésis,6846,166305,47040,213345,31.2
29259,Saint-Pol-de-Léon,6841,70231,12998,83229,12.2
85084,Essarts-en-Bocage,6835,194477,57163,251640,36.8
62270,Divion,6830,80967,112710,193677,28.4
13105,Sénas,6829,121780,191939,313719,45.9
95039,Auvers-sur-Oise,6820,139536,180014,319550,46.9
28220,Luisant,6818,110335,198668,309003,45.3
72058,Changé,6803,271690,433571,705261,103.7
26220,Nyons,6794,363710,349107,712817,104.9
77438,Saint-Thibault-des-Vignes,6793,1000,16793,17793,2.6
59079,Beuvrages,6791,203801,130823,334624,49.3
86137,Loudun,6791,103591,34690,138281,20.4
74105,Douvaine,6788,409916,295527,705443,103.9
34151,Marsillargues,6787,37979,74202,112181,16.5
41059,Le Controis-en-Sologne,6787,125300,124715,250015,36.8
83081,Montauroux,6787,119270,130946,250216,36.9
27275,Gaillon,6785,372630,201213,573843,84.6
33080,Cadaujac,6784,38100,61269,99369,14.6
56164,Ploeren,6781,85235,62732,147967,21.8
78217,Épône,6778,122090,63082,185172,27.3
38150,Domène,6777,96878,261798,358676,52.9
78220,Les Essarts-le-Roi,6772,37449,13194,50643,7.5
35188,Montfort-sur-Meu,6767,76306,77745,154051,22.8
29150,Moëlan-sur-Mer,6763,185456,232351,417807,61.8
62628,Noyelles-sous-Lens,6757,72508,182035,254543,37.7
68195,Lutterbach,6755,494155,470568,964723,142.8
10343,Saint-Julien-les-Villas,6752,167580,96418,263998,39.1
14333,Honfleur,6751,319772,50443,370215,54.8
77349,Othis,6741,217821,83598,301419,44.7
97231,Les Trois-Îlets,6735,153890,33090,186980,27.8
37266,Veigné,6734,87081,107194,194275,28.8
73087,Cognin,6729,105200,85532,190732,28.3
59225,Feignies,6727,279650,239956,519606,77.2
34058,Castries,6722,166110,532956,699066,104
38425,Saint-Maurice-l'Exil,6722,282199,171838,454037,67.5
29195,Plouguerneau,6719,248769,52615,301384,44.9
69028,Brindas,6718,152460,64749,217209,32.3
64160,Cambo-les-Bains,6715,334425,174495,508920,75.8
34114,Gignac,6713,220334,36260,256594,38.2
38001,Les Abrets en Dauphiné,6713,75100,58867,133967,20
13022,Cassis,6706,417080,188482,605562,90.3
13102,Saint-Victoret,6689,85915,188005,273920,41
17347,Saint-Jean-d'Angély,6679,340646,186039,526685,78.9
13042,Gémenos,6678,862799,187695,1050494,157.3
59051,La Bassée,6678,130925,110587,241512,36.2
62386,Grenay,6674,121171,179799,300970,45.1
70311,Luxeuil-les-Bains,6674,288482,6417,294899,44.2
91315,Itteville,6674,94850,9807,104657,15.7
30141,Laudun-l'Ardoise,6673,176440,97374,273814,41
17291,Puilboreau,6668,252612,185038,437650,65.6
17385,Saint-Pierre-d'Oléron,6665,423263,721981,1145244,171.8
31202,Fronton,6664,63298,13388,76686,11.5
82125,Montech,6657,112950,89335,202285,30.4
74280,Thônes,6654,606013,338006,944019,141.9
42304,Sury-le-Comtal,6651,393501,59590,453091,68.1
31341,Merville,6640,80396,55545,135941,20.5
49035,Bouchemaine,6635,135172,107408,242580,36.6
44217,Vigneux-de-Bretagne,6633,116469,39492,155961,23.5
56090,Inzinzac-Lochrist,6631,131430,149977,281407,42.4
44180,Vallons-de-l'Erdre,6625,546328,80942,627270,94.7
45203,Meung-sur-Loire,6621,209041,27282,236323,35.7
13070,La Penne-sur-Huveaune,6618,97987,186009,283996,42.9
91587,Saulx-les-Chartreux,6611,97832,68670,166502,25.2
97214,Le Lorrain,6607,12500,59820,72320,10.9
38337,Rives,6599,252807,112106,364913,55.3
54300,Laneuveville-devant-Nancy,6595,219480,220239,439719,66.7
83141,Trans-en-Provence,6595,119000,82152,201152,30.5
42237,Saint-Jean-Bonnefonds,6594,120849,154499,275348,41.8
73222,Saint-Alban-Leysse,6589,50336,83752,134088,20.4
54115,Champigneulles,6588,145668,63438,209106,31.7
38298,Le Péage-de-Roussillon,6587,443944,168387,612331,93
26166,Loriol-sur-Drôme,6584,106994,79753,186747,28.4
49180,Longué-Jumelles,6583,118618,64137,182755,27.8
66038,Canohès,6575,51000,54764,105764,16.1
81257,Saint-Juéry,6575,393209,63825,457034,69.5
35184,Montauban-de-Bretagne,6574,100816,127653,228469,34.8
54397,Neuves-Maisons,6572,337737,66929,404666,61.6
81120,Labruguière,6567,638867,69076,707943,107.8
95091,Bouffémont,6565,152746,11449,164195,25
34113,Gigean,6559,162923,257642,420565,64.1
63003,Ambert,6556,276034,59243,335277,51.1
69142,La Mulatière,6554,690171,473902,1164073,177.6
59212,Estaires,6551,166614,107532,274146,41.8
63070,Ceyrat,6548,129732,248308,378040,57.7
71230,Gueugnon,6547,178901,33656,212557,32.5
56053,Elven,6543,124694,60530,185224,28.3
49063,Chalonnes-sur-Loire,6541,254872,129854,384726,58.8
69112,Lentilly,6541,146538,52208,198746,30.4
76255,Eu,6541,352119,18811,370930,56.7
34213,Poussan,6540,239491,256896,496387,75.9
44073,Héric,6528,285456,38867,324323,49.7
31165,Eaunes,6525,60447,8104,68551,10.5
43040,Brioude,6523,657205,319675,976880,149.8
44101,La Montagne,6523,132395,283877,416272,63.8
47252,Sainte-Livrade-sur-Lot,6518,216469,49950,266419,40.9
57443,Marange-Silvange,6517,89860,1633,91493,14
78486,Le Perray-en-Yvelines,6515,46525,12693,59218,9.1
54280,Jœuf,6509,320948,60435,381383,58.6
88321,Neufchâteau,6507,318035,72691,390726,60
60684,Villers-Saint-Paul,6500,136100,66852,202952,31.2
59165,Cuincy,6499,101200,90553,191753,29.5
62753,Saint-Laurent-Blangy,6492,263115,182597,445712,68.7
77079,Champagne-sur-Seine,6491,93975,22576,116551,18
38087,Chasse-sur-Rhône,6484,1000,49886,50886,7.8
71263,Louhans,6483,90027,26688,116715,18
53054,Changé,6482,109310,282098,391408,60.4
54215,Frouard,6480,659260,62398,721658,111.4
77430,Saint-Pathus,6478,57585,4922,62507,9.6
33011,Arès,6477,159120,21575,180695,27.9
71475,Saint-Rémy,6476,57723,178057,235780,36.4
69010,L'Arbresle,6469,360525,51633,412158,63.7
63195,Lezoux,6468,55265,29715,84980,13.1
31248,Labarthe-sur-Lèze,6467,62490,8032,70522,10.9
73010,Entrelacs,6465,75164,35767,110931,17.2
91347,Longpont-sur-Orge,6456,60040,64856,124896,19.3
32107,Condom,6454,209530,24816,234346,36.3
51172,Cormontreuil,6454,176434,114700,291134,45.1
49200,Longuenée-en-Anjou,6453,242641,104462,347103,53.8
97419,Sainte-Rose,6450,395000,36741,431741,66.9
13016,La Bouilladisse,6447,119625,181203,300828,46.7
31467,Saint-Alban,6447,198377,157616,355993,55.2
38516,La Tronche,6447,234621,249050,483671,75
76103,Bonsecours,6444,106146,184064,290210,45
35353,Vezin-le-Coquet,6441,284649,330064,614713,95.4
17094,Châtelaillon-Plage,6440,159402,178711,338113,52.5
29178,Ploudalmézeau,6440,200,11600,11800,1.8
1289,Péronnas,6437,138422,124443,262865,40.8
74164,Marignier,6432,228240,194768,423008,65.8
97613,M’Tsangamouji,6432,0,27325,27325,4.2
83070,Le Lavandou,6431,269563,5573,275136,42.8
35037,Bréal-sous-Montfort,6430,265064,113156,378220,58.8
22046,Le Mené,6420,132619,0,132619,20.7
18207,Saint-Florent-sur-Cher,6416,194671,17880,212551,33.1
29061,Gouesnou,6412,392951,295221,688172,107.3
91338,Limours,6408,113076,29559,142635,22.3
29174,Plonéour-Lanvern,6403,101111,205095,306206,47.8
85090,Sèvremont,6401,286227,173967,460194,71.9
18141,Mehun-sur-Yèvre,6394,86169,122471,208640,32.6
15187,Saint-Flour,6390,171557,141339,312896,49
78354,Magnanville,6389,225011,59461,284472,44.5
5046,Embrun,6387,113334,510395,623729,97.7
47032,Bon-Encontre,6386,170268,146188,316456,49.6
97106,Bouillante,6381,51650,28776,80426,12.6
26088,Chatuzange-le-Goubet,6375,69148,129227,198375,31.1
34239,Saint-André-de-Sangonis,6364,450,34375,34825,5.5
15012,Arpajon-sur-Cère,6363,546401,215589,761990,119.8
1419,Thoiry,6356,73643,81816,155459,24.5
8190,Givet,6356,471048,40807,511855,80.5
28015,Auneau-Bleury-Saint-Symphorien,6354,135500,36871,172371,27.1
2B148,Lucciana,6354,274700,118480,393180,61.9
33207,Izon,6347,67500,123805,191305,30.1
89025,Avallon,6346,226540,13761,240301,37.9
74242,Saint-Jorioz,6344,374236,49004,423240,66.7
74278,Thyez,6344,0,57721,57721,9.1
44041,La Chevrolière,6342,47612,30061,77673,12.2
13060,Meyreuil,6341,173568,178223,351791,55.5
78396,Le Mesnil-le-Roi,6340,49140,8971,58111,9.2
59365,Louvroil,6334,217412,225938,443350,70
35085,Combourg,6324,320487,79166,399653,63.2
77326,Nandy,6322,0,125344,125344,19.8
42275,Saint-Priest-en-Jarez,6318,123942,148032,271974,43
74263,Sciez,6317,314517,275021,589538,93.3
1194,Jassans-Riottier,6315,141086,134072,275158,43.6
2B120,Furiani,6308,9000,94423,103423,16.4
62893,Wimereux,6307,450014,213205,663219,105.2
57058,Behren-lès-Forbach,6299,667698,115154,782852,124.3
30062,Calvisson,6295,74450,468279,542729,86.2
41136,Mer,6294,199784,18951,218735,34.8
53034,Bonchamp-lès-Laval,6294,111112,273916,385028,61.2
63103,Châtel-Guyon,6294,92096,47599,139695,22.2
69094,Grézieu-la-Varenne,6284,72649,60566,133215,21.2
86158,Migné-Auxances,6276,443022,373918,816940,130.2
84072,Mazan,6272,318205,204798,523003,83.4
74008,Ambilly,6269,110574,100183,210757,33.6
37104,Esvres,6264,69630,99713,169343,27
24547,Terrasson-Lavilledieu,6262,321655,109516,431171,68.9
69141,Mornant,6261,74810,200920,275730,44
56176,Pluneret,6257,77034,242109,319143,51
35207,Noyal-sur-Vilaine,6250,96559,179864,276423,44.2
54263,Homécourt,6250,318844,58031,376875,60.3
68145,Horbourg-Wihr,6247,604942,128385,733327,117.4
56010,Baud,6246,120654,14668,135322,21.7
84039,Courthézon,6245,320150,6274,326424,52.3
86297,Vouneuil-sous-Biard,6245,85245,372071,457316,73.2
85019,Bellevigny,6239,264255,53275,317530,50.9
77171,Esbly,6237,65846,177319,243165,39
31584,Villemur-sur-Tarn,6235,293910,0,293910,47.1
37132,Loches,6233,157000,108195,265195,42.5
40001,Aire-sur-l'Adour,6215,237454,194559,432013,69.5
26313,Saint-Marcel-lès-Valence,6214,279132,125963,405095,65.2
59327,Lallaing,6212,42166,86554,128720,20.7
71445,Saint-Marcel,6211,98030,170771,268801,43.3
34217,Prades-le-Lez,6207,88761,492124,580885,93.6
33042,Belin-Béliet,6205,62075,22055,84130,13.6
71118,Châtenoy-le-Royal,6205,79680,170606,250286,40.3
66017,Le Barcarès,6203,234100,51666,285766,46.1
45298,Saint-Pryvé-Saint-Mesmin,6200,157001,90685,247686,39.9
56158,Plescop,6200,122129,57357,179486,28.9
69255,Vaugneray,6198,444417,59737,504154,81.3
40209,Ondres,6194,62579,175930,238509,38.5
13053,Mallemort,6190,248062,173979,422041,68.2
14098,Thue et Mue,6189,267525,137718,405243,65.5
95388,Menucourt,6189,166824,184525,351349,56.8
97604,Bouéni,6189,0,61877,61877,10
36018,Le Blanc,6188,194623,34015,228638,36.9
14371,Livarot-Pays-d'Auge,6183,375733,68825,444558,71.9
38449,Saint-Quentin-Fallavier,6182,289062,75119,364181,58.9
42223,Saint-Genest-Lerpt,6182,167413,144846,312259,50.5
57537,Petite-Rosselle,6176,211421,112905,324326,52.5
87065,Feytiat,6174,244891,87551,332442,53.8
49223,Mûrs-Erigné,6172,99730,99913,199643,32.3
66149,Prades,6166,281120,184672,465792,75.5
59456,Pecquencourt,6160,419815,74071,493886,80.2
17219,Marennes-Hiers-Brouage,6148,156060,141269,297329,48.4
76481,Octeville-sur-Mer,6147,462607,55445,518052,84.3
27198,Mesnils-sur-Iton,6142,168453,172737,341190,55.6
30169,Milhaud,6142,36844,22622,59466,9.7
78644,La Verrière,6142,54285,153095,207380,33.8
62351,Fouquières-lès-Lens,6134,56940,165251,222191,36.2
43012,Aurec-sur-Loire,6133,130569,95456,226025,36.9
32132,Fleurance,6130,297303,3481,300784,49.1
9261,Saint-Girons,6129,367976,742708,1110684,181.2
76402,Malaunay,6125,74788,174952,249740,40.8
69040,Champagne-au-Mont-d'Or,6124,423197,442810,866007,141.4
40273,Saint-Martin-de-Seignanx,6123,95268,173914,269182,44
57332,Hombourg-Haut,6122,346674,195179,541853,88.5
74043,Bons-en-Chablais,6120,427223,266444,693667,113.3
30047,Bouillargues,6119,301474,22537,324011,53
69191,Saint-Cyr-au-Mont-d'Or,6113,176315,442014,618329,101.1
69279,Jonage,6109,150700,441725,592425,97
38316,Pont-de-Chéruy,6107,122438,6824,129262,21.2
67313,Mutzig,6101,178559,15719,194278,31.8
78380,Maule,6100,208885,14315,223200,36.6
62443,Hersin-Coupigny,6098,42950,100631,143581,23.5
76495,Pavilly,6095,77149,20355,97504,16
83131,Solliès-Toucas,6087,81880,101247,183127,30.1
17142,Dompierre-sur-Mer,6084,247426,168832,416258,68.4
83091,Pierrefeu-du-Var,6084,145390,5273,150663,24.8
76475,Franqueville-Saint-Pierre,6081,213333,173695,387028,63.6
80212,Corbie,6080,171038,803,171841,28.3
1344,Saint-Denis-lès-Bourg,6078,461304,117503,578807,95.2
59484,Quiévrechain,6078,190208,117088,307296,50.6
69291,Saint-Symphorien-d'Ozon,6076,144052,36819,180871,29.8
62274,Dourges,6068,123820,96220,220040,36.3
85151,Mortagne-sur-Sèvre,6065,120422,77711,198133,32.7
83153,Saint-Mandrier-sur-Mer,6064,239812,261320,501132,82.6
59603,Trith-Saint-Léger,6062,557873,228057,785930,129.6
43224,Sainte-Sigolène,6060,139030,547249,686279,113.2
31445,Quint-Fonsegrives,6059,169044,148131,317175,52.3
56075,Guer,6056,65711,73675,139386,23
12133,Luc-la-Primaube,6054,205459,92780,298239,49.3
4143,Oraison,6042,61686,70233,131919,21.8
94001,Ablon-sur-Seine,6029,32000,49155,81155,13.5
27213,Vexin-sur-Epte,6026,64700,31663,96363,16
77037,Bois-le-Roi,6026,451445,50171,501616,83.2
44166,Saint-Jean-de-Boiseau,6024,134523,262161,396684,65.9
83055,Fayence,6024,94242,116225,210467,34.9
3082,Commentry,6018,469356,214994,684350,113.7
9160,Lavelanet,6018,382952,53443,436395,72.5
14174,Condé-en-Normandie,6018,221777,2749,224526,37.3
59452,Ostricourt,6014,83460,102640,186100,30.9
88372,Raon-l'Étape,6011,162370,58442,220812,36.7
34077,Clapiers,6010,95800,476505,572305,95.2
34192,Palavas-les-Flots,6007,630284,44762,675046,112.4
67506,Vendenheim,6005,120870,2332819,2453689,408.6
31351,Mondonville,6003,23550,146761,170311,28.4
13098,Saint-Mitre-les-Remparts,5996,80587,168527,249114,41.5
59359,Loon-Plage,5995,3436457,732021,4168478,695.3
44071,Haute-Goulaine,5992,41286,110630,151916,25.4
83035,Le Castellet,5992,181050,3722,184772,30.8
14076,Blainville-sur-Orne,5991,205442,133313,338755,56.5
35120,Gévezé,5987,313477,306799,620276,103.6
71040,Blanzy,5983,63970,96136,160106,26.8
26116,Donzère,5981,208822,92471,301293,50.4
80561,Montdidier,5978,127046,7216,134262,22.5
62737,Sains-en-Gohelle,5972,111237,160887,272124,45.6
59509,Roost-Warendin,5966,104496,83127,187623,31.4
78321,Jouars-Pontchartrain,5965,174970,2575,177545,29.8
84004,Aubignan,5962,64185,194676,258861,43.4
34332,Vias,5960,573800,66197,639997,107.4
38423,Saint-Martin-le-Vinoux,5957,38678,230121,268799,45.1
64189,Ciboure,5957,133835,154797,288632,48.5
86174,Naintré,5954,163571,135509,299080,50.2
13030,Cuges-les-Pins,5949,57746,167206,224952,37.8
62624,Noyelles-Godault,5949,151901,94333,246234,41.4
60581,Saint-Just-en-Chaussée,5940,173607,32911,206518,34.8
57012,Algrange,5928,92085,121823,213908,36.1
97206,Le Diamant,5924,142950,29106,172056,29
67028,Benfeld,5922,43050,109491,152541,25.8
74169,Marnaz,5920,92869,53863,146732,24.8
84137,Vaison-la-Romaine,5920,196415,6925,203340,34.3
13066,Noves,5918,266915,30832,297747,50.3
33393,Saint-Denis-de-Pile,5916,60430,115398,175828,29.7
31091,Bruguières,5908,110885,144439,255324,43.2
54328,Ludres,5899,155408,196996,352404,59.7
26347,Tain-l'Hermitage,5890,267788,259165,526953,89.5
50082,Bricquebec-en-Cotentin,5888,235425,185204,420629,71.4
77192,Fontenay-Trésigny,5887,116820,29918,146738,24.9
16154,Gond-Pontouvre,5884,300897,152974,453871,77.1
51250,Fismes,5884,252033,104570,356603,60.6
11266,Port-la-Nouvelle,5882,173700,90962,264662,45
67519,La Wantzenau,5879,643375,2283870,2927245,497.9
6114,Saint-André-de-la-Roche,5877,104590,115706,220296,37.5
13091,Saint-Cannat,5877,555274,165182,720456,122.6
83120,Saint-Zacharie,5877,114610,165182,279792,47.6
49345,Bellevigne-en-Layon,5874,453068,116612,569680,97
31188,Fontenilles,5869,34984,1794,36778,6.3
77320,Mouroux,5869,47276,22857,70133,11.9
78117,Buc,5868,154750,48636,203386,34.7
86165,Montmorillon,5867,288287,237294,525581,89.6
25284,Grand-Charmont,5865,184710,371276,555986,94.8
62757,Saint-Martin-lez-Tatinghem,5863,67040,521808,588848,100.4
33240,Lesparre-Médoc,5862,167329,51540,218869,37.3
87113,Le Palais-sur-Vienne,5861,47761,83112,130873,22.3
87001,Aixe-sur-Vienne,5860,66015,2727,68742,11.7
56067,Grand-Champ,5859,117535,54202,171737,29.3
78537,Saint-Arnoult-en-Yvelines,5854,12165,11405,23570,4
91577,Saintry-sur-Seine,5853,11610,116045,127655,21.8
95371,Marly-la-Ville,5852,92386,72573,164959,28.2
36159,Le Poinçonnet,5848,204614,216747,421361,72.1
42222,Saint-Galmier,5848,607006,137020,744026,127.2
67131,Eschau,5847,90087,2271439,2361526,403.9
24294,Montpon-Ménestérol,5845,86030,44423,130453,22.3
38318,Pont-Évêque,5843,43904,44954,88858,15.2
82134,Nègrepelisse,5839,175473,47396,222869,38.2
33090,Canéjan,5836,408974,27129,436103,74.7
76312,Gournay-en-Bray,5834,253470,110209,363679,62.3
84122,Sarrians,5834,182347,190496,372843,63.9
78133,Chambourcy,5826,337400,8243,345643,59.3
13107,Simiane-Collongue,5823,88290,163664,251954,43.3
30033,Beauvoisin,5823,115946,19093,135039,23.2
34028,Bédarieux,5820,346011,54187,400198,68.8
56003,Arradon,5820,125570,53842,179412,30.8
62035,Annezin,5819,12070,96027,108097,18.6
29020,Briec,5815,65978,186666,252644,43.4
80253,Doullens,5814,233865,22663,256528,44.1
97121,Pointe-Noire,5813,0,15888,15888,2.7
25539,Seloncourt,5812,76285,367921,444206,76.4
65258,Lannemezan,5810,317190,17352,334542,57.6
30006,Aimargues,5806,65183,19037,84220,14.5
17264,Nieul-sur-Mer,5805,64400,161090,225490,38.8
81220,Rabastens,5801,96760,318723,415483,71.6
62276,Douvrin,5799,254585,95697,350282,60.4
13033,Ensuès-la-Redonne,5796,63240,162905,226145,39
8363,Revin,5795,118100,37205,155305,26.8
13080,Le Puy-Sainte-Réparade,5794,263738,162849,426587,73.6
69248,Thizy-les-Bourgs,5794,359146,68485,427631,73.8
78672,Villennes-sur-Seine,5792,66740,53905,120645,20.8
79174,Melle,5790,98120,167217,265337,45.8
35095,Dol-de-Bretagne,5786,382923,49203,432126,74.7
13085,Roquefort-la-Bédoule,5784,133110,162568,295678,51.1
47031,Boé,5784,116319,132407,248726,43
49367,Erdre-en-Anjou,5784,35554,167627,203181,35.1
56166,Plouay,5779,193635,130707,324342,56.1
64496,Saint-Pierre-d'Irube,5779,136722,150172,286894,49.6
30344,Vergèze,5778,149600,0,149600,25.9
67520,Wasselonne,5777,206596,313763,520359,90.1
49194,Mazé-Milon,5770,54660,20162,74822,13
67137,Fegersheim,5769,354723,2241138,2595861,450
11106,Coursan,5762,139594,89107,228701,39.7
95355,Magny-en-Vexin,5755,121821,36380,158201,27.5
80685,Roye,5748,216245,6938,223183,38.8
64410,Mourenx,5744,384471,154663,539134,93.9
56193,Riantec,5742,249677,129870,379547,66.1
57474,Mondelange,5739,182290,11649,193939,33.8
50484,Saint-Hilaire-du-Harcouët,5735,132217,141105,273322,47.7
31182,Fenouillet,5727,72390,140014,212404,37.1
80489,Longueau,5726,45500,367102,412602,72.1
2095,Bohain-en-Vermandois,5724,79480,51860,131340,22.9
66189,Saleilles,5724,75886,47676,123562,21.6
2B050,Calvi,5720,200000,0,200000,35
62263,Dainville,5718,60935,160827,221762,38.8
13021,Carry-le-Rouet,5717,131800,160685,292485,51.2
62645,Oye-Plage,5716,99142,43383,142525,24.9
25578,Valdahon,5715,440366,67510,507876,88.9
33029,Le Barp,5713,74674,20306,94980,16.6
29117,Lannilis,5712,75479,44729,120208,21
29004,Bannalec,5707,293231,196071,489302,85.7
34259,Saint-Georges-d'Orques,5707,268528,452482,721010,126.3
72071,Montval-sur-Loir,5707,72712,321826,394538,69.1
34031,Bessan,5705,191975,63365,255340,44.8
71543,Tournus,5702,128202,132697,260899,45.8
28209,Lèves,5701,54205,166120,220325,38.6
68163,Kembs,5694,114530,110673,225203,39.6
14726,Valdallière,5692,111624,2600,114224,20.1
16166,L'Isle-d'Espagnac,5691,57089,147956,205045,36
91376,Marolles-en-Hurepoix,5688,131711,57141,188852,33.2
3118,Gannat,5684,152668,116261,268929,47.3
95480,Parmain,5683,75850,36950,112800,19.8
79048,La Crèche,5681,62408,31578,93986,16.5
84091,Piolenc,5679,71778,0,71778,12.6
74236,Saint-Gervais-les-Bains,5678,674572,59461,734033,129.3
59239,Flines-lez-Raches,5677,110918,79100,190018,33.5
90033,Delle,5677,569017,33764,602781,106.2
10268,Nogent-sur-Seine,5673,1040665,35056,1075721,189.6
94065,Rungis,5669,1035465,46220,1081685,190.8
59524,Sainghin-en-Weppes,5663,184139,93778,277917,49.1
86281,Saint-Martin-la-Pallu,5663,42912,294288,337200,59.5
83027,La Cadière-d'Azur,5657,134500,3514,138014,24.4
54318,Liverdun,5656,115995,54463,170458,30.1
59553,Santes,5656,128311,93662,221973,39.2
42149,Montrond-les-Bains,5655,340303,102502,442805,78.3
91659,Villabé,5654,145952,112100,258052,45.6
67343,Oberhausbergen,5652,148419,2195686,2344105,414.7
74272,Sillingy,5652,66721,24002,90723,16.1
69288,Saint-Laurent-de-Mure,5651,65877,16702,82579,14.6
31107,Carbonne,5650,590761,9717,600478,106.3
64230,Gan,5649,79522,166790,246312,43.6
59663,Wormhout,5645,134577,108721,243298,43.1
49377,Rives-du-Loir-en-Anjou,5642,226690,91334,318024,56.4
85182,Pouzauges,5641,350457,153312,503769,89.3
33555,Marcheprime,5637,34750,18777,53527,9.5
69278,Genay,5632,479739,407235,886974,157.5
73064,Challes-les-Eaux,5626,63623,71512,135135,24
74309,Viry,5625,309878,22043,331921,59
14271,Fleury-sur-Orne,5622,45650,125101,170751,30.4
11379,Sigean,5620,208806,86911,295717,52.6
83097,Pourrières,5620,73100,210560,283660,50.5
44098,Missillac,5619,60410,58338,118748,21.1
49020,Beaucouzé,5618,388153,90945,479098,85.3
59632,Wallers,5618,188673,211353,400026,71.2
81021,Aussillon,5617,252594,59083,311677,55.5
13114,Ventabren,5613,431650,157762,589412,105
13073,Peypin,5612,88995,157734,246729,44
35208,Orgères,5602,249189,287070,536259,95.7
28103,Cloyes-les-Trois-Rivières,5601,0,306058,306058,54.6
68300,Sausheim,5597,671090,389899,1060989,189.6
44082,Ligné,5593,67529,68333,135862,24.3
30294,Saint-Privat-des-Vieux,5592,54129,174791,228920,40.9
97122,Port-Louis,5591,168500,79413,247913,44.3
78502,Le Port-Marly,5583,69955,7900,77855,13.9
69297,Ternay,5582,61601,33825,95426,17.1
85302,Chanverrie,5580,83173,71497,154670,27.7
83064,Garéoult,5579,20400,209024,229424,41.1
37273,La Ville-aux-Dames,5575,304785,99586,404371,72.5
68004,Altkirch,5575,206370,149551,355921,63.8
91330,Lardy,5572,79835,37733,117568,21.1
1071,Cessy,5570,68657,71699,140356,25.2
87002,Ambazac,5565,287091,9017,296108,53.2
35049,Cancale,5554,429031,131682,560713,101
38249,Montbonnot-Saint-Martin,5554,59350,103199,162549,29.3
59268,La Gorgue,5553,282631,91150,373781,67.3
6108,La Roquette-sur-Siagne,5552,41760,141753,183513,33.1
8328,Nouzonville,5548,69545,127444,196989,35.5
66088,Ille-sur-Têt,5546,162758,7483,170241,30.7
59227,Fenain,5533,34570,66532,101102,18.3
59234,Flers-en-Escrebieux,5533,274480,77094,351574,63.5
17414,Saint-Xandre,5531,301453,153486,454939,82.3
78160,Chevreuse,5531,115018,6975,121993,22.1
62099,Beaurains,5530,133715,155539,289254,52.3
97362,Papaichton,5530,406515,26005,432520,78.2
79195,Nueil-les-Aubiers,5529,161148,157281,318429,57.6
30221,Roquemaure,5528,50845,103746,154591,28
84016,Bédarrides,5521,155479,22003,177482,32.1
44182,Saint-Michel-Chef-Chef,5520,206970,168268,375238,68
38422,Saint-Martin-d'Uriage,5512,322253,102418,424671,77
53096,Ernée,5511,263570,25046,288616,52.4
28140,Épernon,5509,184590,31967,216557,39.3
95652,Viarmes,5509,102290,31851,134141,24.3
27602,Saint-Sébastien-de-Morsent,5508,87000,64778,151778,27.6
62397,Guînes,5508,120880,33713,154593,28.1
42059,Chazelles-sur-Lyon,5507,192106,99819,291925,53
97609,Kani-Kéli,5507,0,55058,55058,10
77382,Quincy-Voisins,5506,66192,75088,141280,25.7
84034,Caumont-sur-Durance,5499,120794,103202,223996,40.7
34298,Sauvian,5498,0,31850,31850,5.8
26124,Étoile-sur-Rhône,5497,376354,111429,487783,88.7
35275,Saint-Gilles,5489,338948,281280,620228,113
66144,Pollestres,5489,73200,45719,118919,21.7
83106,Rocbaron,5489,37320,205652,242972,44.3
47100,Foulayronnes,5480,87730,125448,213178,38.9
57097,Boulay-Moselle,5479,89723,32999,122722,22.4
49228,Noyant-Villages,5473,241508,19125,260633,47.6
33256,Ludon-Médoc,5466,41180,1553,42733,7.8
86177,Neuville-de-Poitou,5465,315298,283998,599296,109.7
18015,Aubigny-sur-Nère,5464,165026,0,165026,30.2
72008,Arnage,5463,117205,111761,228966,41.9
63069,Le Cendre,5455,76917,206860,283777,52
70279,Gray,5455,339747,27529,367276,67.3
85152,Les Achards,5451,44381,344606,388987,71.4
59656,Wervicq-Sud,5446,240643,90185,330828,60.7
21390,Marsannay-la-Côte,5440,279316,157865,437181,80.4
51506,Saint-Memmie,5439,33355,276452,309807,57
62555,Marles-les-Mines,5437,56779,89723,146502,26.9
44179,Saint-Mars-du-Désert,5435,39907,32360,72267,13.3
34300,Servian,5427,128968,31439,160407,29.6
77431,Saint-Pierre-lès-Nemours,5424,92300,2772,95072,17.5
79003,Aiffres,5423,234796,73089,307885,56.8
77143,Crégy-lès-Meaux,5419,54898,73901,128799,23.8
22225,Ploumagoar,5418,82411,97017,179428,33.1
62194,Calonne-Ricouart,5416,69496,89376,158872,29.3
85096,La Garnache,5413,165039,36144,201183,37.2
85089,La Ferrière,5411,180993,255760,436753,80.7
38133,Coublevie,5409,100053,91890,191943,35.5
67411,Rosheim,5409,99622,196471,296093,54.7
67388,Reichshoffen,5407,290551,198014,488565,90.4
21154,Châtillon-sur-Seine,5404,177535,90160,267695,49.5
62244,Coulogne,5403,181295,162392,343687,63.6
71073,Chagny,5402,147524,23491,171015,31.7
54257,Heillecourt,5396,87231,180198,267429,49.6
66024,Le Boulou,5396,138573,223797,362370,67.2
65100,Bordères-sur-l'Échez,5394,0,51531,51531,9.6
33214,Lacanau,5389,196060,5207,201267,37.3
11397,Trèbes,5386,112770,34935,147705,27.4
13044,Grans,5382,259409,151269,410678,76.3
69205,Saint-Genis-les-Ollières,5370,151170,388290,539460,100.5
72231,Parigné-l'Évêque,5367,2230,342051,344281,64.1
6075,Levens,5366,139550,105645,245195,45.7
59044,Baisieux,5361,154754,88777,243531,45.4
91461,Ollainville,5361,44473,53856,98329,18.3
13087,Rousset,5357,931600,150567,1082167,202
67106,Drusenheim,5357,98895,64913,163808,30.6
13084,La Roque-d'Anthéron,5355,336607,150510,487117,91
64407,Mouguerre,5353,144148,139102,283250,52.9
59202,Erquinghem-Lys,5349,34385,88579,122964,23
62057,Audruicq,5349,94423,40597,135020,25.2
49176,Le Lion-d'Angers,5343,104377,154846,259223,48.5
56169,Plouhinec,5343,1000,19079,20079,3.8
59170,Dechy,5343,131892,74446,206338,38.6
37027,Bléré,5340,192550,120159,312709,58.6
60439,Mouy,5339,185376,28317,213693,40
95392,Mériel,5337,87640,34700,122340,22.9
63457,Vic-le-Comte,5336,94359,95652,190011,35.6
44120,Le Pellerin,5335,139935,232176,372111,69.7
55122,Commercy,5332,283114,21519,304633,57.1
29158,Penmarch,5320,105047,199675,304722,57.3
13074,Peyrolles-en-Provence,5316,88950,149414,238364,44.8
24372,Saint-Astier,5309,168375,28939,197314,37.2
6054,Drap,5300,305559,104346,409905,77.3
72213,Mulsanne,5299,56805,108406,165211,31.2
31458,Roques,5295,55275,6577,61852,11.7
25057,Bethoncourt,5288,295261,334750,630011,119.1
82186,Valence,5287,242565,568042,810607,153.3
69157,Vindry-sur-Turdine,5283,48738,62445,111183,21
44128,Plessé,5281,339519,75339,414858,78.6
77317,Mormant,5280,32785,67976,100761,19.1
14181,Cormelles-le-Royal,5273,27808,117335,145143,27.5
69044,Charbonnières-les-Bains,5272,213438,381204,594642,112.8
21464,Nuits-Saint-Georges,5263,250491,25239,275730,52.4
67151,Gambsheim,5263,55697,63774,119471,22.7
25321,Villers-le-Lac,5248,48661,62470,111131,21.2
44175,Saint-Lyphard,5246,119678,72654,192332,36.7
73029,Barberaz,5246,28800,66681,95481,18.2
30125,Garons,5244,29365,19314,48679,9.3
44067,Guémené-Penfao,5242,71141,74783,145924,27.8
38557,Villette-d'Anthon,5240,55758,5855,61613,11.8
16078,Champniers,5237,75666,136153,211819,40.4
67309,Mundolsheim,5236,19530,2034078,2053608,392.2
1322,Reyrieux,5228,410875,82801,493676,94.4
57207,Farébersviller,5226,614298,166613,780911,149.4
86157,Mignaloux-Beauvoir,5224,35990,311241,347231,66.5
83140,Tourves,5220,45500,195573,241073,46.2
74026,La Balme-de-Sillingy,5215,51771,22146,73917,14.2
97424,Cilaos,5215,98900,25551,124451,23.9
84056,Jonquières,5213,53100,5237,58337,11.2
84119,Saint-Saturnin-lès-Avignon,5211,108857,97797,206654,39.7
62173,Brebières,5210,57577,6482,64059,12.3
85155,Mouilleron-le-Captif,5209,84415,246212,330627,63.5
87048,Condat-sur-Vienne,5208,106597,73852,180449,34.6
13088,Le Rove,5205,164435,146294,310729,59.7
10297,Pont-Sainte-Marie,5202,37107,74284,111391,21.4
62523,Loison-sous-Lens,5202,0,140143,140143,26.9
65417,Séméac,5202,189185,49697,238882,45.9
2340,Gauchy,5197,164197,742767,906964,174.5
29274,Scaër,5197,292561,178549,471110,90.7
90099,Valdoie,5193,96278,181173,277451,53.4
97601,Acoua,5192,36235,0,36235,7
33535,Tresses,5188,62350,112034,174384,33.6
34069,Cazouls-lès-Béziers,5185,114200,48415,162615,31.4
57336,L'Hôpital,5179,200700,88430,289130,55.8
91540,Saint-Chéron,5176,68261,30087,98348,19
42332,Villerest,5175,119567,152712,272279,52.6
60338,Lacroix-Saint-Ouen,5175,69146,46609,115755,22.4
69260,Vernaison,5175,165080,374190,539270,104.2
62560,Marquise,5169,84811,20563,105374,20.4
59230,Ferrière-la-Grande,5167,213985,184310,398295,77.1
33314,Pauillac,5165,136561,45412,181973,35.2
62261,Cucq,5165,220011,54948,274959,53.2
57487,Moulins-lès-Metz,5161,53985,255885,309870,60
29130,Locmaria-Plouzané,5160,315818,9294,325112,63
27022,Le Val d'Hazey,5156,178470,152904,331374,64.3
93015,Coubron,5156,38950,42037,80987,15.7
54498,Seichamps,5155,6309,172150,178459,34.6
1093,Châtillon-sur-Chalaronne,5154,465359,1074,466433,90.5
35139,Laillé,5154,180313,264113,444426,86.2
57209,Faulquemont,5154,206673,239165,445838,86.5
51030,Aÿ-Champagne,5148,119084,12725,131809,25.6
78638,Vaux-sur-Seine,5143,73579,47865,121444,23.6
4088,Forcalquier,5142,282359,104432,386791,75.2
45315,Sully-sur-Loire,5142,275895,30116,306011,59.5
54322,Longuyon,5141,64732,65264,129996,25.3
34247,Saint-Clément-de-Rivière,5140,38400,95772,134172,26.1
85035,Bretignolles-sur-Mer,5139,129135,11179,140314,27.3
34101,Florensac,5138,67415,57067,124482,24.2
64269,Idron,5134,26990,151584,178574,34.8
89464,Villeneuve-sur-Yonne,5130,111763,34091,145854,28.4
14225,Dives-sur-Mer,5129,282095,65155,347250,67.7
21292,Genlis,5125,136830,116,136946,26.7
59052,Bauvin,5124,123430,84853,208283,40.6
14228,Douvres-la-Délivrande,5123,155994,34488,190482,37.2
54439,Pulnoy,5123,92941,171081,264022,51.5
73031,Bassens,5118,32940,65054,97994,19.1
14514,Pont-l'Évêque,5116,78470,82225,160695,31.4
67458,Schweighouse-sur-Moder,5116,177015,62206,239221,46.8
56248,Surzur,5110,220493,47273,267766,52.4
77475,Trilport,5107,78485,69647,148132,29
29026,Châteaulin,5106,303069,80472,383541,75.1
79179,Moncoutant-sur-Sèvre,5100,108232,145078,253310,49.7
39368,Hauts de Bienne,5099,175261,19495,194756,38.2
4049,Château-Arnoux-Saint-Auban,5095,154418,213557,367975,72.2
61168,La Ferté Macé,5095,87540,136460,224000,44
77055,Brou-sur-Chantereine,5094,20000,54454,74454,14.6
17333,Saint-Georges-de-Didonne,5093,280988,80209,361197,70.9
35257,Maen Roch,5093,349919,156122,506041,99.4
97417,Saint-Philippe,5093,272211,8516,280727,55.1
38097,Chavanoz,5090,53600,5687,59287,11.6
44064,Gorges,5090,16261,93977,110238,21.7
74288,Valleiry,5090,123435,19946,143381,28.2
83087,Nans-les-Pins,5090,125450,190703,316153,62.1
42256,Saint-Marcellin-en-Forez,5088,60100,45586,105686,20.8
37139,Luynes,5081,111902,60115,172017,33.9
72180,Mamers,5080,68107,94201,162308,32
68042,Blotzheim,5077,565781,98681,664462,130.9
73051,Le Bourget-du-Lac,5077,114558,28088,142646,28.1
78089,Bonnières-sur-Seine,5077,33738,25955,59693,11.8
62132,Billy-Berclau,5076,111315,83765,195080,38.4
77513,Villenoy,5073,114915,69183,184098,36.3
11170,Gruissan,5068,430245,78374,508619,100.4
25047,Baume-les-Dames,5064,95302,252420,347722,68.7
68118,Habsheim,5061,82310,352560,434870,85.9
1443,Villars-les-Dombes,5059,178112,1054,179166,35.4
25527,Saint-Vit,5059,196330,89137,285467,56.4
59459,Petite-Forêt,5058,122594,97438,220032,43.5
74096,Cruseilles,5058,37463,90931,128394,25.4
31582,Villefranche-de-Lauragais,5054,186827,24651,211478,41.8
62746,Saint-Étienne-au-Mont,5051,54470,170747,225217,44.6
67372,Val-de-Moder,5047,61846,61367,123213,24.4
62502,Lestrem,5041,129280,82746,212026,42.1
29199,Plouigneau,5039,194236,302134,496370,98.5
40282,Saint-Sever,5038,258209,116398,374607,74.4
88367,Rambervillers,5032,74434,25104,99538,19.8
30321,Sommières,5028,44300,374028,418328,83.2
12089,Decazeville,5025,275175,50493,325668,64.8
58095,Decize,5025,350107,12962,363069,72.3
56143,Muzillac,5022,75910,47819,123729,24.6
95134,Champagne-sur-Oise,5022,64183,17890,82073,16.3
33058,Blaye,5017,119752,51349,171101,34.1
17407,Sainte-Soulle,5016,173621,139195,312816,62.4
6159,Villefranche-sur-Mer,5012,204550,98676,303226,60.5
45053,Briare,5012,109408,58342,167750,33.5
38034,Beaurepaire,5007,278272,127996,406268,81.1
62491,Laventie,5007,112173,82188,194361,38.8
19229,Saint-Pantaléon-de-Larche,5006,65684,79895,145579,29.1
40197,Morcenx-la-Nouvelle,5005,381491,71515,453006,90.5
44021,Villeneuve-en-Retz,5004,60979,152539,213518,42.7
90009,Beaucourt,4985,100230,29648,129878,26.1
45224,Neuville-aux-Bois,4984,121280,15358,136638,27.4
51388,Mourmelon-le-Grand,4984,99949,253325,353274,70.9
71310,Montchanin,4982,144728,80052,224780,45.1
22389,Yffiniac,4980,238970,78984,317954,63.8
71137,Cluny,4980,90100,34612,124712,25
85088,Le Fenouiller,4978,28299,10829,39128,7.9
27448,Pacy-sur-Eure,4975,238993,26140,265133,53.3
62400,Haillicourt,4974,43230,82082,125312,25.2
77458,Souppes-sur-Loing,4974,85150,5241,90391,18.2
49183,Val d'Erdre-Auxence,4967,312172,143949,456121,91.8
50487,Saint-James,4966,166061,122185,288246,58
51662,Witry-lès-Reims,4958,377671,88113,465784,93.9
14301,Giberville,4956,186471,110282,296753,59.9
59098,Bousbecque,4956,398598,82071,480669,97
42103,La Grand-Croix,4951,319282,116003,435285,87.9
33424,Saint-Laurent-Médoc,4950,52465,43521,95986,19.4
97104,Baillif,4949,64314,22319,86633,17.5
8081,Bogny-sur-Meuse,4947,19621,77016,96637,19.5
68298,Sainte-Marie-aux-Mines,4945,113913,874666,988579,199.9
38269,La Mure,4940,59738,51724,111462,22.6
38538,Le Versoud,4940,66177,91790,157967,32
87201,Verneuil-sur-Vienne,4940,45295,70052,115347,23.3
74005,Allinges,4938,76998,214984,291982,59.1
1043,Beynost,4936,178900,159132,338032,68.5
35177,La Mézière,4935,207411,106009,313420,63.5
23176,La Souterraine,4928,282980,93267,376247,76.3
31230,Gratentour,4926,179262,120431,299693,60.8
33397,Sainte-Eulalie,4922,162490,10331,172821,35.1
78224,L'Étang-la-Ville,4915,30350,6954,37304,7.6
82190,Verdun-sur-Garonne,4914,173296,65945,239241,48.7
95352,Luzarches,4909,61998,28382,90380,18.4
95116,Bruyères-sur-Oise,4907,47573,17481,65054,13.3
1281,Ornex,4903,71600,63113,134713,27.5
59329,Lambres-lez-Douai,4902,385612,68302,453914,92.6
59272,Grand-Fort-Philippe,4901,376810,598438,975248,199
57089,Bitche,4899,63482,112905,176387,36
42123,Lorette,4896,155157,114715,269872,55.1
3254,Saint-Pourçain-sur-Sioule,4894,128333,100102,228435,46.7
62139,Blendecques,4891,81030,435300,516330,105.6
28051,Bonneval,4890,66560,8996,75556,15.5
44163,Vair-sur-Loire,4890,265886,59744,325630,66.6
85113,L'Île-d'Yeu,4887,353229,0,353229,72.3
51242,Fagnières,4886,20308,248344,268652,55
77142,Crécy-la-Chapelle,4881,165442,19009,184451,37.8
41232,Salbris,4880,149550,41584,191134,39.2
33483,Saint-Sulpice-et-Cameyrac,4879,0,10240,10240,2.1
78571,Saint-Nom-la-Bretèche,4877,188230,11445,199675,40.9
94047,Mandres-les-Roses,4876,58322,39755,98077,20.1
56147,Nivillac,4874,87087,46410,133497,27.4
34276,Saint-Mathieu-de-Tréviers,4869,63250,90723,153973,31.6
42110,L'Horme,4868,57703,114059,171762,35.3
10325,Rosières-près-Troyes,4866,139734,69486,209220,43
83031,Le Cannet-des-Maures,4866,87800,20823,108623,22.3
56008,Baden,4864,65705,44998,110703,22.8
33140,Créon,4863,149940,480140,630080,129.6
59462,Phalempin,4863,156299,82996,239295,49.2
76178,Cléon,4863,1550379,138905,1689284,347.4
22004,Bégard,4862,89497,87061,176558,36.3
44211,La Turballe,4862,190035,67336,257371,52.9
27165,Conches-en-Ouche,4860,148694,43238,191932,39.5
59481,Le Quesnoy,4859,269668,13713,283381,58.3
69006,Amplepuis,4858,289891,57421,347312,71.5
81145,Lisle-sur-Tarn,4857,60618,266857,327475,67.4
89287,Paron,4855,109036,32264,141300,29.1
89086,Charny Orée de Puisaye,4854,107793,219176,326969,67.4
18213,Saint-Germain-du-Puy,4852,79657,92936,172593,35.6
33104,Castelnau-de-Médoc,4850,92300,3041,95341,19.7
61486,Tinchebray-Bocage,4850,42558,163863,206421,42.6
13023,Ceyreste,4847,17200,136232,153432,31.7
60342,Laigneville,4846,35628,2029,37657,7.8
62865,Vitry-en-Artois,4842,22290,6025,28315,5.8
37154,Montbazon,4839,19442,77029,96471,19.9
91044,Ballainvilliers,4838,36377,50253,86630,17.9
30132,La Grand-Combe,4837,146738,151192,297930,61.6
65460,Vic-en-Bigorre,4830,102790,109103,211893,43.9
62268,Desvres,4827,353334,13937,367271,76.1
63040,Billom,4826,114820,46289,161109,33.4
30333,Uchaud,4824,53683,0,53683,11.1
38189,Heyrieux,4824,10496,135361,145857,30.2
33036,Bazas,4819,128550,1602,130152,27
31135,Cazères,4818,264989,168724,433713,90
72124,Écommoy,4818,83915,10065,93980,19.5
36006,Argenton-sur-Creuse,4817,156649,35368,192017,39.9
54430,Pompey,4815,208384,46365,254749,52.9
9282,Saverdun,4808,192670,21647,214317,44.6
84099,Robion,4803,52200,46815,99015,20.6
66050,Claira,4801,51970,7391,59361,12.4
26113,Die,4796,327193,266651,593844,123.8
60088,Bornel,4796,27400,15430,42830,8.9
60670,Verneuil-en-Halatte,4795,51430,7007,58437,12.2
79062,Cerizay,4795,97919,136401,234320,48.9
38130,La Côte-Saint-André,4793,95112,52292,147404,30.8
29254,Saint-Martin-des-Champs,4792,23369,287324,310693,64.8
31410,Pechbonnieu,4792,56592,34360,90952,19
1185,Plateau d'Hauteville,4790,133321,181196,314517,65.7
37153,Monnaie,4785,80085,85474,165559,34.6
56186,Quiberon,4782,286891,185035,471926,98.7
63470,Volvic,4779,0,36142,36142,7.6
86062,Chasseneuil-du-Poitou,4776,147345,284549,431894,90.4
67472,Soufflenheim,4775,289291,57861,347152,72.7
38348,Ruy-Montceau,4771,14610,57974,72584,15.2
44081,Legé,4769,50705,62717,113422,23.8
83092,Pignans,4767,68558,20400,88958,18.7
88516,Vittel,4766,519407,1678,521085,109.3
7349,La Voulte-sur-Rhône,4762,462018,15889,477907,100.4
38399,Saint-Jean-de-Bournay,4762,61611,51953,113564,23.8
77182,La Ferté-Gaucher,4762,52532,78416,130948,27.5
62767,Saint-Pol-sur-Ternoise,4759,506104,102809,608913,127.9
42271,Saint-Paul-en-Jarez,4758,175885,111481,287366,60.4
62774,Sangatte,4755,252027,142916,394943,83.1
48092,Marvejols,4752,200861,113293,314154,66.1
21425,Montbard,4751,129895,92547,222442,46.8
66182,Sainte-Marie-la-Mer,4749,91500,39555,131055,27.6
69115,Limas,4749,23103,100825,123928,26.1
88304,Mirecourt,4746,140955,68207,209162,44.1
10033,Bar-sur-Aube,4743,295964,0,295964,62.4
13045,Graveson,4743,51211,24710,75921,16
68155,Ingersheim,4743,49713,97476,147189,31
85300,Venansault,4743,217316,224186,441502,93.1
76709,Le Trait,4742,0,135449,135449,28.6
1142,Dagneux,4741,20597,64554,85151,18
59278,Hallennes-lez-Haubourdin,4739,25100,78477,103577,21.9
16028,Barbezieux-Saint-Hilaire,4738,173985,253348,427333,90.2
91179,Le Coudray-Montceaux,4738,205085,93938,299023,63.1
44070,La Haie-Fouassière,4734,40996,87404,128400,27.1
29076,Milizac-Guipronvel,4733,357724,8525,366249,77.4
87125,Rilhac-Rancon,4733,93234,67117,160351,33.9
34309,Teyran,4729,96221,88114,184335,39
62846,Vermelles,4729,140705,78039,218744,46.3
68269,Ribeauvillé,4723,285128,11291,296419,62.8
59566,Sequedin,4722,82124,78196,160320,34
30284,Saint-Martin-de-Valgalgues,4721,31249,147566,178815,37.9
24312,Sanilhac,4720,62450,26361,88811,18.8
62032,Angres,4719,44330,127131,171461,36.3
33363,Sadirac,4718,33116,465824,498940,105.8
59168,Cysoing,4717,66865,80504,147369,31.2
97308,Saint-Georges,4710,0,0,0,0
68226,Munster,4709,200680,189027,389707,82.8
56117,Locminé,4708,153061,18975,172036,36.5
29031,Clohars-Carnoët,4701,214130,161509,375639,79.9
44187,Saint-Père-en-Retz,4701,65066,131197,196263,41.7
58059,La Charité-sur-Loire,4701,178200,265316,443516,94.3
67194,Herrlisheim,4701,24413,56964,81377,17.3
91064,Bièvres,4700,438860,38955,477815,101.7
27065,Beuzeville,4697,170149,35096,205245,43.7
47106,Fumel,4696,120963,27053,148016,31.5
34148,Maraussan,4693,66420,43821,110241,23.5
35032,Bourgbarré,4692,188339,240438,428777,91.4
79185,Aigondigné,4685,12367,135305,147672,31.5
94048,Marolles-en-Brie,4685,67750,38197,105947,22.6
35131,L'Hermitage,4683,239020,239977,478997,102.3
37267,Véretz,4682,41821,83634,125455,26.8
44096,Mésanger,4681,253289,57191,310480,66.3
51535,Sézanne,4679,240038,61053,301091,64.3
97112,Grand-Bourg,4678,24181,248102,272283,58.2
22222,Plouha,4677,129542,94719,224261,47.9
25367,Mandeure,4672,139640,295755,435395,93.2
76462,Neufchâtel-en-Bray,4671,61803,109115,170918,36.6
49167,Les Garennes sur Loire,4670,350082,92710,442792,94.8
69046,Charly,4670,289332,337675,627007,134.3
74311,Viuz-en-Sallaz,4668,140500,24398,164898,35.3
35299,Saint-Méloir-des-Ondes,4666,47919,110628,158547,34
14027,Les Monts d'Aunay,4664,32484,172949,205433,44
40287,Sanguinet,4662,35332,127231,162563,34.9
57540,Phalsbourg,4657,316379,9346,325725,69.9
62321,Évin-Malmaison,4657,51237,73846,125083,26.9
71047,Bourbon-Lancy,4656,440011,23935,463946,99.6
31079,Bouloc,4655,5838,9352,15190,3.3
69176,Soucieu-en-Jarrest,4652,74859,149286,224145,48.2
54079,Blénod-lès-Pont-à-Mousson,4649,132175,50794,182969,39.4
57032,Ars-sur-Moselle,4645,63183,230302,293485,63.2
59276,Guesnain,4645,80896,64721,145617,31.3
80799,Villers-Bretonneux,4644,62870,613,63483,13.7
30259,Saint-Hilaire-de-Brethmas,4643,57137,145128,202265,43.6
42097,La Fouillouse,4643,256143,108787,364930,78.6
35297,Saint-Méen-le-Grand,4642,239651,90138,329789,71
62051,Auchy-les-Mines,4642,20262,76603,96865,20.9
62773,Samer,4642,68601,13403,82004,17.7
64499,Salies-de-Béarn,4642,324238,97035,421273,90.8
90008,Bavilliers,4641,66465,161915,228380,49.2
13082,Rognes,4640,107845,130414,238259,51.3
47052,Casteljaloux,4639,198077,78282,276359,59.6
57049,Le Ban-Saint-Martin,4637,44342,229905,274247,59.1
45173,Jargeau,4636,117059,9013,126072,27.2
6147,Tourrette-Levens,4633,107445,91214,198659,42.9
73128,Grésy-sur-Aix,4633,32033,25631,57664,12.4
43020,Bas-en-Basset,4631,55368,418203,473571,102.3
72346,La Suze-sur-Sarthe,4628,208470,24788,233258,50.4
59024,Auberchicourt,4626,41785,55625,97410,21.1
14715,Trouville-sur-Mer,4624,402085,366000,768085,166.1
40119,Hagetmau,4622,286730,106787,393517,85.1
94053,Noiseau,4619,29426,37659,67085,14.5
76452,Montville,4618,113903,3156,117059,25.3
44126,La Plaine-sur-Mer,4617,22237,140742,162979,35.3
68349,Village-Neuf,4617,653910,89740,743650,161.1
49129,Écouflant,4614,108936,74692,183628,39.8
76647,Saint-Romain-de-Colbosc,4608,389386,41564,430950,93.5
12096,Espalion,4607,389262,22815,412077,89.4
69063,Collonges-au-Mont-d'Or,4604,215802,332903,548705,119.2
35059,La Chapelle-des-Fougeretz,4603,178193,235877,414070,90
35133,Iffendic,4603,65211,52883,118094,25.7
54157,Dieulouard,4603,31700,50292,81992,17.8
35031,La Bouëxière,4602,116460,17926,134386,29.2
35006,Argentré-du-Plessis,4591,101960,68975,170935,37.2
59414,Montigny-en-Ostrevent,4588,73293,55168,128461,28
69289,Saint-Pierre-de-Chandieu,4588,315645,13560,329205,71.8
95257,La Frette-sur-Seine,4587,150547,13906,164453,35.9
81144,Lescure-d'Albigeois,4585,61554,44508,106062,23.1
66016,Banyuls-sur-Mer,4583,206520,18926,225446,49.2
91405,Milly-la-Forêt,4582,72340,159640,231980,50.6
17003,Aigrefeuille-d'Aunis,4578,105896,189424,295320,64.5
13018,Cabannes,4576,298934,23840,322774,70.5
60584,Saint-Leu-d'Esserent,4576,90705,47064,137769,30.1
91685,Villiers-sur-Orge,4576,104309,45970,150279,32.8
33262,Macau,4575,72720,1300,74020,16.2
95612,Le Thillay,4575,90183,56737,146920,32.1
22171,Plaintel,4571,205006,72497,277503,60.7
35023,Bédée,4571,51117,52516,103633,22.7
64132,Bizanos,4570,111100,134932,246032,53.8
83100,Puget-Ville,4568,38450,19548,57998,12.7
35076,Chavagne,4562,187794,233776,421570,92.4
64065,Ascain,4561,206215,118521,324736,71.2
37063,Château-Renault,4560,84767,20011,104778,23
67205,Hœrdt,4557,261373,75708,337081,74
83068,Grimaud,4557,218530,36516,255046,56
53119,L'Huisserie,4554,35508,198191,233699,51.3
67389,Reichstett,4554,51134,1769135,1820269,399.7
35239,Retiers,4553,131428,88634,220062,48.3
84029,Camaret-sur-Aigues,4549,81782,0,81782,18
38468,Salaise-sur-Sanne,4548,436555,116263,552818,121.6
62764,Saint-Nicolas,4548,86890,127919,214809,47.2
62033,Annay,4544,23110,122416,145526,32
17452,La Tremblade,4543,45151,71547,116698,25.7
59160,Crespin,4541,55086,87479,142565,31.4
56173,Pluméliau-Bieuzy,4535,179364,10650,190014,41.9
85081,Dompierre-sur-Yon,4535,128276,214354,342630,75.6
85284,Soullans,4535,39017,69944,108961,24
69206,Saint-Georges-de-Reneins,4533,60174,0,60174,13.3
28227,Maintenon,4532,102195,132057,234252,51.7
11202,Leucate,4531,238742,70070,308812,68.2
29207,Plourin-lès-Morlaix,4529,198512,271555,470067,103.8
69272,Communay,4524,74538,27414,101952,22.5
97205,Case-Pilote,4524,55792,40961,96753,21.4
29190,Plougonvelin,4520,71671,8142,79813,17.7
41106,Lamotte-Beuvron,4519,122510,37104,159614,35.3
62128,Biache-Saint-Vaast,4519,103928,5623,109551,24.2
66011,Bages,4519,33666,18662,52328,11.6
69270,Chaponnay,4519,39849,27384,67233,14.9
83058,Flayosc,4514,62700,56229,118929,26.3
57620,Sainte-Marie-aux-Chênes,4512,70963,1130,72093,16
2361,Guise,4510,139439,24861,164300,36.4
59375,Marchiennes,4506,214862,54182,269044,59.7
86293,Vivonne,4505,51730,102930,154660,34.3
38412,Saint-Laurent-du-Pont,4502,235775,308259,544034,120.8
85163,Noirmoutier-en-l'Île,4502,199818,153389,353207,78.5
49347,Tiercé,4498,147912,34414,182326,40.5
34146,Lunel-Viel,4497,57970,49166,107136,23.8
6032,Cap-d'Ail,4491,214990,88418,303408,67.6
31117,Castelmaurou,4491,45378,32202,77580,17.3
97226,Sainte-Anne,4491,79000,22065,101065,22.5
88090,Charmes,4489,152153,112886,265039,59
41047,La Chaussée-Saint-Victor,4488,95998,172007,268005,59.7
17218,Marans,4487,139100,65374,204474,45.6
13048,Jouques,4478,113730,125861,239591,53.5
16167,Jarnac,4478,141786,167547,309333,69.1
42022,Bonson,4478,25785,40121,65906,14.7
27562,Saint-Marcel,4474,280494,23508,304002,67.9
59301,Hergnies,4471,30853,86130,116983,26.2
67378,Plobsheim,4471,3600,1736891,1740491,389.3
13046,Gréasque,4469,68230,125608,193838,43.4
97218,Le Morne-Rouge,4469,42000,40463,82463,18.5
34162,Montagnac,4465,78179,49592,127771,28.6
91458,Nozay,4465,109310,46379,155689,34.9
60636,Thourotte,4460,50850,22662,73512,16.5
69250,La Tour-de-Salvagny,4460,561457,322491,883948,198.2
35308,Mesnil-Roc'h,4457,106882,55794,162676,36.5
54174,Écrouves,4457,92759,9298,102057,22.9
51058,Bezannes,4456,26500,79192,105692,23.7
59477,Provin,4456,99678,73791,173469,38.9
31035,Auzeville-Tolosane,4451,66702,72570,139272,31.3
35125,La Guerche-de-Bretagne,4450,287766,66856,354622,79.7
38559,Vinay,4449,0,71899,71899,16.2
33324,Pineuilh,4447,7350,33569,40919,9.2
24102,Chancelade,4442,56210,24808,81018,18.2
27049,Mesnil-en-Ouche,4441,53680,19146,72826,16.4
33352,La Réole,4441,72101,36156,108257,24.4
50601,Torigny-les-Villes,4441,66235,65684,131919,29.7
30223,Rousson,4437,53700,138689,192389,43.4
64393,Monein,4436,203956,119444,323400,72.9
91433,Morigny-Champigny,4435,58358,11169,69527,15.7
11429,Villemoustaussou,4434,88131,28760,116891,26.4
77222,Guignes,4434,25080,4204,29284,6.6
36031,Buzançais,4431,124228,7020,131248,29.6
44030,La Chapelle-des-Marais,4424,54805,163024,217829,49.2
33213,La Brède,4423,89500,39946,129446,29.3
25434,Ornans,4421,276390,32217,308607,69.8
63308,Royat,4420,323110,167611,490721,111
76711,Le Tréport,4417,379941,12703,392644,88.9
38261,Morestel,4416,171323,22798,194121,44
66227,Villeneuve-de-la-Raho,4416,0,36782,36782,8.3
91016,Angerville,4416,36909,11122,48031,10.9
53084,Craon,4415,76825,29227,106052,24
33539,Vayres,4414,34300,86100,120400,27.3
62401,Haisnes,4411,109847,72791,182638,41.4
64519,Serres-Castet,4411,187356,69065,256421,58.1
73006,Aime-la-Plagne,4409,251800,221782,473582,107.4
69013,Arnas,4408,18170,93585,111755,25.4
80410,Ham,4408,83334,84017,167351,38
78382,Maurecourt,4399,37434,131156,168590,38.3
12052,Capdenac-Gare,4394,211000,129758,340758,77.6
80368,Friville-Escarbotin,4394,38750,29213,67963,15.5
62038,Ardres,4393,99085,26888,125973,28.7
14101,Bretteville-sur-Odon,4392,375515,97731,473246,107.8
68162,Kaysersberg Vignoble,4391,380218,224226,604444,137.7
80164,Camon,4387,30340,281257,311597,71
83150,Vinon-sur-Verdon,4387,139651,50995,190646,43.5
4242,Villeneuve,4386,75750,50983,126733,28.9
57628,Sarralbe,4386,80569,59941,140510,32
78168,Coignières,4385,241719,109300,351019,80
67281,Marckolsheim,4384,428981,92346,521327,118.9
91534,Saclay,4380,83754,45496,129250,29.5
22209,Beaussais-sur-Mer,4379,50054,116658,166712,38.1
35179,Miniac-Morvan,4379,414,103823,104237,23.8
6122,Saint-Jeannet,4378,171053,86194,257247,58.8
31421,Pins-Justaret,4377,61660,5436,67096,15.3
57508,Nilvange,4375,85886,89908,175794,40.2
84133,La Tour-d'Aigues,4375,180502,19628,200130,45.7
29236,Riec-sur-Bélon,4374,180949,150274,331223,75.7
50532,Saint-Pair-sur-Mer,4372,153544,105811,259355,59.3
67324,Niederbronn-les-Bains,4372,172206,160110,332316,76
37123,Langeais,4370,168893,40537,209430,47.9
64405,Morlaàs,4367,111124,45585,156709,35.9
24026,Bassillac et Auberoche,4365,58410,24378,82788,19
38548,Villard-de-Lans,4365,414200,516739,930939,213.3
24340,Prigonrieux,4362,44750,97108,141858,32.5
17093,Le Château-d'Oléron,4359,80822,472186,553008,126.9
91617,Tigery,4359,63870,86424,150294,34.5
37172,Notre-Dame-d'Oé,4358,55770,51561,107331,24.6
83067,Gonfaron,4349,63850,18611,82461,19
6064,Gattières,4345,88555,85544,174099,40.1
53140,Louverné,4345,114624,189096,303720,69.9
86222,Saint-Georges-lès-Baillargeaux,4345,102183,258871,361054,83.1
45235,Ormes,4341,221435,63494,284929,65.6
73137,Jacob-Bellecombette,4340,12099,55165,67264,15.5
84038,Cheval-Blanc,4340,27810,42302,70112,16.2
62688,Rang-du-Fliers,4339,36750,46161,82911,19.1
19073,Égletons,4336,66756,55630,122386,28.2
82124,Montbeton,4335,6800,37746,44546,10.3
16287,Roullet-Saint-Estèphe,4334,123886,112677,236563,54.6
34240,Saint-Aunès,4333,87224,32288,119512,27.6
69066,Cours,4329,464986,51169,516155,119.2
30075,Caveirac,4328,159595,15941,175536,40.6
67495,Truchtersheim,4328,80000,82344,162344,37.5
84026,Cadenet,4327,66427,19413,85840,19.8
35123,Goven,4326,240816,39039,279855,64.7
66108,Millas,4325,96999,5836,102835,23.8
74267,Sevrier,4324,187490,33401,220891,51.1
3098,Désertines,4323,0,101757,101757,23.5
69133,Millery,4323,320644,116795,437439,101.2
86082,Valence-en-Poitou,4323,144110,97353,241463,55.9
31389,Montrabé,4322,41265,105664,146929,34
50410,Pontorson,4319,123638,106266,229904,53.2
87161,Saint-Léonard-de-Noblat,4319,114328,17776,132104,30.6
15267,Ytrac,4316,180701,146233,326934,75.7
31254,Labège,4316,440602,70369,510971,118.4
33099,Carignan-de-Bordeaux,4312,35260,93117,128377,29.8
17283,Pons,4308,263720,50868,314588,73
21317,Is-sur-Tille,4308,73676,61318,134994,31.3
59580,Steenvoorde,4308,359918,26320,386238,89.7
91457,La Norville,4308,34800,43277,78077,18.1
91333,Leuville-sur-Orge,4307,19382,43267,62649,14.5
54495,Saulxures-lès-Nancy,4306,42756,143798,186554,43.3
22081,Hillion,4304,191932,68262,260194,60.5
34324,Valras-Plage,4300,159072,24910,183982,42.8
78255,Freneuse,4299,25486,21978,47464,11
38455,Saint-Savin,4297,23000,52214,75214,17.5
68309,Sierentz,4296,62174,83501,145675,33.9
31460,Roquettes,4292,39716,5331,45047,10.5
13036,Eyragues,4289,296073,22345,318418,74.2
35363,Pont-Péan,4289,14723,219786,234509,54.7
85213,Rives de l'Yon,4285,45815,202538,248353,58
26197,Montélier,4284,14966,86840,101806,23.8
27112,Breteuil,4284,139324,120483,259807,60.6
59107,Bray-Dunes,4284,314170,523099,837269,195.4
34336,Villeneuve-lès-Béziers,4283,59580,24811,84391,19.7
62861,Vimy,4281,124945,115331,240276,56.1
44113,Nozay,4280,91016,68120,159136,37.2
60446,Nanteuil-le-Haudouin,4274,0,16734,16734,3.9
69228,Chabanière,4274,137070,137156,274226,64.2
26037,Beaumont-lès-Valence,4272,39668,86597,126265,29.6
19274,Ussac,4271,23660,68164,91824,21.5
29037,Combrit,4271,53976,160303,214279,50.2
69052,Chazay-d'Azergues,4270,43620,38481,82101,19.2
89418,Tonnerre,4268,109250,9916,119166,27.9
50002,Agneaux,4266,35904,63095,98999,23.2
30206,Poulx,4265,120320,15709,136029,31.9
67073,Châtenois,4265,45034,82053,127087,29.8
71499,Sanvignes-les-Mines,4265,74498,68531,143029,33.5
13010,Barbentane,4262,109050,22204,131254,30.8
77238,Jouarre,4262,0,16598,16598,3.9
2A032,Bastelicaccia,4258,100300,58123,158423,37.2
30082,Clarensac,4257,220328,15679,236007,55.4
83143,Le Val,4257,62256,159493,221749,52.1
27428,Le Neubourg,4251,444291,18282,462573,108.8
41220,Saint-Laurent-Nouan,4249,152579,29769,182348,42.9
76258,Terres-de-Caux,4247,82600,32366,114966,27.1
2B123,Ghisonaccia,4246,114400,0,114400,26.9
83104,Rians,4245,84016,43541,127557,30
1376,Saint-Maurice-de-Beynost,4243,0,136790,136790,32.2
43041,Brives-Charensac,4242,389811,176506,566317,133.5
31066,Bessières,4238,75410,0,75410,17.8
14658,Noues de Sienne,4236,119670,1935,121605,28.7
22118,Lanvallay,4235,38610,112822,151432,35.8
97102,Anse-Bertrand,4232,220445,60110,280555,66.3
35251,Saint-Aubin-d'Aubigné,4231,66587,90887,157474,37.2
77100,Le Châtelet-en-Brie,4231,63100,4012,67112,15.9
89345,Saint-Florentin,4230,275800,27333,303133,71.7
29216,Pluguffan,4229,96394,135755,232149,54.9
30211,Redessan,4227,190405,15569,205974,48.7
25356,Maîche,4226,79847,29439,109286,25.9
41242,Selles-sur-Cher,4225,56010,77637,133647,31.6
26301,Saint-Donat-sur-l'Herbasse,4224,41245,185859,227104,53.8
62826,Le Touquet-Paris-Plage,4223,1173611,44927,1218538,288.5
27116,Brionne,4220,83012,18193,101205,24
43205,Saint-Just-Malmont,4220,650,65681,66331,15.7
29170,Plomelin,4216,45180,135337,180517,42.8
56034,Carnac,4215,219229,163096,382325,90.7
67339,Betschdorf,4212,44920,116058,160978,38.2
45300,Sandillon,4209,91640,8183,99823,23.7
61007,Athis-Val de Rouvre,4208,69790,112704,182494,43.4
82075,Grisolles,4206,5350,56444,61794,14.7
14191,Courseulles-sur-Mer,4202,201290,28288,229578,54.6
67282,Marlenheim,4200,116646,228112,344758,82.1
49332,La Séguinière,4199,128313,174481,302794,72.1
56175,Plumergat,4199,44068,162477,206545,49.2
6112,Le Rouret,4198,114670,50871,165541,39.4
69179,Beauvallon,4198,21736,134717,156453,37.3
59571,Solesmes,4193,100945,1055,102000,24.3
47209,Pont-du-Casse,4192,199943,95963,295906,70.6
67551,Wolfisheim,4191,66888,1628117,1695005,404.4
60104,Breteuil,4189,213234,94467,307701,73.5
57647,Serémange-Erzange,4188,584936,86065,671001,160.2
80725,Salouël,4188,3510,268498,272008,64.9
72386,Yvré-l'Évêque,4187,126844,85657,212501,50.8
13083,Rognonas,4186,190642,21808,212450,50.8
34163,Montarnaud,4186,38040,22610,60650,14.5
68287,Rouffach,4186,112514,411005,523519,125.1
73215,Valgelon-La Rochette,4185,114452,74841,189293,45.2
61464,Sées,4182,121901,26237,148138,35.4
38126,Corenc,4177,140330,161359,301689,72.2
54261,Herserange,4176,87885,38993,126878,30.4
59302,Hérin,4176,27295,157104,184399,44.2
73270,Saint-Pierre-d'Albigny,4175,235233,74662,309895,74.2
59207,Escautpont,4174,154106,157029,311135,74.5
44074,Indre,4172,871991,181563,1053554,252.5
51507,Sainte-Menehould,4166,96872,61858,158730,38.1
77085,Chanteloup-en-Brie,4166,4150,10299,14449,3.5
59002,Abscon,4160,24995,156502,181497,43.6
26084,Châteauneuf-sur-Isère,4159,114473,84306,198779,47.8
16061,Brie,4157,45757,108075,153832,37
35245,Romillé,4154,226257,212868,439125,105.7
95604,Survilliers,4154,149325,51516,200841,48.3
26010,Anneyron,4152,20951,68349,89300,21.5
35127,Guignen,4149,332119,37442,369561,89.1
77372,Pomponne,4149,113935,10257,124192,29.9
13062,Mimet,4147,40000,116558,156558,37.8
17010,Angoulins,4147,209745,115080,324825,78.3
31396,Nailloux,4146,14300,20222,34522,8.3
35253,Saint-Aubin-du-Cormier,4145,201732,16146,217878,52.6
69285,Pusignan,4145,192726,12251,204977,49.5
69024,Val d'Oingt,4143,60213,37337,97550,23.5
91249,Forges-les-Bains,4138,38290,19088,57378,13.9
50139,Condé-sur-Vire,4136,36294,61173,97467,23.6
68021,Bartenheim,4135,718556,80371,798927,193.2
60450,Neuilly-en-Thelle,4132,97116,17162,114278,27.7
61145,Domfront en Poiraie,4131,149382,139570,288952,69.9
27469,Pont-de-l'Arche,4130,49412,122478,171890,41.6
28348,Saint-Lubin-des-Joncherets,4129,51217,5523,56740,13.7
63019,Aulnat,4127,73098,156501,229599,55.6
76366,Le Houlme,4127,36063,117882,153945,37.3
6148,Tourrettes-sur-Loup,4126,51900,49998,101898,24.7
59260,Ghyvelde,4126,96145,503807,599952,145.4
44168,Saint-Joachim,4125,104328,152006,256334,62.1
17168,Fouras,4124,195990,67913,263903,64
54090,Bouxières-aux-Dames,4122,70000,39692,109692,26.6
42285,Saint-Romain-le-Puy,4121,41221,36922,78143,19
44002,Aigrefeuille-sur-Maine,4121,96814,76086,172900,42
83033,Carnoules,4120,95345,17631,112976,27.4
37226,Sainte-Maure-de-Touraine,4118,47116,111735,158851,38.6
22203,Plœuc-L'Hermitage,4117,133669,65297,198966,48.3
34169,Montferrier-sur-Lez,4117,29460,326418,355878,86.4
89263,Monéteau,4113,130500,80463,210963,51.3
44216,Vieillevigne,4110,32521,75883,108404,26.4
3013,Avermes,4109,99157,55311,154468,37.6
63125,Courpière,4109,63613,95269,158882,38.7
54039,Baccarat,4107,169519,18146,187665,45.7
91494,Le Plessis-Pâté,4107,97929,41258,139187,33.9
68043,Bollwiller,4104,148667,285894,434561,105.9
59592,Thumeries,4102,23600,70008,93608,22.8
59340,Leffrinckoucke,4101,111100,500754,611854,149.2
59266,Gondecourt,4099,67250,69957,137207,33.5
95430,Montsoult,4095,6100,23676,29776,7.3
22186,Pléneuf-Val-André,4094,125164,49413,174577,42.6
56118,Locmiquélic,4094,139602,92596,232198,56.7
78206,Ecquevilly,4090,304750,38065,342815,83.8
59036,Avesnes-sur-Helpe,4088,178018,32383,210401,51.5
35004,Val-Couesnon,4084,56010,125192,181202,44.4
26333,Saint-Vallier,4083,65371,67213,132584,32.5
30012,Aramon,4082,151197,16046,167243,41
44049,Le Croisic,4081,104150,56520,160670,39.4
45067,Chaingy,4081,103041,16816,119857,29.4
46127,Gourdon,4080,252090,122099,374189,91.7
69159,Porte des Pierres Dorées,4079,28687,0,28687,7
30060,Caissargues,4077,246850,15016,261866,64.2
34183,Nissan-lez-Enserune,4077,88600,38069,126669,31.1
44149,Saffré,4075,41726,64857,106583,26.2
11145,Fleury,4071,93960,62956,156916,38.5
11116,Cuxac-d'Aude,4070,111080,62941,174021,42.8
68321,Staffelfelden,4070,193366,283525,476891,117.2
97225,Saint-Pierre,4069,94462,36841,131303,32.3
28359,Saint-Rémy-sur-Avre,4065,46185,5437,51622,12.7
28110,Le Coudray,4063,46100,118391,164491,40.5
35223,Plélan-le-Grand,4063,55398,71501,126899,31.2
32119,Eauze,4060,230070,0,230070,56.7
85020,Benet,4059,128078,63611,191689,47.2
1025,Bâgé-Dommartin,4057,23600,55717,79317,19.6
59092,Bouchain,4054,156138,152514,308652,76.1
90075,Offemont,4054,67797,141436,209233,51.6
17337,Saint-Georges-d'Oléron,4052,90180,438930,529110,130.6
19005,Allassac,4050,34794,64637,99431,24.6
82161,Saint-Étienne-de-Tulmont,4050,107603,32875,140478,34.7
56097,Landévant,4049,40553,156672,197225,48.7
66140,Pézilla-la-Rivière,4048,97630,33716,131346,32.4
83103,Le Revest-les-Eaux,4046,33181,174357,207538,51.3
12270,Sévérac d'Aveyron,4044,73745,383004,456749,112.9
74137,Groisy,4044,191367,31238,222605,55
76164,Rives-en-Seine,4044,357416,30819,388235,96
22190,Pleslin-Trigavou,4043,30215,107707,137922,34.1
29135,Loctudy,4043,87639,151746,239385,59.2
72329,Savigné-l'Évêque,4042,77193,75558,152751,37.8
73171,Montmélian,4041,162625,72266,234891,58.1
33012,Arsac,4040,55950,1148,57098,14.1
78327,Juziers,4040,77190,37600,114790,28.4
30128,Générac,4039,44744,14876,59620,14.8
67202,Hochfelden,4039,59360,135736,195096,48.3
36046,La Châtre,4038,156797,88698,245495,60.8
71090,La Chapelle-de-Guinchay,4038,50885,103143,154028,38.1
74293,Veigy-Foncenex,4035,152700,175670,328370,81.4
18267,Trouy,4034,22702,77268,99970,24.8
68338,Turckheim,4033,93861,82884,176745,43.8
35327,Servon-sur-Vilaine,4032,161391,116034,277425,68.8
60103,Bresles,4032,26180,158107,184287,45.7
44025,Campbon,4031,32296,89603,121899,30.2
17461,Vaux-sur-Mer,4030,42850,63468,106318,26.4
27103,Bourg-Achard,4029,44210,16506,60716,15.1
33203,Hourtin,4028,69023,3892,72915,18.1
59390,Masny,4028,87010,48435,135445,33.6
21603,Semur-en-Auxois,4027,143907,85510,229417,57
48140,Saint-Chély-d'Apcher,4025,143750,41345,185095,46
13031,La Destrousse,4023,0,113073,113073,28.1
28279,Nogent-le-Roi,4023,129569,23344,152913,38
34194,Paulhan,4022,55625,4582,60207,15
16281,La Rochefoucauld-en-Angoumois,4020,97797,71688,169485,42.2
34161,Montady,4020,44400,37537,81937,20.4
58117,Fourchambault,4019,79431,216166,295597,73.5
65235,Juillan,4019,40000,38395,78395,19.5
77114,Chevry-Cossigny,4019,44700,28382,73082,18.2
38529,Vaulnaveys-le-Haut,4018,50550,155217,205767,51.2
57412,Longeville-lès-Metz,4017,277312,199165,476477,118.6
76222,Duclair,4017,257447,114740,372187,92.7
27299,Gravigny,4016,187836,47231,235067,58.5
59514,Rousies,4016,49517,143253,192770,48
72176,Le Lude,4016,191346,20136,211482,52.7
56179,Pont-Scorff,4015,110843,90810,201653,50.2
85039,La Bruffière,4015,27330,67277,94607,23.6
59489,Raimbeaucourt,4012,58315,55901,114216,28.5
44028,Le Cellier,4011,152566,49005,201571,50.3
56061,La Gacilly,4011,134545,48796,183341,45.7
59309,Hondschoote,4010,82260,77231,159491,39.8
39434,Poligny,4007,131242,88627,219869,54.9
44135,Le Pouliguen,4007,339684,55495,395179,98.6
27105,Grand Bourgtheroulde,4006,42925,16412,59337,14.8
60155,Cires-lès-Mello,3997,34355,16602,50957,12.7
95504,Presles,3994,48326,25968,74294,18.6
62604,Neufchâtel-Hardelot,3993,553635,134982,688617,172.5
67222,Ingwiller,3993,16743,107601,124344,31.1
4116,Les Mées,3992,148923,167324,316247,79.2
44150,Saint-Aignan-Grandlieu,3991,187232,173686,360918,90.4
29177,Plouarzel,3987,271235,7181,278416,69.8
56054,Erdeven,3987,66038,154273,220311,55.3
50236,La Haye,3986,62011,83286,145297,36.5
78367,Mareil-Marly,3984,63440,5637,69077,17.3
47004,Aiguillon,3983,50961,38264,89225,22.4
88429,Saint-Nabord,3983,55272,10167,65439,16.4
28422,Les Villages Vovéens,3977,47940,20888,68828,17.3
66148,Port-Vendres,3976,149618,16419,166037,41.8
76116,Boos,3975,0,113540,113540,28.6
63345,Saint-Genès-Champanelle,3974,0,150699,150699,37.9
6118,Saint-Cézaire-sur-Siagne,3971,77970,101387,179357,45.2
25463,Pont-de-Roide-Vermondans,3971,300982,251379,552361,139.1
86100,Fontaine-le-Comte,3971,114982,236588,351570,88.5
59369,Maing,3970,72950,76479,149429,37.6
22206,Châtelaudren-Plouagat,3968,47712,80360,128072,32.3
80570,Moreuil,3968,118470,24376,142846,36
44014,Le Bignon,3967,58646,18804,77450,19.5
59598,Toufflers,3964,168989,65643,234632,59.2
22259,Quévert,3963,47053,105576,152629,38.5
38006,Allevard,3962,104864,73618,178482,45
94070,Santeny,3958,68453,32270,100723,25.4
85018,Beauvoir-sur-Mer,3955,0,26409,26409,6.7
44045,Cordemais,3954,324230,87891,412121,104.2
34341,Villeveyrac,3953,78900,155277,234177,59.2
54415,Pagny-sur-Moselle,3953,126600,43190,169790,43
29140,Loperhet,3952,108502,30630,139132,35.2
56231,Saint-Nolff,3952,69343,36561,105904,26.8
88075,La Bresse,3947,335111,30829,365940,92.7
69064,Condrieu,3945,16640,30352,46992,11.9
73151,Porte-de-Savoie,3944,106390,70531,176921,44.9
4152,Pierrevert,3943,25450,45834,71284,18.1
37077,Cinq-Mars-la-Pile,3943,94641,36576,131217,33.3
14020,Argences,3940,60601,31711,92312,23.4
57224,Folschviller,3937,291244,67223,358467,91.1
17429,Soubise,3935,16038,64800,80838,20.5
69116,Limonest,3933,104100,284385,388485,98.8
62736,Sailly-sur-la-Lys,3932,86550,64542,151092,38.4
22258,Quessoy,3930,46943,47434,94377,24
29209,Plouvien,3930,124587,30775,155362,39.5
1320,Replonges,3929,39534,53959,93493,23.8
22054,Erquy,3929,176190,47422,223612,56.9
84065,Lauris,3929,38866,38296,77162,19.6
14738,Verson,3927,62900,87384,150284,38.3
39526,Tavaux,3926,72704,79682,152386,38.8
35168,Val d'Anast,3925,186700,35421,222121,56.6
38200,Jarrie,3925,246035,151624,397659,101.3
85215,Saint-Fulgent,3924,101160,32817,133977,34.1
29197,Plouhinec,3923,69170,280779,349949,89.2
54270,Hussigny-Godbrange,3921,117481,36612,154093,39.3
77389,La Rochette,3919,103237,54603,157840,40.3
69227,Saint-Martin-en-Haut,3917,428593,196327,624920,159.5
44115,Oudon,3915,358553,47832,406385,103.8
62019,Aix-Noulette,3915,70680,105471,176151,45
40296,Seignosse,3914,348295,87936,436231,111.5
47145,Layrac,3913,138680,89576,228256,58.3
30209,Pujaut,3911,38278,73399,111677,28.6
38374,Saint-Chef,3910,42206,20186,62392,16
59428,Neuville-Saint-Rémy,3909,38550,50810,89360,22.9
56001,Allaire,3906,87846,55723,143569,36.8
27507,Saint-André-de-l'Eure,3903,59500,45902,105402,27
54314,Lexy,3902,91073,36435,127508,32.7
51559,Suippes,3898,118911,36675,155586,39.9
56066,Gourin,3892,49977,124405,174382,44.8
77413,Saint-Germain-sur-Morin,3892,21850,110650,132500,34
67212,Holtzheim,3890,121448,1511185,1632633,419.7
63245,Mozac,3889,37550,29411,66961,17.2
66190,Salses-le-Château,3888,55876,5985,61861,15.9
77181,Ferrières-en-Brie,3887,51061,9609,60670,15.6
30135,Jonquières-Saint-Vincent,3886,70540,27197,97737,25.2
49086,Terranjou,3885,319147,77126,396273,102
54076,Blainville-sur-l'Eau,3885,76324,16051,92375,23.8
76655,Saint-Valery-en-Caux,3884,137655,25155,162810,41.9
82025,Bressols,3883,69325,33810,103135,26.6
85046,La Chaize-le-Vicomte,3883,143882,183536,327418,84.3
17380,Saint-Palais-sur-Mer,3879,65250,61090,126340,32.6
29006,Bénodet,3878,62491,42302,104793,27
49193,Le May-sur-Èvre,3878,51312,161143,212455,54.8
67345,Oberhoffen-sur-Moder,3878,51914,47153,99067,25.5
29171,Plomeur,3877,210793,145515,356308,91.9
35337,Tinténiac,3877,55175,48533,103708,26.7
74082,Collonges-sous-Salève,3876,502511,15189,517700,133.6
17021,Arvert,3875,30180,61027,91207,23.5
78402,Mézières-sur-Seine,3874,95742,36055,131797,34
97202,Les Anses-d'Arlet,3874,32350,19034,51384,13.3
88486,Vagney,3873,271932,30251,302183,78
88487,Le Val-d'Ajol,3873,91573,9886,101459,26.2
77315,Montry,3872,17750,110082,127832,33
35219,Pipriac,3871,120357,55224,175581,45.4
56013,Belz,3869,34016,149707,183723,47.5
60172,Coye-la-Forêt,3868,52501,77519,130020,33.6
31573,Verfeil,3867,151369,43373,194742,50.4
9185,Mazères,3866,196267,17405,213672,55.3
44122,Petit-Mars,3865,41051,23012,64063,16.6
72328,Sargé-lès-le-Mans,3865,38350,79070,117420,30.4
2A249,Propriano,3864,79421,0,79421,20.6
8490,Vouziers,3862,239606,93445,333051,86.2
77378,Pringy,3861,0,53795,53795,13.9
49298,Saint-Léger-de-Linières,3860,64653,62486,127139,32.9
60667,Verberie,3858,70450,34747,105197,27.3
78314,Issou,3858,50400,35906,86306,22.4
14699,Touques,3857,58031,305290,363321,94.2
61293,Mortagne-au-Perche,3857,85820,13542,99362,25.8
16138,Fléac,3856,200968,100249,301217,78.1
14068,Biéville-Beuville,3855,0,85782,85782,22.3
27090,Bosroumois,3855,72599,15793,88392,22.9
91085,Boissy-sous-Saint-Yon,3855,73259,26105,99364,25.8
34111,Ganges,3854,89709,82551,172260,44.7
59284,Hasnon,3853,84191,144952,229143,59.5
77420,Saint-Mard,3853,93286,47783,141069,36.6
44056,Fay-de-Bretagne,3852,23022,22935,45957,11.9
31299,Lherm,3849,47557,134790,182347,47.4
55463,Saint-Mihiel,3848,106585,56705,163290,42.4
56247,Sulniac,3847,51644,35589,87233,22.7
45142,Fay-aux-Loges,3846,42200,7477,49677,12.9
50639,Villedieu-les-Poêles-Rouffigny,3845,87485,64969,152454,39.6
62863,Violaines,3844,149100,63435,212535,55.3
35099,Domloup,3839,71014,110479,181493,47.3
62894,Wimille,3839,0,129776,129776,33.8
6011,Beaulieu-sur-Mer,3835,202211,75503,277714,72.4
79061,Celles-sur-Belle,3834,92621,110727,203348,53
85197,Montréverd,3833,0,64227,64227,16.8
83048,La Croix-Valmer,3832,231106,30706,261812,68.3
1450,Villieu-Loyes-Mollon,3831,80668,65381,146049,38.1
84064,Lapalud,3831,38400,35244,73644,19.2
22198,Pleumeur-Bodou,3828,59365,76046,135411,35.4
77040,Boissise-le-Roi,3828,0,53335,53335,13.9
42099,Fraisses,3825,65710,89621,155331,40.6
73150,La Plagne Tarentaise,3825,260211,192405,452616,118.3
57106,Bouzonville,3824,190850,55047,245897,64.3
60500,Le Plessis-Belleville,3822,78902,14965,93867,24.6
22343,Trébeurden,3821,53650,75907,129557,33.9
42225,Genilac,3821,49096,89527,138623,36.3
13059,Meyrargues,3818,121000,107311,228311,59.8
78003,Ablis,3814,76905,7431,84336,22.1
88415,Saint-Étienne-lès-Remiremont,3814,47904,9735,57639,15.1
83121,Salernes,3812,122145,47485,169630,44.5
54451,Réhon,3811,72990,35585,108575,28.5
60537,Ribécourt-Dreslincourt,3809,60486,19354,79840,21
67176,Gundershoffen,3808,20900,139455,160355,42.1
6136,Sospel,3807,52700,21367,74067,19.5
33065,Bouliac,3806,161600,97302,258902,68
27638,Le Thuit de l'Oison,3801,28981,15572,44553,11.7
45115,Courtenay,3799,38230,11517,49747,13.1
1263,Montmerle-sur-Saône,3798,29600,19604,49204,13
44063,Gétigné,3794,144246,70049,214295,56.5
45145,Ferrières-en-Gâtinais,3794,0,37214,37214,9.8
73003,Grand-Aigueblanche,3794,45973,820770,866743,228.5
83029,Callian,3794,30322,73200,103522,27.3
16089,Châteaubernard,3793,22922,141917,164839,43.5
66212,Torreilles,3793,86090,31593,117683,31
97111,Deshaies,3792,88529,10365,98894,26.1
16192,Terres-de-Haute-Charente,3790,99182,77976,177158,46.7
44161,Saint-Gildas-des-Bois,3790,91160,39349,130509,34.4
49283,Saint-Georges-sur-Loire,3787,76680,75181,151861,40.1
30350,Le Vigan,3786,96616,61067,157683,41.6
63214,Les Martres-de-Veyre,3786,65457,67867,133324,35.2
68270,Richwiller,3786,86036,263741,349777,92.4
74229,Saint-Cergues,3779,48884,60391,109275,28.9
35189,Montgermont,3777,48226,193549,241775,64
70245,Fougerolles-Saint-Valbert,3777,32380,24003,56383,14.9
47215,Pujols,3776,58960,28937,87897,23.3
13118,Coudoux,3775,99761,106102,205863,54.5
25547,Sochaux,3772,542566,238782,781348,207.1
24352,Ribérac,3770,103568,28627,132195,35.1
42259,Saint-Martin-la-Plaine,3768,132233,88285,220518,58.5
59504,Rœulx,3767,64123,141717,205840,54.6
6038,Châteauneuf-Grasse,3765,0,45624,45624,12.1
82079,Labastide-Saint-Pierre,3763,44990,50499,95489,25.4
59361,Lourches,3756,39624,141303,180927,48.2
84078,Mondragon,3756,65000,34554,99554,26.5
95509,Puiseux-en-France,3755,34650,46568,81218,21.6
82013,Beaumont-de-Lomagne,3754,163850,87998,251848,67.1
22183,Plémet,3751,91291,0,91291,24.3
69238,Saint-Symphorien-sur-Coise,3749,155719,187907,343626,91.7
24064,Brantôme en Périgord,3748,32234,52802,85036,22.7
72024,La Bazoge,3748,18208,210601,228809,61
36005,Ardentes,3747,53454,138877,192331,51.3
85076,Cugand,3746,0,62769,62769,16.8
57159,Créhange,3745,29560,173782,203342,54.3
33018,Val de Virvée,3744,14449,21142,35591,9.5
22211,Ploubezre,3741,20200,74318,94518,25.3
62297,Éperlecques,3740,46085,332860,378945,101.3
30263,Saint-Hippolyte-du-Fort,3739,85751,7772,93523,25
29179,Ploudaniel,3738,298178,94189,392367,105
91115,Bruyères-le-Châtel,3738,72060,37551,109611,29.3
19153,Objat,3737,76231,59642,135873,36.4
2B251,Prunelli-di-Fiumorbo,3736,126453,0,126453,33.8
40036,Bénesse-Maremne,3733,32016,83869,115885,31
2A272,Sartène,3732,40000,0,40000,10.7
35204,Nouvoitou,3732,28116,191243,219359,58.8
63042,Blanzat,3729,61600,141408,203008,54.4
77335,Chauconin-Neufmontiers,3726,36150,50813,86963,23.3
77482,Varennes-sur-Seine,3724,1243,2632,3875,1
72039,Bonnétable,3721,47558,69000,116558,31.3
31358,Montastruc-la-Conseillère,3719,56468,41713,98181,26.4
45247,Pannes,3719,25255,50102,75357,20.3
62080,Bapaume,3718,77630,18485,96115,25.9
49215,Montreuil-Bellay,3716,225695,36204,261899,70.5
78310,Houdan,3716,59518,37259,96777,26
62573,Meurchin,3715,21090,100083,121173,32.6
81273,Saïx,3714,0,4135,4135,1.1
74019,Argonay,3713,127275,28681,155956,42
76377,Isneauville,3713,86782,106057,192839,51.9
66002,Alénya,3712,35150,363,35513,9.6
25228,Étupes,3711,63231,234920,298151,80.3
69127,Marcy-l'Étoile,3711,106657,268332,374989,101
86163,Montamisé,3710,149188,221038,370226,99.8
29003,Audierne,3708,132376,265391,397767,107.3
85071,Commequiers,3708,36646,8066,44712,12.1
76624,Saint-Nicolas-d'Aliermont,3707,61801,23447,85248,23
86294,Vouillé,3707,99951,192641,292592,78.9
67061,Bouxwiller,3706,149425,99867,249292,67.3
42052,Charlieu,3703,216597,96071,312668,84.4
39470,Les Rousses,3702,31132,26349,57481,15.5
17146,Échillais,3701,9250,60947,70197,19
33234,Latresne,3699,26130,27231,53361,14.4
72200,Moncé-en-Belin,3699,126742,7727,134469,36.4
63455,Veyre-Monton,3698,23470,66290,89760,24.3
55291,Ligny-en-Barrois,3696,130261,44560,174821,47.3
29101,Landéda,3695,54015,28935,82950,22.4
29165,Plobannalec-Lesconil,3694,39198,138647,177845,48.1
49220,Morannes sur Sarthe-Daumeray,3694,46899,28262,75161,20.3
40224,Peyrehorade,3693,84101,27483,111584,30.2
13072,Peynier,3692,0,103769,103769,28.1
56140,Moréac,3692,58318,14880,73198,19.8
44223,Geneston,3691,118062,17495,135557,36.7
45269,Saint-Ay,3691,89525,15209,104734,28.4
78043,Bailly,3690,332536,30584,363120,98.4
44089,Malville,3689,31966,82001,113967,30.9
74104,Doussard,3688,70075,30410,100485,27.2
18050,La Chapelle-Saint-Ursin,3687,61365,70621,131986,35.8
32208,Lectoure,3685,197164,2092,199256,54.1
42234,Saint-Héand,3684,68002,86317,154319,41.9
26250,Pont-de-l'Isère,3683,32623,162055,194678,52.9
37163,Nazelles-Négron,3682,53370,99941,153311,41.6
38157,Estrablin,3682,19229,28328,47557,12.9
10321,La Rivière-de-Corps,3681,17850,52565,70415,19.1
72054,Champagné,3680,610910,75285,686195,186.5
35040,Breteil,3678,0,42256,42256,11.5
38378,Saint-Clair-du-Rhône,3678,115401,94023,209424,56.9
41149,Montoire-sur-le-Loir,3678,44918,45491,90409,24.6
58088,Coulanges-lès-Nevers,3678,53655,197825,251480,68.4
27226,Étrépagny,3677,414566,2996,417562,113.6
28070,Champhol,3674,34485,107056,141541,38.5
70120,Champagney,3674,23423,6225,29648,8.1
29011,Bohars,3671,37416,169020,206436,56.2
85129,Les Lucs-sur-Boulogne,3671,112044,31347,143391,39.1
40304,Soorts-Hossegor,3669,467221,82431,549652,149.8
33474,Saint-Selve,3668,24940,33127,58067,15.8
58121,Garchizy,3666,40500,197179,237679,64.8
68218,Morschwiller-le-Bas,3666,1327,255381,256708,70
31287,Lavernose-Lacasse,3665,117858,4552,122410,33.4
42168,Pélussin,3665,99330,112466,211796,57.8
76599,Saint-Léger-du-Bourg-Denis,3665,43850,104686,148536,40.5
24309,Neuvic,3663,0,19967,19967,5.5
91232,La Ferté-Alais,3663,0,5382,5382,1.5
6130,Saint-Vallier-de-Thiey,3662,42551,93497,136048,37.2
83057,Flassans-sur-Issole,3661,61719,15667,77386,21.1
60223,Estrées-Saint-Denis,3660,211015,3425,214440,58.6
7346,Viviers,3659,228350,291683,520033,142.1
71120,Chauffailles,3656,56920,70960,127880,35
77155,Dampmart,3655,22611,9036,31647,8.7
14117,Cabourg,3654,627180,46418,673598,184.3
27230,Ézy-sur-Eure,3653,41372,4886,46258,12.7
76276,Forges-les-Eaux,3653,713830,69008,782838,214.3
30276,Saint-Laurent-d'Aigouze,3651,89065,23456,112521,30.8
58160,Marzy,3650,150,196319,196469,53.8
22194,Plestin-les-Grèves,3649,48606,72490,121096,33.2
29162,Pleyben,3649,68696,57509,126205,34.6
30305,Salindres,3648,317,114027,114344,31.3
37031,Bourgueil,3648,43367,33840,77207,21.2
61397,Saint-Germain-du-Corbéis,3648,18965,107810,126775,34.8
85065,Chavagnes-en-Paillers,3648,69030,30509,99539,27.3
29027,Châteauneuf-du-Faou,3646,148455,29885,178340,48.9
2A006,Alata,3645,0,36546,36546,10
61474,Gouffern en Auge,3644,20124,7697,27821,7.6
41151,Montrichard Val de Cher,3641,56846,66906,123752,34
87126,Rochechouart,3637,87850,79541,167391,46
17086,Chaniers,3634,7725,115173,122898,33.8
59585,Templemars,3630,49724,60112,109836,30.3
8480,Villers-Semeuse,3628,38990,83340,122330,33.7
2064,Belleu,3624,54900,30318,85218,23.5
71221,Givry,3623,97858,99614,197472,54.5
27528,Le Vaudreuil,3622,402962,107413,510375,140.9
85262,Saint-Philbert-de-Bouaine,3622,136803,60692,197495,54.5
69163,Quincieux,3620,48960,261752,310712,85.8
97204,Le Carbet,3619,10600,32767,43367,12
49278,Sainte-Gemmes-sur-Loire,3617,397902,58553,456455,126.2
30123,Gallargues-le-Montueux,3615,78371,0,78371,21.7
35266,Saint-Erblon,3615,187007,185248,372255,103
68201,Masevaux-Niederbruck,3615,69289,75848,145137,40.1
85238,Saint-Laurent-sur-Sèvre,3613,42752,46294,89046,24.6
80674,Rivery,3609,266882,231378,498260,138.1
28012,Vald'Yerre,3608,29630,197154,226784,62.9
56151,Noyal-Pontivy,3605,36012,25100,61112,17
38013,Apprieu,3602,25710,19278,44988,12.5
38400,Saint-Jean-de-Moirans,3601,205624,61175,266799,74.1
3236,Saint-Germain-des-Fossés,3600,72958,98621,171579,47.7
34051,Canet,3600,38980,4102,43082,12
46224,Pradines,3600,30307,30397,60704,16.9
58079,Clamecy,3597,191617,75258,266875,74.2
64237,Gelos,3595,42550,106144,148694,41.4
14689,Thury-Harcourt-le-Hom,3593,88174,108624,196798,54.8
57413,Longeville-lès-Saint-Avold,3592,180270,166682,346952,96.6
57143,Clouange,3591,61903,900,62803,17.5
31048,Baziège,3590,38340,58532,96872,27
36202,Saint-Maur,3589,84216,133021,217237,60.5
3298,Varennes-sur-Allier,3588,74638,61971,136609,38.1
64038,Arcangues,3588,47450,93237,140687,39.2
77437,Saint-Soupplets,3586,62740,48904,111644,31.1
83119,Saint-Tropez,3586,1066645,28735,1095380,305.5
1265,Montréal-la-Cluse,3584,73712,135575,209287,58.4
59037,Avesnes-les-Aubert,3584,80486,24626,105112,29.3
63263,Orcines,3584,56000,135909,191909,53.5
34087,Cournonsec,3583,82477,284080,366557,102.3
29030,Cléder,3582,106586,6806,113392,31.7
38315,Le Pont-de-Beauvoisin,3582,37200,31411,68611,19.2
1031,Bellignat,3581,281456,135462,416918,116.4
33274,Martillac,3581,35850,32341,68191,19
26271,La Roche-de-Glun,3579,19410,157479,176889,49.4
32462,Vic-Fezensac,3578,162465,26018,188483,52.7
44051,Derval,3578,168576,60010,228586,63.9
44068,Guenrouet,3577,50072,37137,87209,24.4
62534,Lumbres,3577,109250,7739,116989,32.7
17197,Jonzac,3576,121765,42224,163989,45.9
77257,Lizy-sur-Ourcq,3575,39380,52493,91873,25.7
43089,Espaly-Saint-Marcel,3574,195440,148711,344151,96.3
29302,Pont-de-Buis-lès-Quimerch,3571,24880,46156,71036,19.9
85190,Rocheservière,3571,63388,59837,123225,34.5
87011,Bellac,3569,0,60743,60743,17
5070,Laragne-Montéglin,3566,142840,106310,249150,69.9
18087,Dun-sur-Auron,3566,64410,33214,97624,27.4
25048,Bavans,3566,157601,225741,383342,107.5
69131,Messimy,3565,125921,34360,160281,45
31454,Rieumes,3564,69960,124809,194769,54.6
14220,Deauville,3563,788838,282020,1070858,300.5
13076,Plan-d'Orgon,3562,278710,18557,297267,83.5
16090,Châteauneuf-sur-Charente,3562,67869,133274,201143,56.5
52353,Nogent,3562,65903,391260,457163,128.3
57616,Saint-Julien-lès-Metz,3562,21670,176606,198276,55.7
44137,Prinquiau,3557,26598,79066,105664,29.7
13038,Fontvieille,3555,51800,6544,58344,16.4
35088,Corps-Nuds,3555,112180,182173,294353,82.8
54549,Varangéville,3555,43650,28289,71939,20.2
66003,Amélie-les-Bains-Palalda,3553,119500,0,119500,33.6
51380,Montmirail,3551,29886,114089,143975,40.5
74128,Fillinges,3550,35500,18555,54055,15.2
14342,Isigny-sur-Mer,3549,37779,24567,62346,17.6
29185,Plouescat,3549,46285,6743,53028,14.9
59005,Allennes-les-Marais,3549,44066,58771,102837,29
81218,Puygouzon,3549,208900,34451,243351,68.6
51474,Saint-Brice-Courcelles,3546,960971,63019,1023990,288.8
73030,Barby,3545,79754,45060,124814,35.2
29015,Bourg-Blanc,3544,54582,27752,82334,23.2
38138,Crémieu,3543,0,18291,18291,5.2
59067,Bergues,3543,152248,68237,220485,62.2
64511,Sauvagnon,3542,18590,55459,74049,20.9
81222,Réalmont,3542,31550,73896,105446,29.8
45098,Cléry-Saint-André,3540,38918,14586,53504,15.1
79355,Vouillé,3538,16653,47684,64337,18.2
28168,Gallardon,3537,875,20524,21399,6.1
34037,Boujan-sur-Libron,3536,65860,20484,86344,24.4
79109,Échiré,3536,9323,47657,56980,16.1
35227,Pleumeleuc,3535,12099,40613,52712,14.9
68156,Issenheim,3534,249640,87209,336849,95.3
62744,Sainte-Catherine,3533,23950,99371,123321,34.9
12174,Olemps,3531,123902,54114,178016,50.4
34147,Magalas,3531,0,6907,6907,2
90032,Danjoutin,3531,56392,123189,179581,50.9
4197,Sainte-Tulle,3530,84049,41033,125082,35.4
25304,Hérimoncourt,3530,228803,223462,452265,128.1
56119,Locoal-Mendon,3529,58489,136551,195040,55.3
74143,Les Houches,3529,51352,1563263,1614615,457.5
38377,Saint-Clair-de-la-Tour,3526,37606,30920,68526,19.4
66069,Espira-de-l'Agly,3525,0,29360,29360,8.3
8491,Vrigne aux Bois,3524,52318,80951,133269,37.8
2B207,Penta-di-Casinca,3523,222045,16312,238357,67.7
44012,La Bernerie-en-Retz,3523,62662,107393,170055,48.3
59314,Hornaing,3522,62071,42350,104421,29.6
35013,Bains-sur-Oust,3521,133106,50231,183337,52.1
60482,Orry-la-Ville,3519,222910,70525,293435,83.4
17058,Bourcefranc-le-Chapus,3515,43770,80768,124538,35.4
67529,Weyersheim,3515,106037,58396,164433,46.8
37054,Chanceaux-sur-Choisille,3509,103940,41516,145456,41.5
38247,Montalieu-Vercieu,3508,0,18110,18110,5.2
49292,Val-du-Layon,3508,40730,69642,110372,31.5
71059,Le Breuil,3508,47510,56367,103877,29.6
95370,Marines,3508,87662,161179,248841,70.9
6046,Colomars,3507,0,69046,69046,19.7
33293,Montussan,3506,0,7359,7359,2.1
33165,Fargues-Saint-Hilaire,3504,0,75669,75669,21.6
15120,Mauriac,3503,152540,66255,218795,62.5
43177,Saint-Didier-en-Velay,3502,155452,54506,209958,60
74276,Taninges,3501,284101,672640,956741,273.3
38389,Saint-Georges-d'Espéranche,3500,71968,98209,170177,48.6
62489,Lapugnoy,3500,78770,57758,136528,39
66196,Sorède,3500,55572,14454,70026,20
38061,La Buisse,3499,0,59442,59442,17
44155,Saint-Colomban,3499,280248,16585,296833,84.8
46128,Gramat,3496,22150,114059,136209,39
65062,Barbazan-Debat,3495,0,33389,33389,9.6
84036,Châteauneuf-de-Gadagne,3495,114735,29143,143878,41.2
30274,Saint-Julien-les-Rosiers,3492,32474,109151,141625,40.6
72260,Ruaudin,3492,16648,71439,88087,25.2
9324,Varilhes,3491,48976,93831,142807,40.9
29247,Saint-Évarzec,3491,20818,38080,58898,16.9
42299,Savigneux,3489,162179,31260,193439,55.4
73257,Les Belleville,3488,7519566,270584,7790150,2233.4
81156,Marssac-sur-Tarn,3486,74780,33840,108620,31.2
29057,La Forêt-Fouesnant,3485,39692,38015,77707,22.3
33330,Pompignac,3485,0,75258,75258,21.6
1032,Béligneux,3484,29819,47438,77257,22.2
63338,Saint-Éloy-les-Mines,3484,91229,5407,96636,27.7
54254,Haucourt-Moulaine,3483,0,32522,32522,9.3
1014,Arbent,3482,336937,131717,468654,134.6
73181,Moûtiers,3482,90834,270119,360953,103.7
50076,Bréhal,3480,62042,84223,146265,42
7331,Vals-les-Bains,3479,132538,59381,191919,55.2
60575,Sainte-Geneviève,3478,61774,14446,76220,21.9
59398,Mérignies,3476,0,59324,59324,17.1
67256,Lampertheim,3475,86142,1349966,1436108,413.3
59581,Steenwerck,3474,65653,21225,86878,25
74303,Villaz,3473,108330,26827,135157,38.9
13065,Mouriès,3471,40000,6389,46389,13.4
73154,Mercury,3471,0,81877,81877,23.6
85034,Bournezeau,3471,288666,17671,306337,88.3
89460,Villeneuve-la-Guyard,3470,44553,639,45192,13
84030,Caromb,3469,0,113273,113273,32.7
1224,Loyettes,3468,46668,59186,105854,30.5
33473,Saint-Savin,3468,19560,19409,38969,11.2
12013,Aubin,3465,70062,34817,104879,30.3
34244,Saint-Brès,3462,39090,274486,313576,90.6
33381,Saint-Caprais-de-Bordeaux,3460,16400,25471,41871,12.1
43190,Saint-Germain-Laprade,3459,103137,143926,247063,71.4
56046,Crach,3458,37470,133804,171274,49.5
60178,Crèvecœur-le-Grand,3458,118051,135598,253649,73.4
88408,Rupt-sur-Moselle,3458,74386,6991,81377,23.5
67154,Gerstheim,3457,55798,63916,119714,34.6
97313,Montsinéry-Tonnegrande,3457,0,23076,23076,6.7
16097,Val-de-Cognac,3455,88710,129271,217981,63.1
40317,Tosse,3455,32860,77624,110484,32
62848,Verquin,3452,34155,56966,91121,26.4
77107,Chaumes-en-Brie,3452,29700,3273,32973,9.6
49060,Bellevigne-les-Châteaux,3450,41445,33613,75058,21.8
77394,Rubelles,3450,1523,48069,49592,14.4
13101,Saint-Savournin,3449,33650,96939,130589,37.9
30210,Quissac,3449,0,7169,7169,2.1
46251,Saint-Céré,3449,87725,112526,200251,58.1
55181,Étain,3449,41415,62302,103717,30.1
17194,La Jarrie,3447,20670,95655,116325,33.7
33501,Saucats,3446,41040,31122,72162,20.9
64061,Artix,3446,74543,92787,167330,48.6
56058,Férel,3445,328854,47711,376565,109.3
68249,Orbey,3445,57422,175919,233341,67.7
44032,La Chapelle-Heulin,3443,36773,35656,72429,21
14712,Troarn,3442,42495,76592,119087,34.6
32256,Mirande,3442,67545,52187,119732,34.8
63453,Vertaizon,3442,118888,33014,151902,44.1
85108,L'Herbergement,3437,219910,57592,277502,80.7
43112,Langeac,3433,153204,31261,184465,53.7
1269,Nantua,3431,164597,129788,294385,85.8
21452,Neuilly-Crimolois,3430,0,99536,99536,29
38439,Crêts en Belledonne,3430,45742,63733,109475,31.9
45272,Saint-Cyr-en-Val,3430,188212,50169,238381,69.5
77450,Servon,3430,43098,24222,67320,19.6
60012,Andeville,3429,13800,11032,24832,7.2
86133,Ligugé,3429,82347,204296,286643,83.6
91129,Cerny,3425,34460,5033,39493,11.5
22213,Plouër-sur-Rance,3423,47429,91190,138619,40.5
35150,Lécousse,3423,0,41913,41913,12.2
74241,Saint-Jeoire,3423,253400,17891,271291,79.3
91390,Le Mérévillois,3420,35750,8613,44363,13
45327,Traînou,3419,35452,10535,45987,13.5
29272,Saint-Yvi,3418,46540,37641,84181,24.6
33333,Le Porge,3418,0,2143,2143,0.6
17409,Saint-Sulpice-de-Royan,3417,55690,53814,109504,32
77463,Thomery,3417,54800,11885,66685,19.5
1138,Culoz-Béon,3416,65100,38073,103173,30.2
85070,Coëx,3416,58725,7431,66156,19.4
37014,Azay-le-Rideau,3415,41180,54361,95541,28
59331,Landrecies,3414,124206,9635,133841,39.2
34052,Capestang,3413,69775,19296,89071,26.1
34333,Vic-la-Gardiole,3413,47850,134065,181915,53.3
38170,Fontanil-Cornillon,3410,0,131730,131730,38.6
83032,Carcès,3407,63800,127647,191447,56.2
38451,Saint-Romain-de-Jalionas,3405,0,17579,17579,5.2
14456,Moult-Chicheboville,3404,0,27397,27397,8
26218,Mours-Saint-Eusèbe,3404,8350,69002,77352,22.7
56040,Cléguer,3404,36006,76990,112996,33.2
6126,Saint-Martin-du-Var,3403,0,66998,66998,19.7
68126,Hégenheim,3403,104401,66143,170544,50.1
1049,La Boisse,3401,69292,46308,115600,34
29191,Plougonven,3398,38582,203741,242323,71.3
37281,Vouvray,3397,19210,60681,79891,23.5
66168,Saint-André,3395,66780,14020,80800,23.8
84147,Villelaure,3395,47850,15231,63081,18.6
16292,Ruffec,3394,11900,74291,86191,25.4
2B346,Vescovato,3393,0,15710,15710,4.6
44094,Mauves-sur-Loire,3393,133353,147661,281014,82.8
17360,Sainte-Marie-de-Ré,3392,0,209445,209445,61.7
43251,Vals-près-le-Puy,3392,22583,141139,163722,48.3
85280,Sallertaine,3390,27449,22636,50085,14.8
1159,Feillens,3388,139880,46529,186409,55
29146,Melgven,3388,31955,37311,69266,20.4
34209,Portiragnes,3388,0,37630,37630,11.1
35033,Bourg-des-Comptes,3388,159787,30575,190362,56.2
56244,Sérent,3386,26213,41193,67406,19.9
60151,Choisy-au-Bac,3386,30825,30496,61321,18.1
40283,Saint-Vincent-de-Paul,3384,52242,28969,81211,24
56144,Évellys,3384,30365,13639,44004,13
90039,Essert,3382,16100,117991,134091,39.6
97310,Roura,3382,212000,22575,234575,69.4
63050,Brassac-les-Mines,3380,28885,21972,50857,15
29049,Elliant,3379,100414,37212,137626,40.7
62464,Hulluch,3377,0,90977,90977,26.9
49127,Durtal,3376,85014,25829,110843,32.8
91111,Briis-sous-Forges,3375,0,15569,15569,4.6
44117,Le Pallet,3374,22743,34941,57684,17.1
63302,La Roche-Blanche,3373,25291,60464,85755,25.4
1024,Attignat,3372,75117,65189,140306,41.6
29147,Mellac,3371,0,115815,115815,34.4
1333,Saint-André-de-Corcy,3369,179160,702,179862,53.4
13089,Saint-Andiol,3369,0,17552,17552,5.2
67291,Mertzwiller,3367,0,123305,123305,36.6
72051,Cérans-Foulletourte,3365,32915,18023,50938,15.1
78118,Buchelay,3364,40351,31308,71659,21.3
33448,Saint-Médard-d'Eyrans,3361,0,30355,30355,9
38332,Renage,3361,27050,17988,45038,13.4
85295,Treize-Septiers,3361,275701,56318,332019,98.8
41150,Mont-près-Chambord,3360,0,23541,23541,7
67045,Bischoffsheim,3360,11178,122045,133223,39.6
60143,Chaumont-en-Vexin,3359,0,73762,73762,22
89309,Pont-sur-Yonne,3357,53860,618,54478,16.2
34135,Lespignan,3355,0,31328,31328,9.3
22282,Saint-Cast-le-Guildo,3353,170893,89325,260218,77.6
30227,Saint-Ambroix,3353,75355,136091,211446,63.1
69268,Vourles,3353,159856,90588,250444,74.7
83059,Forcalqueiret,3353,0,125624,125624,37.5
35162,Louvigné-du-Désert,3352,244948,41044,285992,85.3
38384,Saint-Étienne-de-Saint-Geoirs,3352,41218,36570,77788,23.2
57144,Cocheren,3351,0,61261,61261,18.3
2A001,Afa,3350,0,33588,33588,10
41173,Beauce la Romaine,3350,37200,13804,51004,15.2
62571,Merlimont,3348,42745,35618,78363,23.4
57483,Morhange,3347,0,57149,57149,17.1
6007,Auribeau-sur-Siagne,3346,0,85429,85429,25.5
37243,Savonnières,3346,26755,39588,66343,19.8
44102,Montbert,3346,61998,15860,77858,23.3
62755,Saint-Léonard,3346,41600,113110,154710,46.2
38071,Champ-sur-Drac,3344,0,129180,129180,38.6
56137,Monterblanc,3342,53705,30917,84622,25.3
30036,Bernis,3341,236718,12305,249023,74.5
59158,Coutiches,3341,0,57020,57020,17.1
30004,Aigues-Vives,3340,63220,0,63220,18.9
95149,Chaumontel,3340,54849,19311,74160,22.2
62902,Wizernes,3339,30950,297171,328121,98.3
10003,Aix-Villemaur-Pâlis,3336,56905,58202,115107,34.5
31303,Longages,3336,102650,5737,108387,32.5
45258,Puiseaux,3336,0,25283,25283,7.6
59322,Iwuy,3335,126362,43349,169711,50.9
38175,Froges,3334,57748,61949,119697,35.9
57123,Carling,3332,50146,56893,107039,32.1
77121,Collégien,3332,65525,8237,73762,22.1
2A130,Grosseto-Prugna,3331,28924,2495,31419,9.4
40202,Narrosse,3331,32100,28515,60615,18.2
60513,Précy-sur-Oise,3331,35000,13835,48835,14.7
77005,Annet-sur-Marne,3329,15425,2530,17955,5.4
41167,Veuzain-sur-Loire,3327,36344,127510,163854,49.2
95256,Frépillon,3327,69190,10086,79276,23.8
61484,Val-au-Perche,3324,44215,38593,82808,24.9
30010,Anduze,3322,0,103837,103837,31.3
57260,Grosbliederstroff,3322,0,45400,45400,13.7
33108,Castillon-la-Bataille,3320,0,23165,23165,7
50546,Bourgvallées,3319,0,49089,49089,14.8
29239,Roscoff,3318,0,6304,6304,1.9
66224,Villelongue-de-la-Salanque,3318,0,27636,27636,8.3
44013,Besné,3317,0,122231,122231,36.8
64100,Bassussarry,3317,26684,86195,112879,34
77042,Boissy-le-Châtel,3313,0,12902,12902,3.9
77276,Mareuil-lès-Meaux,3313,33700,45181,78881,23.8
31541,Seilh,3311,47580,80947,128527,38.8
25204,Doubs,3309,10940,94582,105522,31.9
1072,Ceyzériat,3306,38204,63913,102117,30.9
82096,La Ville-Dieu-du-Temple,3305,0,42446,42446,12.8
31263,Lagardelle-sur-Lèze,3304,0,17379,17379,5.3
44185,Saint-Nicolas-de-Redon,3304,0,47135,47135,14.3
26170,Malissard,3303,22400,66955,89355,27.1
34159,Mireval,3301,81080,129666,210746,63.8
59316,Houplin-Ancoisne,3301,12175,54664,66839,20.2
33327,Podensac,3300,55650,101189,156839,47.5
29161,Pleuven,3298,29592,35975,65567,19.9
34134,Lavérune,3298,32950,261483,294433,89.3
14384,Luc-sur-Mer,3295,0,22182,22182,6.7
78442,Neauphle-le-Château,3295,96240,1422,97662,29.6
79005,Airvault,3295,144543,84269,228812,69.4
31574,Vernet,3294,82105,17326,99431,30.2
33004,Ambès,3291,0,84136,84136,25.6
65331,Odos,3291,0,31440,31440,9.6
29055,Le Folgoët,3290,121113,82900,204013,62
34272,Saint-Just,3290,0,35969,35969,10.9
37115,Descartes,3289,0,57092,57092,17.4
44061,Frossay,3289,174986,91790,266776,81.1
62361,Frévent,3288,47398,71031,118429,36
22182,Plélo,3283,0,66487,66487,20.3
27554,La Chapelle-Longueville,3283,0,17250,17250,5.3
22266,Rostrenen,3282,185598,302230,487828,148.6
11370,Salles-d'Aude,3280,25660,50724,76384,23.3
76005,Amfreville-la-Mi-Voie,3280,0,93689,93689,28.6
60508,Pontpoint,3279,0,4792,4792,1.5
25230,Exincourt,3273,0,207193,207193,63.3
80131,Boves,3273,0,209837,209837,64.1
44145,Rouans,3272,26680,99742,126422,38.6
82002,Albias,3272,0,26559,26559,8.1
37151,La Membrolle-sur-Choisille,3270,13325,38688,52013,15.9
69284,Montanay,3270,52299,236445,288744,88.3
2A041,Bonifacio,3269,129187,47944,177131,54.2
9312,La Tour-du-Crieu,3268,0,14713,14713,4.5
69249,Thurins,3268,0,31497,31497,9.6
74040,Bonne,3268,0,52225,52225,16
12264,Sébazac-Concourès,3266,7788,50053,57841,17.7
14137,Carpiquet,3266,0,72675,72675,22.3
50215,Gouville-sur-Mer,3266,0,94499,94499,28.9
50402,Les Pieux,3266,278762,102730,381492,116.8
66012,Baho,3266,0,27203,27203,8.3
14325,Hermanville-sur-Mer,3263,0,72609,72609,22.3
88009,Anould,3262,0,31715,31715,9.7
29023,Carantec,3261,68607,195527,264134,81
10265,Les Noës-près-Troyes,3260,0,46553,46553,14.3
38064,Cessieu,3257,0,28561,28561,8.8
43185,Sainte-Florine,3257,29250,36477,65727,20.2
45127,Dordives,3257,19197,31947,51144,15.7
77322,Moussy-le-Neuf,3255,0,40367,40367,12.4
57102,Bousse,3254,0,20850,20850,6.4
22325,Saint-Quay-Portrieux,3253,171892,51593,223485,68.7
11049,Bram,3252,111260,9628,120888,37.2
16199,Magnac-sur-Touvre,3252,13450,84546,97996,30.1
2A271,Sarrola-Carcopino,3250,0,32585,32585,10
50550,Saint-Sauveur-Villages,3250,23132,94036,117168,36.1
80318,Flixecourt,3247,0,5588,5588,1.7
3094,Creuzier-le-Vieux,3246,0,88924,88924,27.4
44033,La Chapelle-Launay,3246,0,72153,72153,22.2
28061,Brou,3245,67352,177318,244670,75.4
5179,Veynes,3244,0,121398,121398,37.4
74159,Magland,3242,0,29497,29497,9.1
59053,Bavay,3240,146232,9144,155376,48
77175,Évry-Grégy-sur-Yerre,3236,45519,3068,48587,15
1457,Vonnas,3233,0,13094,13094,4.1
66133,Palau-del-Vidre,3232,0,13347,13347,4.1
77419,Saint-Mammès,3232,21545,11241,32786,10.1
78683,Villiers-Saint-Frédéric,3231,0,1395,1395,0.4
28214,La Loupe,3230,71320,2300,73620,22.8
38039,Bernin,3230,61024,60017,121041,37.5
79013,Argentonnay,3229,53513,91854,145367,45
28196,Illiers-Combray,3228,0,11943,11943,3.7
4245,Volx,3227,115014,37511,152525,47.3
27493,Romilly-sur-Andelle,3227,224350,21232,245582,76.1
34140,Lignan-sur-Orb,3227,32748,18694,51442,15.9
17240,Montendre,3226,0,38092,38092,11.8
59292,Haveluy,3224,0,121289,121289,37.6
66094,Latour-Bas-Elne,3224,0,315,315,0.1
74200,Neuvecelle,3224,49667,167038,216705,67.2
29169,Plogonnec,3223,37792,103461,141253,43.8
31205,Gagnac-sur-Garonne,3223,0,78796,78796,24.4
85097,La Gaubretière,3223,0,41296,41296,12.8
2684,Saint-Michel,3222,0,63247,63247,19.6
50400,Picauville,3222,0,17461,17461,5.4
44176,Saint-Malo-de-Guersac,3221,0,118694,118694,36.9
59256,Fretin,3221,0,53339,53339,16.6
16341,Saint-Michel,3220,134181,83714,217895,67.7
37203,Rochecorbon,3220,99058,38097,137155,42.6
42182,Renaison,3220,1700,95021,96721,30
76482,Offranville,3218,71700,39108,110808,34.4
10357,Saint-Parres-aux-Tertres,3214,0,45896,45896,14.3
44079,Le Landreau,3214,131715,33284,164999,51.3
2B134,L'Île-Rousse,3213,214600,45091,259691,80.8
58151,La Machine,3213,0,8288,8288,2.6
69136,Montagny,3212,0,86779,86779,27
81219,Puylaurens,3212,0,3576,3576,1.1
77493,Verneuil-l'Étang,3211,0,41339,41339,12.9
44156,Corcoué-sur-Logne,3209,0,42201,42201,13.2
53077,Cossé-le-Vivien,3208,0,21237,21237,6.6
39362,Montmorot,3207,19090,101067,120157,37.5
74211,Pers-Jussy,3207,0,13814,13814,4.3
49192,Maulévrier,3206,81141,133219,214360,66.9
57368,Knutange,3206,0,65885,65885,20.6
59319,Hoymille,3206,0,61747,61747,19.3
26114,Dieulefit,3204,111360,111699,223059,69.6
45308,Semoy,3204,41675,46864,88539,27.6
64417,Nay,3203,87050,34254,121304,37.9
88087,Chantraine,3201,0,80497,80497,25.1
72146,Guécélard,3200,0,17139,17139,5.4
46309,Souillac,3199,84115,104370,188485,58.9
88468,Le Thillot,3198,0,6466,6466,2
37225,Saint-Martin-le-Beau,3193,37100,71848,108948,34.1
49048,Briollay,3193,309533,51689,361222,113.1
69117,Lissieu,3193,0,230877,230877,72.3
53161,Montsûrs,3192,0,22833,22833,7.2
56130,Merlevenez,3191,153671,11395,165066,51.7
6128,Saint-Paul-de-Vence,3190,76520,38656,115176,36.1
38148,Dolomieu,3188,0,27956,27956,8.8
17140,Dolus-d'Oléron,3187,57613,345229,402842,126.4
18108,La Guerche-sur-l'Aubois,3187,0,1009,1009,0.3
2B353,Ville-di-Pietrabugno,3187,0,47706,47706,15
50256,Isigny-le-Buat,3187,0,78414,78414,24.6
70207,Échenoz-la-Méline,3187,0,164862,164862,51.7
69298,Toussieu,3186,13226,9417,22643,7.1
72191,Mayet,3186,110310,15974,126284,39.6
17222,Marsilly,3185,167581,88384,255965,80.4
41212,Saint-Gervais-la-Forêt,3184,39320,122030,161350,50.7
47233,Sainte-Bazeille,3183,0,32932,32932,10.3
71336,Ouroux-sur-Saône,3183,0,18553,18553,5.8
69121,Lozanne,3182,0,28676,28676,9
7078,Davézieux,3181,161514,16388,177902,55.9
50419,Quettreville-sur-Sienne,3181,0,92039,92039,28.9
56031,Camors,3180,16341,123047,139388,43.8
57659,Spicheren,3180,0,58134,58134,18.3
59206,Escaudœuvres,3180,0,41334,41334,13
12090,Druelle Balsac,3179,0,48719,48719,15.3
71150,Crêches-sur-Saône,3179,32480,81201,113681,35.8
49343,La Tessoualle,3178,0,132056,132056,41.6
35220,Piré-Chancé,3177,0,91428,91428,28.8
66176,Saint-Hippolyte,3177,0,26462,26462,8.3
89346,Saint-Georges-sur-Baulche,3176,28000,62132,90132,28.4
29163,Pleyber-Christ,3175,43557,190370,233927,73.7
58134,Imphy,3175,244057,8190,252247,79.4
40313,Tartas,3174,0,74660,74660,23.5
30255,Saint-Geniès-de-Malgoirès,3172,22474,11683,34157,10.8
85031,Le Boupère,3170,0,86155,86155,27.2
56127,Mauron,3169,0,47721,47721,15.1
59068,Berlaimont,3169,0,113040,113040,35.7
61391,Saint-Georges-des-Groseillers,3169,47307,84876,132183,41.7
12056,Baraqueville,3168,0,96961,96961,30.6
55505,Thierville-sur-Meuse,3168,84680,196360,281040,88.7
67463,Seltz,3168,13194,363282,376476,118.8
59476,Proville,3167,0,41165,41165,13
78501,Porcheville,3167,119795,29475,149270,47.1
17230,Meschers-sur-Gironde,3165,73310,49845,123155,38.9
24256,Marsac-sur-l'Isle,3165,62108,17676,79784,25.2
57226,Fontoy,3163,0,33243,33243,10.5
33478,Saint-Seurin-sur-l'Isle,3161,0,61659,61659,19.5
7055,Charmes-sur-Rhône,3160,353917,61737,415654,131.5
6140,Le Tignet,3158,0,80629,80629,25.5
45282,Saint-Hilaire-Saint-Mesmin,3156,0,46162,46162,14.6
60589,Saint-Maximin,3153,0,32428,32428,10.3
25632,Voujeaucourt,3152,164184,199533,363717,115.4
45087,Châtillon-sur-Loire,3152,0,36691,36691,11.6
59012,Anor,3152,0,51707,51707,16.4
4230,Valensole,3151,122644,36627,159271,50.5
40233,Pouillon,3151,0,23449,23449,7.4
60107,Breuil-le-Vert,3150,0,16707,16707,5.3
77099,Château-Landon,3150,0,3319,3319,1.1
97108,Capesterre-de-Marie-Galante,3150,49000,167063,216063,68.6
43244,Tence,3148,30571,72111,102682,32.6
59015,Arleux,3148,0,43862,43862,13.9
39013,Arbois,3146,112256,69583,181839,57.8
33085,Camblanes-et-Meynac,3145,0,23152,23152,7.4
63099,Châteaugay,3143,54293,119186,173479,55.2
86095,Dissay,3143,56165,187257,243422,77.4
25532,Saône,3142,0,55361,55361,17.6
59479,Quarouble,3141,0,60509,60509,19.3
59564,La Sentinelle,3140,0,118129,118129,37.6
63210,Maringues,3140,0,12834,12834,4.1
59104,Boussois,3139,0,111970,111970,35.7
44037,Château-Thébaud,3138,31994,57937,89931,28.7
84142,Velleron,3138,0,58892,58892,18.8
43078,Coubon,3137,30882,130528,161410,51.5
56033,Carentoir,3137,51566,38164,89730,28.6
76591,Saint-Jacques-sur-Darnétal,3134,0,89518,89518,28.6
50165,Donville-les-Bains,3133,0,75825,75825,24.2
60068,Béthisy-Saint-Pierre,3133,29250,28218,57468,18.3
89013,Appoigny,3133,51680,61291,112971,36.1
17161,La Flotte,3131,100013,193329,293342,93.7
69296,Solaize,3131,58838,226394,285232,91.1
34127,Lansargues,3130,75722,23324,99046,31.6
22214,Plouézec,3129,0,56029,56029,17.9
85294,La Tranche-sur-Mer,3129,148433,66130,214563,68.6
33389,Saint-Ciers-sur-Gironde,3128,57827,29157,86984,27.8
95026,Asnières-sur-Oise,3128,0,18085,18085,5.8
3138,Lapalisse,3127,28570,6288,34858,11.1
37015,Azay-sur-Cher,3127,23533,55858,79391,25.4
83127,Signes,3126,0,1942,1942,0.6
30179,Montfrin,3125,0,12284,12284,3.9
67474,Soultz-sous-Forêts,3125,24846,86107,110953,35.5
83018,Besse-sur-Issole,3123,0,13364,13364,4.3
68058,Buhl,3122,0,77042,77042,24.7
31364,Montberon,3121,0,22378,22378,7.2
67445,Scherwiller,3121,47301,60044,107345,34.4
51612,Blancs-Coteaux,3120,0,62003,62003,19.9
8185,Fumay,3118,0,20018,20018,6.4
29266,Saint-Thégonnec Loc-Eguiner,3118,39666,186952,226618,72.7
76517,Quincampoix,3118,34944,2131,37075,11.9
88158,Éloyes,3117,0,7956,7956,2.6
59550,Salomé,3116,0,51600,51600,16.6
38511,Le Touvet,3115,73550,57880,131430,42.2
40243,Rion-des-Landes,3115,0,73272,73272,23.5
14752,Villers-Bocage,3113,0,115435,115435,37.1
30295,Saint-Quentin-la-Poterie,3110,0,23898,23898,7.7
32147,Gimont,3110,0,39505,39505,12.7
33179,Galgon,3109,0,46795,46795,15.1
56161,Ploemel,3109,28085,120300,148385,47.7
60142,La Chapelle-en-Serval,3109,0,62308,62308,20
73124,Gilly-sur-Isère,3109,0,73338,73338,23.6
33022,Avensan,3108,0,1949,1949,0.6
38457,Saint-Siméon-de-Bressieux,3107,0,33897,33897,10.9
5040,Chorges,3106,57070,248205,305275,98.3
9194,Mirepoix,3106,0,64336,64336,20.7
47069,Colayrac-Saint-Cirq,3106,0,71102,71102,22.9
11369,Sallèles-d'Aude,3104,43450,48002,91452,29.5
16085,Chasseneuil-sur-Bonnieure,3103,101913,63842,165755,53.4
63226,Mur-sur-Allier,3102,21220,29753,50973,16.4
78431,Morainvilliers,3102,0,28870,28870,9.3
45179,Lailly-en-Val,3100,0,12773,12773,4.1
91225,Étiolles,3100,0,61462,61462,19.8
49299,Saint-Léger-sous-Cholet,3099,31108,128773,159881,51.6
62666,Pont-à-Vendin,3099,0,83488,83488,26.9
22172,Plancoët,3095,0,82452,82452,26.6
54150,Custines,3095,0,29803,29803,9.6
7066,Chomérac,3094,69367,10323,79690,25.8
54152,Damelevières,3094,0,12783,12783,4.1
38182,Le Grand-Lemps,3093,0,16554,16554,5.4
14370,Le Molay-Littry,3092,0,21404,21404,6.9
10060,Bréviandes,3091,8122,44139,52261,16.9
4094,Gréoux-les-Bains,3088,146350,35895,182245,59
31186,Fonbeauzard,3086,0,75447,75447,24.4
31375,Montesquieu-Volvestre,3083,0,5302,5302,1.7
45194,Mardié,3083,0,45094,45094,14.6
47168,Miramont-de-Guyenne,3082,119534,57396,176930,57.4
74031,Beaumont,3081,33797,12074,45871,14.9
27279,Gasny,3080,189325,16183,205508,66.7
31065,Bérat,3079,0,107825,107825,35
49355,Trémentines,3078,31625,127900,159525,51.8
24098,Champcevinel,3077,51875,17185,69060,22.4
27306,Guichainville,3077,0,36188,36188,11.8
84017,Bédoin,3077,47670,100473,148143,48.1
68258,Pulversheim,3075,0,214211,214211,69.7
57441,Manom,3074,0,32308,32308,10.5
44088,Maisdon-sur-Sèvre,3071,50691,56700,107391,35
34310,Thézan-lès-Béziers,3070,30110,6005,36115,11.8
69087,Fontaines-Saint-Martin,3070,113433,221983,335416,109.3
49160,Ingrandes-le-Fresne-sur-Loire,3069,47761,37496,85257,27.8
33417,Sainte-Hélène,3068,0,1924,1924,0.6
83094,Le Plan-de-la-Tour,3068,0,24584,24584,8
44023,Bouvron,3067,0,39022,39022,12.7
25240,Les Fins,3062,108306,36449,144755,47.3
29181,Plouédern,3062,65965,23732,89697,29.3
44054,Erbray,3062,0,51356,51356,16.8
9306,Tarascon-sur-Ariège,3060,0,11812,11812,3.9
17064,Breuillet,3060,21961,48191,70152,22.9
60007,Agnetz,3060,0,16230,16230,5.3
89055,Brienon-sur-Armançon,3060,33250,19773,53023,17.3
57556,Puttelange-aux-Lacs,3058,0,41792,41792,13.7
45273,Saint-Denis-de-l'Hôtel,3057,139809,5943,145752,47.7
69294,Sérézin-du-Rhône,3057,0,18524,18524,6.1
85160,Nesmy,3056,8455,144447,152902,50
59466,Pont-à-Marcq,3054,0,52122,52122,17.1
22134,Louannec,3053,0,60650,60650,19.9
17349,Saint-Jean-de-Liversay,3050,0,44438,44438,14.6
80688,Rue,3050,52810,75525,128335,42.1
83085,La Motte,3050,0,37993,37993,12.5
24311,Nontron,3049,53036,20432,73468,24.1
38075,Chapareillan,3049,32600,56653,89253,29.3
83008,Bagnols-en-Forêt,3049,0,58826,58826,19.3
59335,Lecelles,3048,0,114668,114668,37.6
91099,Boutigny-sur-Essonne,3048,0,106195,106195,34.8
34289,Saint-Thibéry,3047,85434,33843,119277,39.1
44133,Port-Saint-Père,3046,44953,92852,137805,45.2
85114,Jard-sur-Mer,3046,0,61154,61154,20.1
91579,Saint-Vrain,3046,0,4476,4476,1.5
73330,Yenne,3045,0,19318,19318,6.3
72350,Teloché,3043,0,6357,6357,2.1
19063,Cosnac,3042,0,48550,48550,16
2243,Crouy,3041,0,25441,25441,8.4
17228,Médis,3041,17298,47892,65190,21.4
42069,Commelle-Vernay,3041,0,89738,89738,29.5
61508,Vimoutiers,3041,142746,21983,164729,54.2
81070,Coufouleux,3041,0,167081,167081,54.9
86123,Boivre-la-Vallée,3041,70742,158031,228773,75.2
50582,Sourdeval,3040,0,74797,74797,24.6
59146,Chéreng,3040,0,50342,50342,16.6
77371,Pommeuse,3039,14724,11835,26559,8.7
34178,Murviel-lès-Béziers,3038,72766,5942,78708,25.9
78233,Feucherolles,3038,66550,7129,73679,24.3
69207,Saint-Germain-au-Mont-d'Or,3037,0,219597,219597,72.3
88116,Cornimont,3037,170773,23721,194494,64
23008,Aubusson,3036,109104,114821,223925,73.8
29188,Plougasnou,3035,66983,181976,248959,82
44038,Chauvé,3035,225560,92517,318077,104.8
77176,Faremoutiers,3035,0,11820,11820,3.9
34225,Puisserguier,3034,0,17153,17153,5.7
17172,Gémozac,3033,44331,50527,94858,31.3
31293,Lespinasse,3032,0,74126,74126,24.4
7341,Villeneuve-de-Berg,3031,42451,94019,136470,45
44116,Paimbœuf,3030,130183,84562,214745,70.9
73236,Saint-Genix-les-Villages,3028,0,4483,4483,1.5
59193,Emmerin,3026,0,50110,50110,16.6
68295,Sainte-Croix-en-Plaine,3026,29289,62189,91478,30.2
76329,Gruchet-le-Valasse,3026,302571,23061,325632,107.6
74067,Chavanod,3024,0,23359,23359,7.7
24354,La Roche-Chalais,3023,68932,10572,79504,26.3
55043,Belleville-sur-Meuse,3023,32050,187373,219423,72.6
84047,Gargas,3020,0,61558,61558,20.4
14221,Démouville,3017,0,67135,67135,22.3
42019,Boën-sur-Lignon,3017,0,27031,27031,9
41226,Saint-Ouen,3016,14350,37304,51654,17.1
73103,Drumettaz-Clarafond,3016,0,16686,16686,5.5
44152,Sainte-Anne-sur-Brivet,3014,0,31292,31292,10.4
28373,Senonches,3013,0,53786,53786,17.9
38431,Saint-Nazaire-les-Eymes,3013,27334,55985,83319,27.7
50003,Agon-Coutainville,3013,0,87178,87178,28.9
69003,Albigny-sur-Saône,3013,423271,217862,641133,212.8
6150,La Turbie,3012,0,16905,16905,5.6
57529,Ottange,3012,0,25970,25970,8.6
66145,Ponteilla,3012,0,25087,25087,8.3
33514,Soulac-sur-Mer,3011,0,2909,2909,1
77132,Coupvray,3008,148320,85518,233838,77.7
62711,Rinxent,3007,0,11963,11963,4
12033,Bozouls,3006,0,14887,14887,5
57242,Gandrange,3006,0,6102,6102,2
64540,Urcuit,3006,28125,78113,106238,35.3
38225,Autrans-Méaudre en Vercors,3005,141159,355739,496898,165.4
57155,Courcelles-Chaussy,3005,0,7317,7317,2.4
74070,Chens-sur-Léman,3005,384249,130828,515077,171.4
88319,Moyenmoutier,3003,0,29197,29197,9.7
45187,Lorris,3002,0,30781,30781,10.3
62770,Saint-Venant,3002,0,49540,49540,16.5
65433,Soues,3000,0,28660,28660,9.6
29234,Rédené,2999,0,103034,103034,34.4
87019,Boisseuil,2997,97155,42499,139654,46.6
2B305,San-Martino-di-Lota,2996,0,44847,44847,15
83012,Barjols,2995,0,30719,30719,10.3
31145,Cintegabelle,2994,96660,15748,112408,37.5
11304,Quillan,2992,279199,32870,312069,104.3
97216,Le Marigot,2991,16500,27081,43581,14.6
25560,Thise,2990,25600,52683,78283,26.2
61491,Tourouvre au Perche,2989,56663,12732,69395,23.2
86113,Iteuil,2989,36900,68292,105192,35.2
84118,Saint-Saturnin-lès-Apt,2986,0,60865,60865,20.4
85153,Mouchamps,2986,0,12773,12773,4.3
95641,Vémars,2986,97650,37031,134681,45.1
22210,Ploubazlanec,2985,0,53451,53451,17.9
44050,Crossac,2985,19113,30991,50104,16.8
66175,Saint-Génis-des-Fontaines,2985,0,12327,12327,4.1
30278,Saint-Laurent-des-Arbres,2984,57600,43543,101143,33.9
85082,Les Epesses,2984,0,12764,12764,4.3
21295,Gevrey-Chambertin,2983,0,14305,14305,4.8
31273,Lapeyrouse-Fossat,2983,0,33458,33458,11.2
31399,Noé,2979,91615,5123,96738,32.5
81288,Sorèze,2978,0,60543,60543,20.3
40230,Pontonx-sur-l'Adour,2975,0,69979,69979,23.5
64371,Mauléon-Licharre,2975,136676,77308,213984,71.9
22197,Pleudihen-sur-Rance,2974,0,79229,79229,26.6
80011,Ailly-sur-Somme,2973,0,5116,5116,1.7
43162,Retournac,2971,23049,69642,92691,31.2
3102,Dompierre-sur-Besbre,2970,0,51297,51297,17.3
35263,Saint-Coulomb,2970,0,70417,70417,23.7
1348,Saint-Didier-sur-Chalaronne,2969,0,15325,15325,5.2
59660,Willems,2969,0,49166,49166,16.6
72269,Saint-Calais,2969,0,40138,40138,13.5
54234,Gorcy,2968,0,27713,27713,9.3
79130,Frontenay-Rohan-Rohan,2968,0,40002,40002,13.5
86092,Dangé-Saint-Romain,2968,0,67550,67550,22.8
59346,Lezennes,2966,0,49116,49116,16.6
69154,Pollionnay,2966,0,28587,28587,9.6
70421,Port-sur-Saône,2966,0,17615,17615,5.9
85004,Angles,2966,0,59548,59548,20.1
95426,Montlignon,2966,20830,5172,26002,8.8
47027,Bias,2965,0,22722,22722,7.7
26206,Montmeyran,2964,0,60083,60083,20.3
43025,Beauzac,2964,153121,267664,420785,142
29215,Plozévet,2963,22000,94908,116908,39.5
59589,Thiant,2963,0,111470,111470,37.6
90053,Grandvillars,2963,122328,17622,139950,47.2
85223,Sainte-Hermine,2962,99987,62600,162587,54.9
49294,Saint-Lambert-la-Potherie,2961,28480,47933,76413,25.8
6010,Le Bar-sur-Loup,2960,0,35869,35869,12.1
61167,La Ferté-en-Ouche,2960,28671,30513,59184,20
64558,Villefranque,2957,162088,76840,238928,80.8
67112,Duttlenheim,2957,37865,7618,45483,15.4
34010,Aniane,2956,34404,15967,50371,17
83088,Néoules,2956,0,110750,110750,37.5
86180,Nouaillé-Maupertuis,2955,47170,67515,114685,38.8
7076,Cruas,2954,287469,63246,350715,118.7
34176,Mudaison,2954,41150,22012,63162,21.4
50359,Mortain-Bocage,2954,0,72681,72681,24.6
95369,Margency,2954,30970,5151,36121,12.2
17190,L'Houmeau,2953,0,81946,81946,27.8
34249,Saint-Drézéry,2952,0,234050,234050,79.3
62277,Drocourt,2952,0,46810,46810,15.9
57690,Valmont,2951,15708,50388,66096,22.4
69033,Cailloux-sur-Fontaines,2951,0,213379,213379,72.3
22147,Merdrignac,2950,0,0,0,0
31253,Labastidette,2946,46622,3659,50281,17.1
40261,Saint-Geours-de-Maremne,2946,0,66188,66188,22.5
52250,Joinville,2944,0,10903,10903,3.7
62338,Fleurbaix,2944,0,48325,48325,16.4
18242,Sancoins,2941,19151,47127,66278,22.5
86019,Beaumont Saint-Cyr,2941,26840,175222,202062,68.7
86263,Smarves,2941,100,67196,67296,22.9
30019,Aubais,2938,16970,0,16970,5.8
31088,Brax,2938,44485,71828,116313,39.6
24223,Lalinde,2936,65199,10668,75867,25.8
88078,Bruyères,2935,0,3850,3850,1.3
66174,Saint-Féliu-d'Avall,2934,0,24438,24438,8.3
85243,Brem-sur-Mer,2933,33913,6380,40293,13.7
29210,Plouvorn,2932,279719,21654,301373,102.8
88114,Contrexéville,2932,0,1032,1032,0.4
22020,Broons,2931,0,78083,78083,26.6
57724,Vitry-sur-Orne,2929,18373,734,19107,6.5
72241,Montfort-le-Gesnois,2928,0,54734,54734,18.7
80680,Rosières-en-Santerre,2928,0,52991,52991,18.1
3001,Abrest,2927,0,80185,80185,27.4
73300,Tresserve,2927,0,16193,16193,5.5
74173,Megève,2927,2291783,30652,2322435,793.5
49002,Allonnes,2925,84875,28498,113373,38.8
73043,La Biolle,2922,27239,16166,43405,14.9
65226,Ibos,2921,0,27906,27906,9.6
42023,Bourg-Argental,2920,0,59743,59743,20.5
64147,Briscous,2920,0,75879,75879,26
81033,Blaye-les-Mines,2920,0,66804,66804,22.9
83138,Tourrettes,2920,57900,56337,114237,39.1
35282,Rives-du-Couesnon,2919,0,35742,35742,12.2
79170,Mauzé-sur-le-Mignon,2917,77921,39314,117235,40.2
64453,Pontacq,2916,35918,30439,66357,22.8
85038,Les Brouzils,2916,0,24387,24387,8.4
2334,Fresnoy-le-Grand,2915,0,26410,26410,9.1
38144,Diémoz,2915,0,81794,81794,28.1
42224,Saint-Genest-Malifaux,2912,0,59579,59579,20.5
71512,Sennecey-le-Grand,2911,7516,35263,42779,14.7
77259,Longperrier,2911,17250,36101,53351,18.3
50523,Sainte-Mère-Église,2910,0,15770,15770,5.4
16286,Rouillac,2909,155260,201664,356924,122.7
72138,Fresnay-sur-Sarthe,2909,0,136928,136928,47.1
18018,Avord,2908,0,13402,13402,4.6
53007,Argentré,2908,72316,126557,198873,68.4
34165,Montbazin,2903,30140,114032,144172,49.7
44108,Mouzillon,2903,42042,30063,72105,24.8
68135,Hésingue,2902,537165,56406,593571,204.5
33554,Yvrac,2901,0,6089,6089,2.1
69049,Chasselay,2901,0,26144,26144,9
1288,Péron,2900,0,37330,37330,12.9
57067,Bertrange,2900,0,18582,18582,6.4
72244,Précigné,2900,0,67445,67445,23.3
77210,La Grande-Paroisse,2899,0,2049,2049,0.7
31572,Venerque,2898,0,15243,15243,5.3
51217,Dormans,2898,0,4196,4196,1.4
76159,Cany-Barville,2898,0,18769,18769,6.5
38519,Valencin,2897,18650,81289,99939,34.5
90052,Giromagny,2897,45850,86291,132141,45.6
34166,Montblanc,2896,56583,16777,73360,25.3
84127,Sérignan-du-Comtat,2896,118280,0,118280,40.8
87178,Saint-Priest-Taurion,2896,0,4692,4692,1.6
91468,Ormoy,2896,0,4255,4255,1.5
60029,Auneuil,2895,0,113521,113521,39.2
7231,Saint-Étienne-de-Fontbellon,2894,16080,49396,65476,22.6
7181,Le Pouzin,2893,5771,9653,15424,5.3
24551,Thiviers,2889,74299,9532,83831,29
57288,Ham-sous-Varsberg,2889,0,17917,17917,6.2
77409,Saint-Germain-Laval,2887,0,2040,2040,0.7
42056,Chavanay,2886,0,88561,88561,30.7
67169,Gries,2886,149969,47946,197915,68.6
29279,Taulé,2883,30471,172862,203333,70.5
40134,Labouheyre,2883,0,22684,22684,7.9
42165,Panissières,2882,20083,52239,72322,25.1
2305,Fère-en-Tardenois,2881,0,66592,66592,23.1
84001,Althen-des-Paluds,2881,0,11481,11481,4
73157,Modane,2879,0,50869,50869,17.7
1027,Balan,2878,0,39187,39187,13.6
64138,Bordes,2878,0,30778,30778,10.7
37250,Sorigny,2877,27483,45797,73280,25.5
60116,Bury,2876,0,15254,15254,5.3
62480,Labourse,2876,0,47460,47460,16.5
11279,Pennautier,2875,0,18648,18648,6.5
22364,Trélivan,2875,0,76591,76591,26.6
63272,Pérignat-lès-Sarliève,2875,0,109023,109023,37.9
86076,Cissé,2875,16315,149404,165719,57.6
68348,Vieux-Thann,2874,35965,48367,84332,29.3
91135,Champcueil,2873,0,4222,4222,1.5
35224,Plerguer,2871,0,68069,68069,23.7
37270,Vernou-sur-Brenne,2871,22300,51285,73585,25.6
86226,Saint-Julien-l'Ars,2871,26826,171051,197877,68.9
10034,Bar-sur-Seine,2869,0,50082,50082,17.5
2A362,Zonza,2869,96100,66905,163005,56.8
38012,Aoste,2869,0,25159,25159,8.8
59156,Courchelettes,2868,0,39961,39961,13.9
10349,Saint-Lyé,2867,0,40941,40941,14.3
25127,Charquemont,2867,0,19972,19972,7
61096,Rives d'Andaine,2867,21950,35579,57529,20.1
63262,Orcet,2867,0,51393,51393,17.9
81209,Pont-de-Larn,2866,65754,30146,95900,33.5
9265,Saint-Jean-du-Falga,2864,0,12894,12894,4.5
1304,Pont-d'Ain,2862,0,41009,41009,14.3
2304,La Fère,2860,0,51387,51387,18
33533,Toulenne,2860,27737,29247,56984,19.9
48080,Langogne,2860,99541,25622,125163,43.8
56222,Saint-Jean-Brévelay,2860,0,11527,11527,4
44183,Saint-Molf,2859,0,39596,39596,13.8
66106,Maureillas-las-Illas,2859,0,118576,118576,41.5
69299,Colombier-Saugnieu,2859,0,8450,8450,3
19010,Argentat-sur-Dordogne,2857,117254,8479,125733,44
60462,Noailles,2857,38342,11867,50209,17.6
56153,Péaule,2856,31524,27194,58718,20.6
49333,Seiches-sur-le-Loir,2853,48297,21828,70125,24.6
59080,Beuvry-la-Forêt,2852,0,48675,48675,17.1
83124,Seillans,2852,0,55026,55026,19.3
56041,Cléguérec,2849,0,19836,19836,7
76367,Houppeville,2849,0,81378,81378,28.6
88181,Fraize,2849,0,27699,27699,9.7
37008,Athée-sur-Cher,2848,0,64085,64085,22.5
42011,Balbigny,2848,22659,51622,74281,26.1
77217,Grisy-Suisnes,2848,32950,2700,35650,12.5
31094,Buzet-sur-Tarn,2847,0,0,0,0
44192,Saint-Viaud,2846,164312,79427,243739,85.6
33268,Margaux-Cantenac,2844,0,808,808,0.3
59523,Sainghin-en-Mélantois,2844,0,47096,47096,16.6
76101,Blangy-sur-Bresle,2844,76857,54,76911,27
49269,Saint-Christophe-du-Bois,2843,32808,118135,150943,53.1
50565,Sartilly-Baie-Bocage,2843,0,69950,69950,24.6
70467,Saint-Loup-sur-Semouse,2842,0,18061,18061,6.4
56174,Plumelin,2841,0,11450,11450,4
56194,Rieux,2841,0,40530,40530,14.3
17336,Saint-Georges-des-Coteaux,2840,0,90009,90009,31.7
38052,Le Bourg-d'Oisans,2840,0,161535,161535,56.9
45104,Corquilleroy,2840,0,38260,38260,13.5
77393,Rozay-en-Brie,2840,0,14433,14433,5.1
82087,Lafrançaise,2839,0,14474,14474,5.1
72090,Connerré,2838,0,53051,53051,18.7
56263,Sainte-Anne-d'Auray,2837,23156,109775,132931,46.9
62023,Allouagne,2837,0,46817,46817,16.5
13003,Alleins,2833,0,79626,79626,28.1
45126,Donnery,2833,0,5508,5508,1.9
62037,Anzin-Saint-Aubin,2833,0,79682,79682,28.1
41067,Cour-Cheverny,2830,26100,108462,134562,47.5
25614,Vieux-Charmont,2829,16666,179086,195752,69.2
50168,Ducey-Les Chéris,2829,0,69605,69605,24.6
76302,Goderville,2829,21580,33501,55081,19.5
1007,Ambronay,2828,120632,48263,168895,59.7
26179,Mercurol-Veaunes,2828,0,124434,124434,44
26307,Saint-Jean-en-Royans,2827,257179,177054,434233,153.6
43152,Polignac,2827,19034,117629,136663,48.3
57428,Macheren,2827,0,48270,48270,17.1
62188,Burbure,2827,0,46652,46652,16.5
73225,Saint-Baldoph,2827,0,35934,35934,12.7
1378,Saint-Maurice-de-Gourdans,2826,0,48229,48229,17.1
41198,Saint-Aignan,2826,21455,51929,73384,26
61230,Longny les Villages,2826,54200,12037,66237,23.4
57752,Woustviller,2822,0,38567,38567,13.7
72344,Spay,2821,0,15109,15109,5.4
33540,Vendays-Montalivet,2820,0,2725,2725,1
42092,L'Étrat,2820,0,66073,66073,23.4
34307,Sussargues,2817,25941,223347,249288,88.5
35284,Saint-Jouan-des-Guérets,2816,0,66765,66765,23.7
56057,Le Faouët,2816,0,90011,90011,32
49054,Candé,2815,71722,2808,74530,26.5
62291,Éleu-dit-Leauwette,2815,0,75837,75837,26.9
29040,Le Conquet,2814,56458,5069,61527,21.9
44022,Boussay,2814,144084,51955,196039,69.7
54462,Rosières-aux-Salines,2814,0,22392,22392,8
59659,Wignehies,2813,0,46146,46146,16.4
89338,Saint-Clément,2813,43565,18694,62259,22.1
7064,Le Cheylard,2812,77131,60123,137254,48.8
14274,Fontaine-Étoupefour,2812,0,4973,4973,1.8
25315,L'Isle-sur-le-Doubs,2812,0,6486,6486,2.3
8488,Vivier-au-Court,2811,0,64572,64572,23
59258,Genech,2811,0,47975,47975,17.1
30356,Rodilhan,2810,0,10350,10350,3.7
97203,Basse-Pointe,2810,7500,25442,32942,11.7
33233,Laruscade,2808,0,15715,15715,5.6
56197,Val d'Oust,2808,43732,42284,86016,30.6
62224,Chocques,2808,0,46338,46338,16.5
85001,L'Aiguillon-la-Presqu'île,2808,0,59346,59346,21.1
26085,Châteauneuf-du-Rhône,2807,0,27045,27045,9.6
31004,Ayguesvives,2807,61355,45766,107121,38.2
19276,Uzerche,2806,0,0,0,0
54138,Cosnes-et-Romain,2805,31930,26191,58121,20.7
65025,Argelès-Gazost,2805,0,114861,114861,40.9
66009,Arles-sur-Tech,2805,0,0,0,0
71540,Torcy,2805,0,45071,45071,16.1
85112,L'Île-d'Olonne,2805,0,163736,163736,58.4
91359,Maisse,2804,0,97693,97693,34.8
28116,Courville-sur-Eure,2802,0,10367,10367,3.7
36093,Levroux,2802,65449,455,65904,23.5
44127,La Planche,2802,0,51733,51733,18.5
33248,Listrac-Médoc,2801,0,1757,1757,0.6
97312,Sinnamary,2801,381949,22998,404947,144.6
44010,Batz-sur-Mer,2799,72758,38765,111523,39.8
60616,Sérifontaine,2798,38250,22937,61187,21.9
4149,Peyruis,2796,0,117194,117194,41.9
29217,Pont-Aven,2796,0,30791,30791,11
35221,Pléchâtel,2796,0,40692,40692,14.6
28298,Pierres,2792,0,16201,16201,5.8
49163,Jarzé Villages,2792,0,21361,21361,7.7
57177,Dieuze,2792,134608,9239,143847,51.5
35090,Crevin,2790,25084,40604,65688,23.5
78420,Montfort-l'Amaury,2790,0,1204,1204,0.4
71106,Charolles,2789,0,10813,10813,3.9
76146,Buchy,2789,0,1906,1906,0.7
2360,Villeneuve-sur-Aisne,2788,65160,7502,72662,26.1
31345,Miremont,2787,16700,14660,31360,11.3
57289,Hambach,2787,0,38089,38089,13.7
86272,Thuré,2787,0,63430,63430,22.8
66186,Saint-Nazaire,2786,0,23205,23205,8.3
74007,Amancy,2786,53328,20307,73635,26.4
53152,Meslay-du-Maine,2784,0,16728,16728,6
66014,Baixas,2784,0,23188,23188,8.3
37006,Artannes-sur-Indre,2782,0,44285,44285,15.9
77048,Bourron-Marlotte,2782,0,23162,23162,8.3
49026,Bécon-les-Granits,2781,8967,80597,89564,32.2
83001,Les Adrets-de-l'Estérel,2780,0,98535,98535,35.4
10006,Arcis-sur-Aube,2779,0,2365,2365,0.9
13052,Maillane,2779,161850,14478,176328,63.5
31420,Pinsaguel,2779,39270,3452,42722,15.4
24299,Mussidan,2778,64016,133023,197039,70.9
52550,Wassy,2776,0,25141,25141,9.1
60665,Venette,2776,0,25002,25002,9
17308,Saint-Agnant,2774,8500,45681,54181,19.5
72320,Saint-Saturnin,2773,34061,56730,90791,32.7
85135,Mareuil-sur-Lay-Dissais,2773,66310,58606,124916,45
33496,Sallebœuf,2771,0,59840,59840,21.6
22161,Pabu,2769,0,49583,49583,17.9
27051,Beaumont-le-Roger,2767,90300,11929,102229,36.9
80724,Saleux,2767,0,177396,177396,64.1
59525,Sains-du-Nord,2766,33940,21911,55851,20.2
29060,Gouesnach,2765,111537,30161,141698,51.2
17155,Étaules,2763,13650,43514,57164,20.7
36034,Chabris,2762,0,2794,2794,1
60286,Grandvilliers,2761,0,13546,13546,4.9
24291,Montignac-Lascaux,2760,114850,38314,153164,55.5
44024,Brains,2760,32361,120114,152475,55.2
69007,Ampuis,2760,0,21235,21235,7.7
59429,Neuville-sur-Escaut,2759,0,103795,103795,37.6
84069,Malaucène,2759,91301,90089,181390,65.7
21663,Venarey-les-Laumes,2758,0,0,0,0
54111,Chaligny,2756,64014,28067,92081,33.4
34081,Colombiers,2755,0,25725,25725,9.3
50292,Marigny-Le-Lozon,2754,0,40732,40732,14.8
44077,Joué-sur-Erdre,2753,0,33635,33635,12.2
85221,Saint-Gervais,2752,0,18376,18376,6.7
67434,Sarre-Union,2751,403862,34488,438350,159.3
56017,Bignan,2750,0,11083,11083,4
34024,Balaruc-le-Vieux,2749,29070,107983,137053,49.9
72080,Cherré-Au,2746,0,16753,16753,6.1
8090,Carignan,2745,26410,97184,123594,45
24225,Lamonzie-Saint-Martin,2745,19750,61110,80860,29.5
70451,Ronchamp,2745,0,4651,4651,1.7
94056,Périgny,2744,0,22372,22372,8.2
22262,Quintin,2743,141759,43505,185264,67.5
77061,Cannes-Écluse,2742,0,1938,1938,0.7
33123,Cézac,2740,0,15335,15335,5.6
33219,La Lande-de-Fronsac,2739,0,41226,41226,15.1
74289,Vallières-sur-Fier,2739,17979,37092,55071,20.1
87014,Bessines-sur-Gartempe,2739,0,4438,4438,1.6
64304,Lahonce,2736,28015,71097,99112,36.2
64504,Sare,2736,146830,71097,217927,79.7
69118,Loire-sur-Rhône,2736,0,21050,21050,7.7
1238,Massieux,2733,0,43285,43285,15.8
59389,Masnières,2731,0,35498,35498,13
56172,Plumelec,2730,39829,11003,50832,18.6
89003,Montholon,2730,46550,64568,111118,40.7
28337,Saint-Georges-sur-Eure,2728,0,79490,79490,29.1
34274,Saint-Martin-de-Londres,2728,0,50830,50830,18.6
86233,Valdivienne,2728,28569,110335,138904,50.9
33081,Cadillac-sur-Garonne,2727,0,83619,83619,30.7
16106,Confolens,2726,208209,56085,264294,97
38357,Saint-André-le-Gaz,2726,0,23905,23905,8.8
77159,Donnemarie-Dontilly,2726,0,38605,38605,14.2
53137,Loiron-Ruillé,2724,0,118549,118549,43.5
7197,Roiffieux,2723,73667,14029,87696,32.2
29153,Névez,2721,36690,29965,66655,24.5
67523,Weitbruch,2721,0,45205,45205,16.6
77533,Vulaines-sur-Seine,2720,0,22646,22646,8.3
37022,Beaumont-en-Véron,2719,36792,149243,186035,68.4
67156,Geudertheim,2719,3133,45172,48305,17.8
57481,Montois-la-Montagne,2717,0,681,681,0.3
83125,Seillons-Source-d'Argens,2717,0,27868,27868,10.3
38276,Nivolas-Vermelle,2716,0,33003,33003,12.2
91649,Vert-le-Petit,2716,0,3991,3991,1.5
19072,Donzenac,2714,0,43315,43315,16
38072,Chanas,2714,0,69379,69379,25.6
68352,Volgelsheim,2714,43027,47104,90131,33.2
76270,Fontaine-la-Mallet,2713,0,24471,24471,9
72300,Saint-Mars-la-Brière,2712,0,50696,50696,18.7
41211,Saint-Georges-sur-Cher,2711,18890,49816,68706,25.3
28191,Hanches,2710,27497,15725,43222,15.9
28007,Anet,2708,0,3622,3622,1.3
41032,Chailles,2708,0,103787,103787,38.3
79162,Magné,2708,76590,36497,113087,41.8
33466,Saint-Quentin-de-Baron,2704,0,52744,52744,19.5
10064,Brienne-le-Château,2703,171972,57063,229035,84.7
67283,Marmoutier,2703,27307,190651,217958,80.6
95058,Bernes-sur-Oise,2703,14500,9629,24129,8.9
30117,Fourques,2701,56417,18904,75321,27.9
41031,Cellettes,2700,24291,103480,127771,47.3
63001,Aigueperse,2700,34287,11035,45322,16.8
67397,Rhinau,2699,21973,49901,71874,26.6
2290,Essômes-sur-Marne,2698,13400,62362,75762,28.1
26004,Alixan,2698,115750,54691,170441,63.2
38205,Lans-en-Vercors,2698,98193,319396,417589,154.8
61483,Bagnoles de l'Orne Normandie,2698,103159,33482,136641,50.6
26011,Aouste-sur-Sye,2696,17945,73280,91225,33.8
1301,Polliat,2694,0,52082,52082,19.3
67216,Huttenheim,2694,1983,49809,51792,19.2
11272,Palaja,2692,0,17461,17461,6.5
34063,Caux,2692,23950,29900,53850,20
67268,Lipsheim,2692,0,1045787,1045787,388.5
38388,Saint-Georges-de-Commiers,2691,36099,103954,140053,52
95014,Andilly,2691,0,4693,4693,1.7
33109,Castres-Gironde,2689,20199,24285,44484,16.5
51660,Warmeriville,2689,29240,47789,77029,28.6
56181,Port-Louis,2689,0,60819,60819,22.6
24222,La Force,2687,23369,59819,83188,31
34320,Vailhauquès,2684,35150,50010,85160,31.7
83056,Figanières,2683,0,33421,33421,12.5
53271,Villaines-la-Juhel,2682,0,23853,23853,8.9
54533,Trieux,2682,0,11816,11816,4.4
95527,Roissy-en-France,2682,1043462,33261,1076723,401.5
7334,Les Vans,2680,55430,65582,121012,45.2
86178,Nieuil-l'Espoir,2680,12238,61232,73470,27.4
66059,Corneilla-del-Vercol,2679,0,262,262,0.1
38408,Saint-Just-Chaleyssin,2678,0,75144,75144,28.1
59611,Verlinghem,2678,0,44347,44347,16.6
29072,Guilvinec,2677,0,100476,100476,37.5
1399,Ségny,2676,0,34446,34446,12.9
31390,Montréjeau,2676,0,55429,55429,20.7
79080,Châtillon-sur-Thouet,2675,0,70133,70133,26.2
83065,Gassin,2674,166850,21427,188277,70.4
34329,Vendres,2671,0,24941,24941,9.3
7337,Vernosc-lès-Annonay,2670,15053,13756,28809,10.8
35109,Étrelles,2670,0,40114,40114,15
60134,Cauffry,2669,0,1118,1118,0.4
77219,Guérard,2669,5336,10394,15730,5.9
80010,Ailly-sur-Noye,2669,35275,16396,51671,19.4
47185,Montayral,2667,0,15364,15364,5.8
43211,Saint-Maurice-de-Lignon,2666,34589,62492,97081,36.4
11441,Vinassan,2665,0,41213,41213,15.5
57642,Scy-Chazelles,2665,0,132132,132132,49.6
62801,Souchez,2664,0,71769,71769,26.9
44125,Piriac-sur-Mer,2663,0,36881,36881,13.8
13067,Orgon,2662,0,13869,13869,5.2
95566,Saint-Martin-du-Tertre,2662,59278,15391,74669,28
1266,Montrevel-en-Bresse,2661,0,51444,51444,19.3
74191,Morzine,2661,5355083,185938,5541021,2082.3
25381,Miserey-Salines,2660,53344,46868,100212,37.7
63148,Ennezat,2658,0,20101,20101,7.6
76752,Yerville,2658,44538,5859,50397,19
41280,Villefranche-sur-Cher,2657,19530,55987,75517,28.4
57484,Morsbach,2657,0,48573,48573,18.3
69241,Taluyers,2657,34460,85265,119725,45.1
41164,Noyers-sur-Cher,2654,0,48769,48769,18.4
87156,Saint-Just-le-Martel,2654,17345,37635,54980,20.7
45093,Chevilly,2653,0,3741,3741,1.4
62706,Richebourg,2653,0,43780,43780,16.5
85204,Saint-Christophe-du-Ligneron,2653,0,17715,17715,6.7
13064,Mollégès,2651,72145,13811,85956,32.4
18148,Méreau,2649,20755,35943,56698,21.4
49241,Le Plessis-Grammoire,2649,17213,42882,60095,22.7
59385,Marpent,2649,0,94492,94492,35.7
81289,Soual,2649,0,2949,2949,1.1
35287,Saint-Lunaire,2647,0,88311,88311,33.4
62217,Cauchy-à-la-Tour,2645,0,43648,43648,16.5
44178,Saint-Mars-de-Coutais,2644,61662,34771,96433,36.5
59486,Râches,2644,0,36840,36840,13.9
63291,Puy-Guillaume,2644,0,61303,61303,23.2
22264,La Roche-Jaudy,2643,0,52505,52505,19.9
54232,Gondreville,2643,133587,5514,139101,52.6
74002,Alby-sur-Chéran,2643,0,20416,20416,7.7
59601,Trélon,2642,59323,43341,102664,38.9
54028,Auboué,2641,0,24521,24521,9.3
59615,Vieux-Berquin,2641,0,16135,16135,6.1
27355,Ivry-la-Bataille,2640,0,3531,3531,1.3
84106,Sainte-Cécile-les-Vignes,2639,122310,0,122310,46.3
24067,Le Bugue,2638,69050,36620,105670,40.1
33334,Portets,2638,28800,80890,109690,41.6
33143,Cubzac-les-Ponts,2637,0,14891,14891,5.6
66053,Collioure,2637,0,10890,10890,4.1
90022,Châtenois-les-Forges,2637,0,92000,92000,34.9
56212,Saint-Dolay,2636,0,25100,25100,9.5
57498,Neufchef,2636,0,54171,54171,20.6
57521,Œting,2636,0,48189,48189,18.3
83136,Le Thoronet,2636,0,11280,11280,4.3
11269,Ouveillan,2635,33103,40749,73852,28
91275,Gometz-le-Châtel,2635,26331,27370,53701,20.4
13024,Charleval,2634,0,74033,74033,28.1
77312,Montigny-sur-Loing,2634,0,9161,9161,3.5
26006,Allex,2633,76512,31894,108406,41.2
62201,Camiers,2633,0,28011,28011,10.6
69148,Orliénas,2633,47890,84495,132385,50.3
28089,Châteauneuf-en-Thymerais,2632,0,3520,3520,1.3
35167,Martigné-Ferchaud,2632,0,51237,51237,19.5
37211,Saint-Branchs,2632,0,41897,41897,15.9
59285,Haspres,2632,0,99018,99018,37.6
72198,La Milesse,2631,0,53825,53825,20.5
26231,Peyrins,2630,15054,53312,68366,26
69156,Pommiers,2629,0,23693,23693,9
50393,Percy-en-Normandie,2628,29658,44406,74064,28.2
14383,Louvigny,2627,0,58456,58456,22.3
67101,Dorlisheim,2626,118984,6766,125750,47.9
2059,Beautor,2625,0,47165,47165,18
31455,Rieux-Volvestre,2625,0,4514,4514,1.7
62239,Coquelles,2625,0,78897,78897,30.1
30037,Bessèges,2624,0,106502,106502,40.6
35241,La Richardais,2624,0,87543,87543,33.4
74118,Étrembières,2624,0,41933,41933,16
76238,Épouville,2624,0,23668,23668,9
43087,Dunières,2623,10175,21007,31182,11.9
50391,Grandparigny,2623,0,64537,64537,24.6
31163,Drémil-Lafage,2622,0,64103,64103,24.4
54205,Foug,2622,0,5470,5470,2.1
30042,Boisset-et-Gaujac,2621,0,81926,81926,31.3
77494,Vernou-la-Celle-sur-Seine,2621,0,9116,9116,3.5
25212,École-Valentin,2620,2458,46163,48621,18.6
28391,Toury,2620,0,13761,13761,5.3
35326,Sens-de-Bretagne,2620,0,56281,56281,21.5
87021,Bosmie-l'Aiguille,2620,10650,1219,11869,4.5
44205,Les Touches,2619,0,15593,15593,6
3264,Saint-Yorre,2618,0,71720,71720,27.4
59435,Nomain,2618,0,44681,44681,17.1
59252,Frelinghien,2617,0,43337,43337,16.6
83021,Bras,2617,22750,98049,120799,46.2
71081,Champforgeuil,2616,18687,71927,90614,34.6
36241,Villedieu-sur-Indre,2615,37725,4143,41868,16
44046,Corsept,2615,54792,72980,127772,48.9
67196,Hilsenheim,2615,0,55083,55083,21.1
35080,Cintré,2614,0,133952,133952,51.2
38292,Villages du Lac de Paladru,2614,0,44408,44408,17
5017,La Bâtie-Neuve,2611,0,23290,23290,8.9
56126,Marzan,2611,20343,24862,45205,17.3
33049,Beychac-et-Caillau,2608,0,5474,5474,2.1
62252,La Couture,2608,0,43038,43038,16.5
69076,Dommartin,2607,0,20808,20808,8
81048,Cagnac-les-Mines,2607,0,59643,59643,22.9
91136,Champlan,2606,43950,27069,71019,27.3
10420,Villenauxe-la-Grande,2604,0,16091,16091,6.2
38383,Saint-Étienne-de-Crossey,2603,0,44221,44221,17
53003,Ambrières-les-Vallées,2603,0,34320,34320,13.2
40168,Magescq,2602,0,58459,58459,22.5
35347,Val-d'Izé,2601,0,39077,39077,15
59128,Capinghem,2601,0,43072,43072,16.6
2028,Athies-sous-Laon,2600,12750,99293,112043,43.1
44027,Casson,2600,24767,15480,40247,15.5
55427,Revigny-sur-Ornain,2600,0,57707,57707,22.2
22339,Taden,2599,37517,69238,106755,41.1
49378,Vivy,2599,123188,25322,148510,57.1
56167,Plougoumelen,2599,0,24044,24044,9.3
74249,Saint-Paul-en-Chablais,2598,56257,134605,190862,73.5
59630,Wahagnies,2596,0,44306,44306,17.1
62300,Équihen-Plage,2596,0,87757,87757,33.8
30027,Bagard,2595,0,81113,81113,31.3
60368,Longueil-Annel,2595,0,13186,13186,5.1
56262,Le Bono,2594,0,23997,23997,9.3
97126,Saint-Louis,2594,0,137575,137575,53
2B342,Ventiseri,2593,24200,0,24200,9.3
57124,Cattenom,2593,0,63129,63129,24.3
77096,Chartrettes,2593,0,21589,21589,8.3
76192,Criel-sur-Mer,2592,37645,7454,45099,17.4
85214,Sainte-Foy,2592,0,151302,151302,58.4
17193,La Jarne,2591,9400,71901,81301,31.4
21021,Arc-sur-Tille,2590,0,62,62,0
39189,Damparis,2590,250,52566,52816,20.4
79014,Loretz-d'Argenton,2590,0,40298,40298,15.6
85059,La Châtaigneraie,2590,94613,56592,151205,58.4
22067,Grâces,2588,0,46342,46342,17.9
29184,Plouénan,2588,0,4917,4917,1.9
35265,Saint-Domineuc,2587,0,32385,32385,12.5
31381,Montgiscard,2586,0,42162,42162,16.3
69231,Saint-Pierre-la-Palud,2586,0,20641,20641,8
2805,Villeneuve-Saint-Germain,2585,89371,21626,110997,42.9
72223,Noyen-sur-Sarthe,2585,0,23489,23489,9.1
2163,Charly-sur-Marne,2584,0,1407,1407,0.5
42177,Pouilly-sous-Charlieu,2584,12855,67039,79894,30.9
55010,Ancerville,2583,0,50487,50487,19.5
45188,Loury,2582,30550,7956,38506,14.9
67350,Oberschaeffolsheim,2578,0,1001500,1001500,388.5
76196,Criquetot-l'Esneval,2578,0,23253,23253,9
33492,Saint-Yzan-de-Soudiac,2577,0,14423,14423,5.6
37124,Larçay,2577,0,46033,46033,17.9
67066,La Broque,2577,7691,186491,194182,75.4
68015,Baldersheim,2577,0,179519,179519,69.7
78265,Garancières,2577,0,1112,1112,0.4
30166,Meynes,2576,0,10126,10126,3.9
47065,Clairac,2576,0,26652,26652,10.3
56152,Le Palais,2576,0,31240,31240,12.1
31160,Daux,2575,0,21540,21540,8.4
59034,Avelin,2575,0,43947,43947,17.1
2789,Vervins,2574,0,45901,45901,17.8
37179,Parçay-Meslay,2574,63239,30454,93693,36.4
76705,Tourville-la-Rivière,2574,0,73523,73523,28.6
34227,Restinclières,2573,23930,204001,227931,88.6
27458,Pîtres,2572,131227,76274,207501,80.7
30061,La Calmette,2572,0,9473,9473,3.7
85119,Les Landes-Genusson,2572,0,32955,32955,12.8
88530,Xertigny,2572,0,64679,64679,25.1
2B049,Calenzana,2571,78000,0,78000,30.3
45229,Nogent-sur-Vernisson,2571,0,26362,26362,10.3
67001,Achenheim,2570,35926,998392,1034318,402.5
1350,Saint-Étienne-du-Bois,2569,0,49665,49665,19.3
56063,Gestel,2569,0,58105,58105,22.6
67089,Dettwiller,2569,10487,181199,191686,74.6
71215,Gergy,2569,25810,70634,96444,37.5
3128,Huriel,2568,0,10449,10449,4.1
69171,Sain-Bel,2568,0,20497,20497,8
59647,Watten,2567,0,49440,49440,19.3
30059,Le Cailar,2566,0,8413,8413,3.3
29068,Guiclan,2564,26446,18936,45382,17.7
6057,L'Escarène,2563,0,72273,72273,28.2
89419,Toucy,2562,50180,115684,165864,64.7
14092,Bourguébus,2561,0,56988,56988,22.3
33402,Sainte-Foy-la-Grande,2561,0,19332,19332,7.5
45244,Ouzouer-sur-Loire,2560,60900,14993,75893,29.6
88218,Granges-Aumontzey,2560,0,4308,4308,1.7
26191,Montboucher-sur-Jabron,2559,44297,24656,68953,26.9
56091,Josselin,2559,55950,38535,94485,36.9
85064,Chauché,2559,0,21402,21402,8.4
41276,Villebarou,2558,39152,98038,137190,53.6
62849,Verton,2557,0,27203,27203,10.6
86139,Lusignan,2556,0,152284,152284,59.6
24167,Eymet,2553,32600,4785,37385,14.6
11099,Conques-sur-Orbiel,2549,39735,16533,56268,22.1
62060,Auxi-le-Château,2549,60950,55066,116016,45.5
22166,Penvénan,2548,0,50618,50618,19.9
56149,Noyal-Muzillac,2548,38602,24262,62864,24.7
63026,Aydat,2548,0,45675,45675,17.9
67237,Kilstett,2548,23160,30875,54035,21.2
1166,Frans,2547,0,40339,40339,15.8
85211,Sainte-Flaive-des-Loups,2547,0,161018,161018,63.2
25512,Le Russey,2546,33713,42757,76470,30
60234,Fitz-James,2546,0,13504,13504,5.3
72253,Roëzé-sur-Sarthe,2546,0,13637,13637,5.4
85161,Nieul-le-Dolent,2546,0,160955,160955,63.2
67124,Entzheim,2545,12790,988680,1001470,393.5
1074,Chalamont,2544,0,530,530,0.2
86078,Civray,2543,0,57268,57268,22.5
3036,Bourbon-l'Archambault,2542,0,39048,39048,15.4
87106,Nexon,2542,95020,34455,129475,50.9
14543,Rots,2541,0,56543,56543,22.3
69068,Couzon-au-Mont-d'Or,2541,0,183733,183733,72.3
84027,Caderousse,2541,0,2553,2553,1
32307,Pavie,2540,0,89497,89497,35.2
38475,Satolas-et-Bonce,2540,0,30864,30864,12.2
85246,Saint-Martin-des-Noyers,2540,84884,12931,97815,38.5
59416,Morbecque,2538,0,15506,15506,6.1
60524,Rantigny,2538,0,1063,1063,0.4
88447,Saulxures-sur-Moselotte,2537,0,19816,19816,7.8
73187,La Léchère,2536,0,548622,548622,216.3
74154,Lugrin,2536,36340,131392,167732,66.1
80533,Mers-les-Bains,2536,105155,7293,112448,44.3
14536,La Rivière-Saint-Sauveur,2535,0,18941,18941,7.5
50492,Saint-Jean-d'Elle,2535,0,37493,37493,14.8
62735,Sailly-Labourse,2535,0,41833,41833,16.5
44048,Couffé,2534,115839,30959,146798,57.9
14663,Saint-Vigor-le-Grand,2533,0,97626,97626,38.5
22185,Plénée-Jugon,2533,35260,30573,65833,26
30269,Saint-Jean-du-Gard,2533,0,79175,79175,31.3
56124,Malestroit,2533,49557,30816,80373,31.7
76034,Val-de-Scie,2533,0,20440,20440,8.1
17425,Semussac,2532,12850,39876,52726,20.8
22353,Trégastel,2532,0,50300,50300,19.9
62376,Gonnehem,2532,0,41784,41784,16.5
83132,Solliès-Ville,2532,0,42116,42116,16.6
23193,Sainte-Feyre,2531,9400,41334,50734,20
49138,Les Bois d'Anjou,2531,0,8844,8844,3.5
56255,Treffléan,2531,0,23415,23415,9.3
35331,Talensac,2530,0,29067,29067,11.5
84083,Mornas,2530,25950,23275,49225,19.5
14166,Colleville-Montgomery,2529,0,56276,56276,22.3
76296,Gainneville,2529,0,22811,22811,9
4019,Barcelonnette,2528,80395,754977,835372,330.4
22084,Jugon-les-Lacs,2528,86701,30512,117213,46.4
22158,Guerlédan,2528,0,0,0,0
81018,Arthès,2528,0,24540,24540,9.7
59557,Saultain,2526,0,48661,48661,19.3
60106,Breuil-le-Sec,2526,0,13398,13398,5.3
18223,Saint-Martin-d'Auxigny,2525,16215,19135,35350,14
1157,Fareins,2524,0,39975,39975,15.8
34073,Cers,2523,41480,14616,56096,22.2
35124,Grand-Fougeray,2523,113336,36719,150055,59.5
50444,Saint-Amand-Villages,2523,0,37316,37316,14.8
25035,Les Auxons,2522,800,44437,45237,17.9
50412,Port-Bail-sur-Mer,2522,126562,79328,205890,81.6
74183,Mieussy,2521,56500,484355,540855,214.5
86213,Rouillé,2521,0,150199,150199,59.6
63417,Sayat,2519,0,19050,19050,7.6
68036,Biesheim,2519,347348,43719,391067,155.2
30083,Codognan,2518,0,0,0,0
87110,Oradour-sur-Glane,2517,23311,55047,78358,31.1
57205,Falck,2516,0,15153,15153,6
24335,Port-Sainte-Foy-et-Ponchapt,2515,0,18985,18985,7.5
3211,Prémilhat,2513,17410,59153,76563,30.5
78263,Gambais,2513,0,1085,1085,0.4
31480,Sainte-Foy-d'Aigrefeuille,2512,39290,12252,51542,20.5
58131,Guérigny,2512,0,141773,141773,56.4
14623,Saint-Martin-de-Fontenay,2511,0,0,0,0
35014,Bais,2511,0,37725,37725,15
77226,Héricy,2511,0,20906,20906,8.3
95580,Saint-Witz,2511,39150,31140,70290,28
2018,Anizy-le-Grand,2510,0,2485,2485,1
14365,Lion-sur-Mer,2510,0,55853,55853,22.3
38105,Chirens,2510,0,42641,42641,17
40075,Castets,2510,0,20427,20427,8.1
60313,Hermes,2510,0,98425,98425,39.2
31181,Le Fauga,2509,21900,3116,25016,10
38059,Brié-et-Angonnes,2509,0,96924,96924,38.6
68384,Zillisheim,2509,0,174782,174782,69.7
21485,Plombières-lès-Dijon,2508,0,72780,72780,29
35116,La Fresnais,2508,0,59463,59463,23.7
72373,Vibraye,2508,0,33906,33906,13.5
81002,Aiguefonde,2507,0,26370,26370,10.5
22032,Caulnes,2506,0,66761,66761,26.6
53188,Renazé,2506,0,16590,16590,6.6
59124,Camphin-en-Pévèle,2506,0,42770,42770,17.1
78513,La Queue-les-Yvelines,2505,0,1081,1081,0.4
43046,Chadrac,2502,131633,104106,235739,94.2
91666,Villejust,2502,42100,25989,68089,27.2
46225,Prayssac,2500,55267,90898,146165,58.5
76401,Arelaune-en-Seine,2500,0,19052,19052,7.6
7245,Saint-Jean-de-Muzols,2499,0,109958,109958,44
78299,Hardricourt,2498,0,23249,23249,9.3
38530,Vaulx-Milieu,2495,0,30318,30318,12.2
47203,Penne-d'Agenais,2495,0,14373,14373,5.8
1426,Val-Revermont,2494,0,48215,48215,19.3
14587,Saint-Germain-la-Blanche-Herbe,2493,0,55475,55475,22.3
57013,Alsting,2493,0,45575,45575,18.3
60374,Maignelay-Montigny,2493,0,13813,13813,5.5
31484,Saint-Geniès-Bellevue,2492,0,17868,17868,7.2
61117,Condé-sur-Sarthe,2492,17881,73647,91528,36.7
27191,Clef Vallée d'Eure,2490,71807,73842,145649,58.5
86128,Lencloître,2490,0,56671,56671,22.8
59409,Monchecourt,2488,0,29917,29917,12
77344,Oissery,2488,7600,1891,9491,3.8
19028,Bort-les-Orgues,2487,0,34094,34094,13.7
31106,Caraman,2487,0,12130,12130,4.9
40331,Villeneuve-de-Marsan,2487,0,23758,23758,9.6
56096,Landaul,2487,0,96232,96232,38.7
68289,Ruelisheim,2486,0,173180,173180,69.7
37091,La Croix-en-Touraine,2484,16700,55894,72594,29.2
78465,Orgerus,2484,23200,24906,48106,19.4
59344,Leval,2483,0,88570,88570,35.7
28199,Janville-en-Beauce,2482,0,13036,13036,5.3
59330,Landas,2482,0,42360,42360,17.1
67356,Offendorf,2481,5210,30063,35273,14.2
84067,Loriol-du-Comtat,2481,40676,81012,121688,49
13094,Saint-Étienne-du-Grès,2480,0,4565,4565,1.8
1275,Neyron,2479,0,79921,79921,32.2
2558,Le Nouvion-en-Thiérache,2479,0,44206,44206,17.8
32410,Samatan,2478,98615,15461,114076,46
49247,La Possonnière,2478,308341,49194,357535,144.3
54029,Audun-le-Roman,2477,0,10913,10913,4.4
38095,Chatte,2476,0,40014,40014,16.2
53107,Gorron,2475,0,32632,32632,13.2
67034,Berstett,2474,11795,47070,58865,23.8
71154,Crissey,2473,6865,67995,74860,30.3
72299,Saint-Mars-d'Outillé,2471,0,157483,157483,63.7
7330,Vallon-Pont-d'Arc,2469,35730,150766,186496,75.5
81124,Lacaune,2469,86528,43679,130207,52.7
44083,La Limouzinière,2468,0,11698,11698,4.7
33037,Beautiran,2466,21700,22271,43971,17.8
68318,Soultzmatt,2466,92001,60854,152855,62
14570,Valorbiquet,2465,0,27439,27439,11.1
31409,Péchabou,2465,13588,40190,53778,21.8
34155,Maureilhan,2465,0,23017,23017,9.3
45254,Poilly-lez-Gien,2464,0,31889,31889,12.9
57678,Tressange,2464,0,25897,25897,10.5
38503,La Terrasse,2463,26589,45765,72354,29.4
45324,Tigy,2463,0,4789,4789,1.9
72217,Neuville-sur-Sarthe,2463,15065,138396,153461,62.3
22226,Ploumilliau,2460,0,48870,48870,19.9
73285,Séez,2460,15138,52265,67403,27.4
8053,Bazeilles,2459,0,56486,56486,23
14566,Saint-Contest,2459,0,54718,54718,22.3
59221,Famars,2459,0,47371,47371,19.3
17397,Saint-Savinien,2458,0,68466,68466,27.9
74016,Archamps,2458,611293,9632,620925,252.6
43184,Saint-Ferréol-d'Auroure,2457,0,38241,38241,15.6
62235,Condette,2456,22300,83024,105324,42.9
14475,Val d'Arry,2455,0,91036,91036,37.1
88165,Étival-Clairefontaine,2454,0,23859,23859,9.7
38181,Goncelin,2452,33532,45561,79093,32.3
43051,Le Chambon-sur-Lignon,2451,63576,56145,119721,48.8
44007,Avessac,2451,0,34966,34966,14.3
62454,Hinges,2450,0,40431,40431,16.5
29022,Camaret-sur-Mer,2448,31383,31641,63024,25.7
44189,Sainte-Reine-de-Bretagne,2447,9194,25405,34599,14.1
14066,Bernières-sur-Mer,2446,0,16466,16466,6.7
28001,Abondant,2446,0,3272,3272,1.3
54425,Piennes,2443,0,10763,10763,4.4
67230,Kaltenhouse,2443,3819,29705,33524,13.7
73059,Brison-Saint-Innocent,2443,0,13516,13516,5.5
85250,Saint-Mathurin,2443,0,142605,142605,58.4
31100,Calmont,2442,0,11911,11911,4.9
57638,Schœneck,2442,0,44643,44643,18.3
85127,Longeville-sur-Mer,2442,20978,49028,70006,28.7
3195,Néris-les-Bains,2441,10800,87205,98005,40.1
51043,Bazancourt,2441,131649,43381,175030,71.7
68343,Ungersheim,2440,0,169976,169976,69.7
76219,Doudeville,2440,125289,5379,130668,53.6
80632,Pont-de-Metz,2440,0,156432,156432,64.1
14143,Caumont-sur-Aure,2439,0,90442,90442,37.1
35096,Domagné,2439,0,36643,36643,15
41158,Naveil,2439,0,30167,30167,12.4
29284,Treffiagat,2438,29010,91505,120515,49.4
34281,Saint-Pargoire,2438,0,13169,13169,5.4
38215,Luzinay,2438,0,18757,18757,7.7
74233,Saint-Félix,2438,0,18832,18832,7.7
14754,Villers-sur-Mer,2437,0,192894,192894,79.2
59118,Busigny,2437,0,16745,16745,6.9
19278,Varetz,2436,11822,38878,50700,20.8
70513,Vaivre-et-Montoille,2436,0,126013,126013,51.7
78238,Flins-sur-Seine,2436,50213,22671,72884,29.9
29273,Santec,2435,34298,4627,38925,16
57550,Porcelette,2435,0,41577,41577,17.1
67052,Bœrsch,2435,44116,88446,132562,54.4
35243,Romagné,2434,0,29803,29803,12.2
54536,Tucquegnieux,2434,0,10724,10724,4.4
41055,Valloire-sur-Cisse,2433,34637,93247,127884,52.6
76026,Arques-la-Bataille,2433,0,29568,29568,12.2
38395,Plateau-des-Petites-Roches,2432,26872,45189,72061,29.6
70447,Rioz,2432,0,20370,20370,8.4
73261,Saint-Michel-de-Maurienne,2432,83350,67279,150629,61.9
80308,Feuquières-en-Vimeu,2432,0,16169,16169,6.6
57096,Boulange,2431,0,20960,20960,8.6
35062,La Chapelle-Fleurigné,2430,0,29754,29754,12.2
37263,Truyes,2430,16303,38682,54985,22.6
39500,Salins-les-Bains,2430,193169,53747,246916,101.6
62557,Marœuil,2430,0,68347,68347,28.1
83093,Plan-d'Aups-Sainte-Baume,2430,8302,91043,99345,40.9
17297,Rivedoux-Plage,2428,0,149921,149921,61.7
31228,Gragnague,2428,0,27233,27233,11.2
42211,Saint-Cyprien,2428,0,21754,21754,9
55063,Bouligny,2428,0,10697,10697,4.4
55502,Stenay,2428,0,87796,87796,36.2
68152,Illfurth,2428,0,65132,65132,26.8
84012,Beaumes-de-Venise,2428,0,79281,79281,32.7
17420,Salles-sur-Mer,2427,5445,67350,72795,30
27580,Saint-Ouen-de-Thouberville,2426,0,9939,9939,4.1
21103,Brazey-en-Plaine,2425,0,18183,18183,7.5
61143,Damigny,2425,39541,71667,111208,45.9
85208,Saint-Denis-la-Chevasse,2425,0,20707,20707,8.5
57669,Théding,2424,0,44314,44314,18.3
26139,Génissieux,2422,44636,49096,93732,38.7
34126,Lamalou-les-Bains,2421,0,22541,22541,9.3
80373,Gamaches,2421,0,6962,6962,2.9
64399,Montardon,2420,0,37891,37891,15.7
16230,Montmoreau,2419,48330,113748,162078,67
35195,Montreuil-sur-Ille,2419,0,51963,51963,21.5
43216,Saint-Paulien,2419,3418,100653,104071,43
69293,Sathonay-Village,2418,61271,174839,236110,97.6
81038,Brens,2418,0,132852,132852,54.9
33341,Pugnac,2417,0,13649,13649,5.6
59197,Ennevelin,2417,0,41251,41251,17.1
7240,Saint-Georges-les-Bains,2415,0,47182,47182,19.5
33097,Carcans,2415,0,2333,2333,1
9157,Laroque-d'Olmes,2414,0,21437,21437,8.9
40117,Grenade-sur-l'Adour,2414,0,11279,11279,4.7
70026,Arc-lès-Gray,2410,0,12162,12162,5
77442,Samoreau,2409,0,20057,20057,8.3
1089,Château-Gaillard,2408,0,41095,41095,17.1
6089,Opio,2408,0,29180,29180,12.1
23030,Bourganeuf,2408,141800,75503,217303,90.2
33447,Saint-Médard-de-Guizières,2408,0,46971,46971,19.5
83053,Évenos,2406,62720,1495,64215,26.7
85017,Beaurepaire,2406,0,10292,10292,4.3
29173,Plonéis,2405,13478,77203,90681,37.7
44165,Saint-Hilaire-de-Clisson,2405,38552,44404,82956,34.5
15162,Riom-ès-Montagnes,2403,119944,37059,157003,65.3
30307,Les Salles-du-Gardon,2403,0,75112,75112,31.3
57597,Rosselange,2403,0,602,602,0.3
79103,Courlay,2403,0,68357,68357,28.4
83102,Régusse,2403,0,9362,9362,3.9
10340,Saint-Germain,2402,0,34301,34301,14.3
50066,Jullouville,2401,0,58109,58109,24.2
57041,Aumetz,2401,0,20701,20701,8.6
33077,Cabanac-et-Villagrains,2400,0,21675,21675,9
56249,Taupont,2400,0,36140,36140,15.1
35306,Saint-Père-Marc-en-Poulet,2399,0,56879,56879,23.7
83113,Saint-Julien,2399,0,24606,24606,10.3
7070,Cornas,2397,0,46830,46830,19.5
49055,Cantenay-Épinard,2397,81580,38803,120383,50.2
13058,Maussane-les-Alpilles,2396,0,4410,4410,1.8
35079,Chevaigné,2396,0,122781,122781,51.2
79299,Saint-Varent,2396,60364,37280,97644,40.8
16271,Puymoyen,2394,28400,62240,90640,37.9
17391,Saint-Rogatien,2394,7200,66434,73634,30.8
21599,Selongey,2394,53410,1655,55065,23
1130,Bresse Vallons,2393,20151,46263,66414,27.8
22135,Louargat,2393,0,42850,42850,17.9
47091,Estillac,2392,0,54757,54757,22.9
60398,Le Mesnil-en-Thelle,2392,35984,9935,45919,19.2
22219,Plouguenast-Langast,2390,102892,0,102892,43.1
34074,Cessenon-sur-Orb,2390,0,13512,13512,5.7
44174,Saint-Lumine-de-Coutais,2390,0,11329,11329,4.7
31324,Martres-Tolosane,2388,0,83626,83626,35
38386,Saint-Geoire-en-Valdaine,2388,0,40568,40568,17
47280,Saint-Sylvestre-sur-Lot,2388,0,13757,13757,5.8
58214,Pougues-les-Eaux,2388,0,128441,128441,53.8
59345,Lewarde,2388,0,28715,28715,12
68286,Rosenau,2388,47490,46415,93905,39.3
59467,Pont-sur-Sambre,2387,0,85146,85146,35.7
79083,Chef-Boutonne,2387,0,68937,68937,28.9
83017,Belgentier,2387,0,39704,39704,16.6
62170,Bouvigny-Boyeffles,2385,0,64252,64252,26.9
62841,Vendin-lès-Béthune,2384,0,39341,39341,16.5
47051,Castelculier,2383,0,54551,54551,22.9
9332,Verniolle,2381,0,63997,63997,26.9
91631,Varennes-Jarcy,2381,0,16814,16814,7.1
59495,Recquignies,2379,0,84860,84860,35.7
29297,Tréméven,2378,0,81699,81699,34.4
54136,Conflans-en-Jarnisy,2378,0,22079,22079,9.3
77051,Bray-sur-Seine,2378,57850,33677,91527,38.5
12102,Flavin,2376,0,42826,42826,18
22273,Saint-Alban,2376,20667,28678,49345,20.8
33177,Gaillan-en-Médoc,2376,0,20890,20890,8.8
44164,Saint-Hilaire-de-Chaléons,2376,0,72429,72429,30.5
76464,La Neuville-Chant-d'Oisel,2376,0,67867,67867,28.6
17466,Vérines,2375,40223,65907,106130,44.7
74087,Contamine-sur-Arve,2374,21400,71887,93287,39.3
54321,Longlaville,2373,0,22158,22158,9.3
74180,Messery,2373,0,103312,103312,43.5
38100,Le Cheylas,2372,120344,44074,164418,69.3
71056,Branges,2372,0,9765,9765,4.1
85159,Nalliers,2372,0,50131,50131,21.1
39367,Morbier,2371,19920,9065,28985,12.2
13109,Le Tholonet,2370,182550,66612,249162,105.1
74013,Anthy-sur-Léman,2370,30292,103182,133474,56.3
33114,Cavignac,2368,0,13253,13253,5.6
38124,Corbelin,2368,0,12225,12225,5.2
17373,Saint-Médard-d'Aunis,2367,5000,65685,70685,29.9
24350,Razac-sur-l'Isle,2367,27530,13219,40749,17.2
29113,Lanmeur,2367,7046,141923,148969,62.9
54305,Lay-Saint-Christophe,2367,0,22793,22793,9.6
57163,Dabo,2367,0,4750,4750,2
76391,La Londe,2367,0,67610,67610,28.6
85016,Beaulieu-sous-la-Roche,2366,0,149576,149576,63.2
39475,Saint-Amour,2364,18781,36046,54827,23.2
64035,Arbonne,2364,54950,61430,116380,49.2
45119,Dadonville,2363,0,2937,2937,1.2
54459,Richardménil,2362,59553,24054,83607,35.4
16236,Mouthiers-sur-Boëme,2358,0,61304,61304,26
44144,Riaillé,2358,28784,28809,57593,24.4
47175,Monflanquin,2358,0,60210,60210,25.5
68146,Houssen,2358,178466,48460,226926,96.2
7264,Saint-Marcel-d'Ardèche,2357,0,187892,187892,79.7
85012,La Barre-de-Monts,2356,0,36337,36337,15.4
50394,Périers,2355,0,49207,49207,20.9
54542,Valleroy,2355,0,21866,21866,9.3
1135,Crozet,2354,0,30301,30301,12.9
86261,Sèvres-Anxaumont,2354,0,140249,140249,59.6
7172,Peaugres,2353,25640,12122,37762,16
34025,Bassan,2353,0,13631,13631,5.8
65344,Ossun,2352,0,22470,22470,9.6
72257,Rouillon,2352,23605,48117,71722,30.5
31533,Saubens,2351,81720,2920,84640,36
69021,Bessenay,2351,0,18765,18765,8
80721,Saint-Valery-sur-Somme,2350,0,7169,7169,3.1
22362,Tréguier,2349,0,46665,46665,19.9
57602,Rurange-lès-Thionville,2349,0,15051,15051,6.4
62364,Fruges,2349,0,139004,139004,59.2
91648,Vert-le-Grand,2348,0,3450,3450,1.5
38110,Chuzelles,2347,0,18057,18057,7.7
52093,Chalindrey,2347,0,46288,46288,19.7
85255,Saint-Michel-en-l'Herm,2347,0,49603,49603,21.1
45061,Cepoy,2346,0,31605,31605,13.5
71420,Saint-Germain-du-Plain,2346,0,13674,13674,5.8
25334,Levier,2345,0,53004,53004,22.6
51193,Courtisols,2345,0,3914,3914,1.7
35250,Saint-Armel,2344,0,120116,120116,51.2
80182,Cayeux-sur-Mer,2344,0,7151,7151,3.1
31497,Saint-Loup-Cammas,2343,0,16800,16800,7.2
39286,Lavans-lès-Saint-Claude,2342,38955,8622,47577,20.3
40332,Ychoux,2342,0,63916,63916,27.3
64546,Urt,2342,41290,60859,102149,43.6
77377,Presles-en-Brie,2342,0,11902,11902,5.1
9167,Lézat-sur-Lèze,2341,0,41636,41636,17.8
30039,Bezouce,2341,0,8622,8622,3.7
44100,Monnières,2341,21160,43222,64382,27.5
45248,Patay,2341,0,3301,3301,1.4
67172,Griesheim-près-Molsheim,2341,0,85032,85032,36.3
79101,Coulonges-sur-l'Autize,2341,8454,19295,27749,11.9
85156,Moutiers-les-Mauxfaits,2341,0,47000,47000,20.1
47049,Casseneuil,2340,0,17932,17932,7.7
67539,Wingersheim les Quatre Bans,2340,9510,78639,88149,37.7
14407,Mathieu,2339,0,52048,52048,22.3
62748,Saint-Folquin,2339,0,17752,17752,7.6
7129,Lamastre,2336,64765,66881,131646,56.4
21607,Seurre,2336,0,17515,17515,7.5
63227,Mirefleurs,2336,0,41875,41875,17.9
67261,Lauterbourg,2336,0,267874,267874,114.7
44111,Notre-Dame-des-Landes,2335,0,13902,13902,6
68091,Fessenheim,2335,7380,40526,47906,20.5
22195,Pleubian,2334,0,46367,46367,19.9
29277,Sizun,2334,58953,17238,76191,32.6
79196,Plaine-et-Vallées,2334,0,36315,36315,15.6
88451,Senones,2334,0,22692,22692,9.7
12100,Firmi,2333,0,23443,23443,10
54557,Bois-de-Haye,2333,145510,4867,150377,64.5
74185,Monnetier-Mornex,2333,0,10049,10049,4.3
49259,Rochefort-sur-Loire,2332,35680,46296,81976,35.2
62520,Locon,2332,0,38483,38483,16.5
13025,Châteauneuf-le-Rouge,2331,0,65516,65516,28.1
88225,Hadol,2331,0,58618,58618,25.1
41142,Valencisse,2329,0,89261,89261,38.3
60041,Bailleul-sur-Thérain,2328,0,91288,91288,39.2
38045,Biviers,2327,29638,43238,72876,31.3
56234,Saint-Pierre-Quiberon,2327,36605,90041,126646,54.4
74269,Seyssel,2327,27400,56206,83606,35.9
19136,Meymac,2326,0,31887,31887,13.7
24139,Coursac,2326,18280,12990,31270,13.4
33146,Cussac-Fort-Médoc,2326,0,661,661,0.3
31136,Cépet,2325,0,4671,4671,2
74024,Ayse,2325,0,70403,70403,30.3
43213,Saint-Pal-de-Mons,2324,22584,209869,232453,100
53005,Andouillé,2324,0,10562,10562,4.5
91243,Fontenay-lès-Briis,2322,0,10711,10711,4.6
6006,Aspremont,2321,0,45696,45696,19.7
21481,Perrigny-lès-Dijon,2321,0,67354,67354,29
38281,Noyarey,2321,0,89661,89661,38.6
88445,Saulcy-sur-Meurthe,2319,0,22546,22546,9.7
19146,Naves,2318,0,43985,43985,19
57287,Basse-Ham,2318,0,24362,24362,10.5
24253,Mareuil en Périgord,2316,11121,32628,43749,18.9
22079,Hénon,2315,127270,27941,155211,67
17008,Andilly,2314,0,33714,33714,14.6
2680,Saint-Gobain,2313,0,41559,41559,18
12254,Salles-la-Source,2313,0,95440,95440,41.3
17164,Fontcouverte,2313,0,73306,73306,31.7
53247,Saint-Pierre-la-Cour,2313,99280,100662,199942,86.4
57193,Ennery,2313,0,4695,4695,2
95211,Ennery,2313,0,61052,61052,26.4
33125,Cissac-Médoc,2310,0,20310,20310,8.8
60402,Le Meux,2310,32707,20805,53512,23.2
1248,Mionnay,2309,0,481,481,0.2
17369,Saint-Martin-de-Ré,2309,81980,142573,224553,97.3
67465,Sessenheim,2309,0,27979,27979,12.1
35135,Irodouër,2308,0,44816,44816,19.4
56069,Groix,2308,101452,52201,153653,66.6
56070,Guégon,2308,0,34755,34755,15.1
74299,Veyrier-du-Lac,2308,19761,17828,37589,16.3
57566,Réding,2307,0,15019,15019,6.5
59288,Haulchin,2307,0,86791,86791,37.6
76648,Saint-Saëns,2307,0,53892,53892,23.4
38349,Sablons,2306,0,58949,58949,25.6
48009,Peyre en Aubrac,2304,109476,85146,194622,84.5
73326,Vimines,2304,0,29286,29286,12.7
54367,Mexy,2303,0,21504,21504,9.3
1103,Chevry,2301,0,29619,29619,12.9
12146,Le Monastère,2301,0,35264,35264,15.3
27183,La Couture-Boussey,2301,0,27062,27062,11.8
38160,Eyzin-Pinet,2301,9870,17703,27573,12
60686,Villers-sous-Saint-Leu,2301,28950,9557,38507,16.7
76636,Saint-Pierre-de-Varengeville,2301,0,65725,65725,28.6
7204,Saint-Agrève,2300,66946,49176,116122,50.5
27438,Nonancourt,2300,0,3076,3076,1.3
53185,Pré-en-Pail-Saint-Samson,2300,0,20455,20455,8.9
69086,Fleurieux-sur-l'Arbresle,2299,0,18350,18350,8
7316,Soyons,2298,38835,44896,83731,36.4
56024,Bréhan,2298,0,16000,16000,7
87205,Le Vigen,2298,15035,32587,47622,20.7
30138,Langlade,2297,32106,8460,40566,17.7
34237,Roujan,2297,0,4493,4493,2
47143,Lavardac,2297,0,11137,11137,4.8
30020,Aubord,2296,67152,7528,74680,32.5
36045,Châtillon-sur-Indre,2296,0,57339,57339,25
80585,Nesle,2296,0,43762,43762,19.1
67115,Ebersheim,2295,0,44153,44153,19.2
73227,Courchevel,2295,2453524,13738,2467262,1075.1
85025,La Boissière-de-Montaigu,2295,0,38456,38456,16.8
57132,Château-Salins,2294,0,7591,7591,3.3
41104,Huisseau-sur-Cosson,2293,0,16065,16065,7
41161,Nouan-le-Fuzelier,2293,0,18827,18827,8.2
80630,Poix-de-Picardie,2293,34622,3166,37788,16.5
85164,Notre-Dame-de-Monts,2293,0,35365,35365,15.4
6023,Breil-sur-Roya,2292,0,12864,12864,5.6
56123,Malansac,2292,29953,16241,46194,20.2
27425,Nassandres sur Risle,2291,0,9877,9877,4.3
66217,Trouillas,2291,0,30708,30708,13.4
73182,Mouxy,2291,0,12675,12675,5.5
77385,Rebais,2291,0,37726,37726,16.5
33413,Saint-Germain-du-Puch,2290,0,44669,44669,19.5
35356,Vignoc,2290,0,49192,49192,21.5
41097,Gièvres,2290,0,48254,48254,21.1
57589,Rohrbach-lès-Bitche,2290,0,52777,52777,23
59071,Bersée,2289,0,39066,39066,17.1
31517,Saint-Sulpice-sur-Lèze,2288,0,3935,3935,1.7
44053,Drefféac,2288,23034,23754,46788,20.4
59303,Herlies,2288,0,37889,37889,16.6
67311,Muttersholtz,2288,0,44018,44018,19.2
71555,Varennes-le-Grand,2287,0,62881,62881,27.5
82169,Saint-Nicolas-de-la-Grave,2287,0,29372,29372,12.8
5065,Guillestre,2286,0,74321,74321,32.5
7201,Ruoms,2286,40290,139591,179881,78.7
39233,Foucherans,2286,7250,46396,53646,23.5
17353,Saint-Laurent-de-la-Prée,2285,20000,37629,57629,25.2
22277,Saint-Brandan,2285,95372,36241,131613,57.6
29206,Plounévez-Lochrist,2285,51231,4342,55573,24.3
85118,Landeronde,2285,0,108004,108004,47.3
57731,Volmerange-les-Mines,2284,0,55606,55606,24.3
66178,Saint-Jean-Pla-de-Corts,2283,0,94686,94686,41.5
38058,Brézins,2282,0,24897,24897,10.9
73328,Viviers-du-Lac,2282,0,12625,12625,5.5
41185,Pruniers-en-Sologne,2281,0,48065,48065,21.1
80793,Vignacourt,2280,0,3924,3924,1.7
1401,Sergy,2279,0,29336,29336,12.9
14229,Dozulé,2279,0,28951,28951,12.7
5006,L'Argentière-la-Bessée,2278,0,157131,157131,69
13096,Saintes-Maries-de-la-Mer,2278,434600,42946,477546,209.6
53094,Entrammes,2278,0,99139,99139,43.5
56132,Meucon,2278,0,21074,21074,9.3
62626,Noyelles-lès-Vermelles,2278,0,37592,37592,16.5
86298,Vouneuil-sur-Vienne,2278,0,51846,51846,22.8
8174,Floing,2277,0,52305,52305,23
57465,Metzervisse,2276,0,14583,14583,6.4
32249,Mauvezin,2275,0,8585,8585,3.8
79100,Coulon,2275,56345,30662,87007,38.2
81131,Lagrave,2275,0,124995,124995,54.9
22025,Callac,2274,0,40719,40719,17.9
14215,Cuverville,2273,0,50579,50579,22.3
35130,Hédé-Bazouges,2273,0,28454,28454,12.5
67405,Rœschwoog,2273,5050,27543,32593,14.3
84074,Mérindol,2273,45695,22155,67850,29.9
5170,Tallard,2272,0,3221,3221,1.4
14200,Creully sur Seulles,2272,0,27855,27855,12.3
56005,Arzon,2272,0,21019,21019,9.3
56168,Plouharnel,2272,29583,87913,117496,51.7
59265,Gommegnies,2272,0,6412,6412,2.8
22048,Corseul,2270,0,60474,60474,26.6
72023,Ballon-Saint Mars,2270,28755,127552,156307,68.9
3304,Vendat,2269,0,62159,62159,27.4
21584,Saulieu,2269,0,6511,6511,2.9
31271,Lanta,2269,0,11067,11067,4.9
72155,Laigné-en-Belin,2269,0,4740,4740,2.1
30212,Remoulins,2268,0,8916,8916,3.9
62240,Corbehem,2268,0,2822,2822,1.2
22233,Plourivo,2267,0,40594,40594,17.9
69140,Morancé,2267,0,20430,20430,9
74255,Sales,2267,0,30700,30700,13.5
35065,La Chapelle-Thouarault,2266,0,116119,116119,51.2
10209,Lusigny-sur-Barse,2265,0,32344,32344,14.3
33067,Bourg,2264,0,12785,12785,5.6
67449,Schirrhein,2263,0,27516,27516,12.2
1192,Izernore,2262,0,85567,85567,37.8
1232,Marboz,2262,0,43730,43730,19.3
56026,Bubry,2262,44726,51161,95887,42.4
54493,Saulnes,2261,0,21112,21112,9.3
74163,Margencel,2261,21407,98436,119843,53
78403,Mézy-sur-Seine,2261,0,21043,21043,9.3
79123,La Forêt-sur-Sèvre,2261,0,64318,64318,28.4
86140,Lussac-les-Châteaux,2261,45470,91447,136917,60.6
1109,Collonges,2260,0,29091,29091,12.9
83077,Méounes-lès-Montrieux,2260,0,84673,84673,37.5
59129,Cappelle-en-Pévèle,2259,0,38554,38554,17.1
1345,Saint-Denis-en-Bugey,2258,0,38536,38536,17.1
16244,Nersac,2258,0,58704,58704,26
56042,Colpo,2258,0,20889,20889,9.3
68068,Dannemarie,2258,0,32153,32153,14.2
44057,Fégréac,2257,0,32199,32199,14.3
76069,Belbeuf,2257,0,64468,64468,28.6
8367,Rocroi,2256,0,35122,35122,15.6
10401,Vendeuvre-sur-Barse,2256,0,13427,13427,6
7041,Boulieu-lès-Annonay,2255,23884,11618,35502,15.7
34207,Pomérols,2255,13268,25046,38314,17
50267,Lessay,2255,0,47117,47117,20.9
59222,Faumont,2255,0,31420,31420,13.9
29172,Plomodiern,2254,0,35524,35524,15.8
59035,Avesnelles,2254,20363,17855,38218,17
82179,Septfonds,2254,0,66644,66644,29.6
83007,Aups,2254,0,8781,8781,3.9
19121,Lubersac,2253,0,21667,21667,9.6
88424,Sainte-Marguerite,2253,0,21905,21905,9.7
69208,Saint-Germain-Nuelles,2252,0,17975,17975,8
72065,La Chapelle-Saint-Aubin,2252,0,46071,46071,20.5
45108,Coullons,2251,31895,29132,61027,27.1
67301,Mommenheim,2251,0,27370,27370,12.2
85210,Saint-Étienne-du-Bois,2251,0,19221,19221,8.5
7191,Rochemaure,2250,0,48173,48173,21.4
25258,Franois,2250,14310,39644,53954,24
31592,Larra,2249,0,18813,18813,8.4
35294,Sainte-Marie,2249,0,32084,32084,14.3
79216,Prahecq,2249,26808,30311,57119,25.4
88483,Uxegney,2249,0,56556,56556,25.1
7138,Lavilledieu,2248,18682,38370,57052,25.4
59041,Bachant,2246,0,80116,80116,35.7
63254,Nohanent,2246,0,85171,85171,37.9
33225,Landiras,2245,76064,68839,144903,64.5
66093,Laroque-des-Albères,2245,0,9271,9271,4.1
2110,Braine,2243,0,4424,4424,2
53127,Lassay-les-Châteaux,2243,67470,83352,150822,67.2
73191,Novalaise,2243,0,114906,114906,51.2
57370,Kœnigsmacker,2242,0,14366,14366,6.4
95120,Butry-sur-Oise,2242,0,59178,59178,26.4
17472,Villedoux,2241,21589,32651,54240,24.2
40004,Angresse,2241,0,50349,50349,22.5
59022,Attiches,2241,0,38247,38247,17.1
60325,Jaux,2240,23837,20175,44012,19.6
2B009,Aléria,2239,141710,17047,158757,70.9
34027,Beaulieu,2239,14590,177520,192110,85.8
36228,Valençay,2239,0,28109,28109,12.6
67125,Epfig,2239,0,69242,69242,30.9
95056,Belloy-en-France,2239,70166,12945,83111,37.1
22372,Trémuson,2238,20147,35495,55642,24.9
26169,Malataverne,2238,0,34601,34601,15.5
37167,Neuillé-Pont-Pierre,2238,19150,24839,43989,19.7
64062,Arudy,2238,0,28407,28407,12.7
25036,Avanne-Aveney,2237,0,39415,39415,17.6
26330,Saint-Sorlin-en-Valloire,2237,1447,36825,38272,17.1
63213,Les Martres-d'Artière,2237,0,16917,16917,7.6
8311,Mouzon,2236,0,79163,79163,35.4
29196,Plouguin,2236,13187,17510,30697,13.7
63265,Orléat,2236,0,10272,10272,4.6
69197,Saint-Étienne-des-Oullières,2236,16945,47472,64417,28.8
77088,La Chapelle-la-Reine,2236,0,18617,18617,8.3
8327,Nouvion-sur-Meuse,2235,0,51341,51341,23
31516,Saint-Sauveur,2235,0,4490,4490,2
35191,Les Portes du Coglais,2235,0,68512,68512,30.7
78591,Septeuil,2234,8245,22399,30644,13.7
7308,Sarras,2232,0,36743,36743,16.5
65304,Maubourguet,2232,0,50418,50418,22.6
89099,Cheny,2231,26350,77973,104323,46.8
22207,Plouaret,2230,0,44301,44301,19.9
59401,Méteren,2230,0,13624,13624,6.1
29156,Pencran,2229,11705,17276,28981,13
35256,Saint-Briac-sur-Mer,2228,30338,74332,104670,47
72280,Saint-Georges-du-Bois,2228,0,45580,45580,20.5
1153,Échenevex,2227,0,28667,28667,12.9
25403,Montlebon,2227,246440,26509,272949,122.6
74201,Neydens,2227,24125,8727,32852,14.8
80013,Airaines,2227,0,3075,3075,1.4
86016,Avanton,2227,11937,115730,127667,57.3
26063,Buis-les-Baronnies,2226,0,114382,114382,51.4
32296,Nogaro,2226,0,1482,1482,0.7
62447,Hesdin,2225,0,35228,35228,15.8
2468,Marle,2224,0,11204,11204,5
77255,Livry-sur-Seine,2224,0,30987,30987,13.9
17131,Cozes,2223,15170,35010,50180,22.6
1435,Versonnex,2222,0,28602,28602,12.9
14409,Merville-Franceville-Plage,2222,0,28227,28227,12.7
30302,Saint-Victor-la-Coste,2222,0,32424,32424,14.6
35328,Sixt-sur-Aff,2222,0,31699,31699,14.3
78090,Bouafle,2222,0,20680,20680,9.3
77240,Jouy-sur-Morin,2221,13000,36573,49573,22.3
29080,Hôpital-Camfrout,2220,28762,17206,45968,20.7
58238,Saint-Éloi,2220,0,119405,119405,53.8
60156,Clairoix,2220,34916,19995,54911,24.7
95241,Fontenay-en-Parisis,2220,0,27531,27531,12.4
13020,Cadolive,2219,0,62368,62368,28.1
50592,Tessy-Bocage,2219,0,32820,32820,14.8
38543,Vézeronce-Curtin,2217,0,11445,11445,5.2
79249,Saint-Gelais,2217,13109,29880,42989,19.4
33349,Quinsac,2216,0,16313,16313,7.4
49135,Feneu,2216,17867,35873,53740,24.3
85100,Givrand,2216,0,4821,4821,2.2
85103,Grosbreuil,2216,0,44490,44490,20.1
85024,Bois-de-Céné,2215,0,14790,14790,6.7
7117,Lablachère,2214,19395,154374,173769,78.5
71132,Ciry-le-Noble,2213,0,35559,35559,16.1
29204,Plounéventer,2212,198475,16336,214811,97.1
38436,Saint-Paul-de-Varces,2212,0,85450,85450,38.6
45346,Vitry-aux-Loges,2212,0,4301,4301,1.9
59086,Boeschepe,2212,0,13514,13514,6.1
59135,Cassel,2212,0,13514,13514,6.1
91156,Cheptainville,2212,0,22221,22221,10
78087,Bonnelles,2211,0,4308,4308,1.9
33226,Langoiran,2210,0,16269,16269,7.4
63322,Saint-Beauzire,2210,0,16713,16713,7.6
85172,Le Perrier,2210,0,34085,34085,15.4
1199,Jujurieux,2209,0,31653,31653,14.3
28236,Arcisses,2209,0,860,860,0.4
49308,Saint-Melaine-sur-Aubance,2209,29105,43854,72959,33
12043,Calmont,2208,0,67579,67579,30.6
12063,La Cavalerie,2208,0,94546,94546,42.8
28393,Tremblay-les-Villages,2208,0,2953,2953,1.3
35016,Baulon,2208,115270,19926,135196,61.2
87143,Saint-Gence,2208,10496,31311,41807,18.9
85002,L'Aiguillon-sur-Vie,2207,0,4801,4801,2.2
31297,Lévignac,2206,0,674,674,0.3
6091,Peille,2205,0,62178,62178,28.2
22237,Pluduno,2205,0,58742,58742,26.6
66230,Vinça,2205,0,66040,66040,30
64279,Itxassou,2204,35498,57273,92771,42.1
31429,Pompertuzat,2203,0,35918,35918,16.3
74103,Domancy,2203,0,23070,23070,10.5
17224,Matha,2202,0,61335,61335,27.9
22272,Saint-Agathon,2202,0,39430,39430,17.9
51562,Taissy,2202,50736,39134,89870,40.8
59475,Prouvy,2202,0,42420,42420,19.3
89348,Saint-Julien-du-Sault,2202,46995,17260,64255,29.2
27502,Rugles,2199,0,61844,61844,28.1
29048,Edern,2199,0,70590,70590,32.1
83108,La Roquebrussanne,2199,44600,82388,126988,57.7
62684,Racquinghem,2197,0,195533,195533,89
56089,Inguiniel,2196,0,49668,49668,22.6
68007,Andolsheim,2196,67798,45131,112929,51.4
29045,Dirinon,2195,36490,17012,53502,24.4
61153,Écouché-les-Vallées,2193,0,4632,4632,2.1
74258,Samoëns,2193,0,421337,421337,192.1
81204,Payrin-Augmontel,2193,0,23067,23067,10.5
72334,Sillé-le-Guillaume,2192,0,42763,42763,19.5
84108,Saint-Didier,2192,47000,71575,118575,54.1
25397,Montferrand-le-Château,2191,36205,38604,74809,34.1
33321,Peujard,2191,0,12373,12373,5.6
14675,Soliers,2190,0,48732,48732,22.3
56102,Forges de Lanouée,2190,0,32978,32978,15.1
38339,Roche,2189,0,61423,61423,28.1
72137,Villeneuve-en-Perseigne,2189,13161,64692,77853,35.6
32213,Lombez,2188,85780,13652,99432,45.4
54197,Fléville-devant-Nancy,2187,0,73034,73034,33.4
31462,Rouffiac-Tolosan,2186,0,15674,15674,7.2
34246,Entre-Vignes,2186,20510,23899,44409,20.3
67084,Dambach-la-Ville,2186,0,67603,67603,30.9
25495,Roche-lez-Beaupré,2185,27436,38499,65935,30.2
35039,Brécé,2185,0,111969,111969,51.2
35137,Javené,2185,0,26754,26754,12.2
45193,Marcilly-en-Villette,2185,0,18850,18850,8.6
1305,Pont-de-Vaux,2184,0,29994,29994,13.7
17225,Les Mathes,2184,61720,34395,96115,44
68292,Saint-Amarin,2184,0,22693,22693,10.4
69050,Châtillon,2184,24200,19682,43882,20.1
40150,Léon,2182,0,17757,17757,8.1
91511,Pussay,2182,0,5495,5495,2.5
13068,Paradou,2181,0,4015,4015,1.8
35015,Balazé,2181,0,32767,32767,15
50031,Barneville-Carteret,2181,154573,68602,223175,102.3
51248,Fère-Champenoise,2181,0,4109,4109,1.9
66208,Théza,2181,0,213,213,0.1
81227,Roquecourbe,2181,0,20377,20377,9.3
25432,Orchamps-Vennes,2180,18618,25752,44370,20.4
1246,Mézériat,2179,0,8825,8825,4.1
1384,Saint-Rambert-en-Bugey,2179,0,37187,37187,17.1
25454,Pirey,2179,12383,38393,50776,23.3
34143,Loupian,2179,21650,85593,107243,49.2
85189,Notre-Dame-de-Riez,2179,0,4740,4740,2.2
34033,Boisseron,2178,11050,23812,34862,16
78239,Follainville-Dennemont,2178,42078,20270,62348,28.6
17051,Le Bois-Plage-en-Ré,2177,90000,134423,224423,103.1
86258,Scorbé-Clairvaux,2177,0,49547,49547,22.8
1347,Saint-Didier-de-Formans,2176,0,34463,34463,15.8
29098,Lampaul-Plouarzel,2176,0,3919,3919,1.8
62288,Ecques,2176,0,193664,193664,89
68141,Hochstatt,2175,0,58345,58345,26.8
29175,Plonévez-du-Faou,2174,0,17820,17820,8.2
68173,Labaroche,2174,0,111015,111015,51.1
86209,Roches-Prémarie-Andillé,2174,51632,49671,101303,46.6
34321,Valergues,2173,0,16193,16193,7.5
85289,Terval,2173,130800,47480,178280,82
33154,Les Églisottes-et-Chalaures,2172,0,42367,42367,19.5
37010,Auzouer-en-Touraine,2172,12685,9531,22216,10.2
77069,Chailly-en-Bière,2172,0,18084,18084,8.3
6060,Falicon,2170,0,42723,42723,19.7
37245,Semblançay,2170,16138,24084,40222,18.5
38464,Saint-Victor-de-Cessieu,2170,0,19029,19029,8.8
59356,Lompret,2170,0,35935,35935,16.6
64191,Coarraze,2170,0,23206,23206,10.7
74006,Allonzier-la-Caille,2170,14587,39012,53599,24.7
66101,Llupia,2169,0,18066,18066,8.3
85029,Bouin,2169,0,14483,14483,6.7
38487,Seyssuel,2168,0,16680,16680,7.7
73032,La Bâthie,2168,0,51141,51141,23.6
97356,Camopi,2168,0,0,0,0
12224,Saint Geniez d'Olt et d'Aubrac,2167,0,205235,205235,94.7
59250,Fournes-en-Weppes,2167,0,35885,35885,16.6
50074,Brécey,2166,0,53293,53293,24.6
76400,Luneray,2166,0,17479,17479,8.1
77483,Varreddes,2166,0,29539,29539,13.6
83046,Cotignac,2166,0,81152,81152,37.5
35319,Saint-Thurial,2165,0,38100,38100,17.6
42176,Pouilly-les-Nonains,2165,6465,63888,70353,32.5
1254,Montagnat,2164,0,41835,41835,19.3
15140,Naucelles,2164,15100,73320,88420,40.9
27517,Saint-Aubin-sur-Gaillon,2164,0,64175,64175,29.7
77168,Égreville,2164,0,2280,2280,1.1
16393,Vars,2163,20079,27192,47271,21.9
24115,Château-l'Évêque,2162,18750,12075,30825,14.3
25467,Pouilley-les-Vignes,2162,12800,38094,50894,23.5
87202,Veyrac,2162,16781,30658,47439,21.9
2B087,Cervione,2161,0,15508,15508,7.2
60409,Monchy-Saint-Éloi,2161,0,905,905,0.4
30186,Nages-et-Solorgues,2160,0,0,0,0
59157,Cousolre,2160,0,77049,77049,35.7
22155,La Motte,2159,0,0,0,0
13115,Vernègues,2158,0,60654,60654,28.1
71497,Sancé,2158,19417,55122,74539,34.5
27180,Courcelles-sur-Seine,2157,0,63967,63967,29.7
38214,Lumbin,2157,45541,40079,85620,39.7
38199,Jardin,2156,0,16588,16588,7.7
44097,Mesquer,2156,44656,29859,74515,34.6
59464,Poix-du-Nord,2156,0,6085,6085,2.8
6059,Èze,2155,0,42427,42427,19.7
8302,Monthermé,2155,0,33549,33549,15.6
57153,Corny-sur-Moselle,2155,0,12865,12865,6
64493,Saint-Palais,2155,0,55999,55999,26
71070,Buxy,2155,0,33053,33053,15.3
57017,Amanvillers,2154,0,106797,106797,49.6
38480,Septème,2153,0,16565,16565,7.7
29032,Clohars-Fouesnant,2152,0,23474,23474,10.9
38065,Châbons,2152,0,11518,11518,5.4
44146,Rougé,2152,0,36093,36093,16.8
33118,Cénac,2151,0,15835,15835,7.4
89068,Chablis,2151,42652,294,42946,20
14349,Laize-Clinchamps,2150,0,3802,3802,1.8
37074,Chouzé-sur-Loire,2150,10172,118011,128183,59.6
71190,Épinac,2150,0,48104,48104,22.4
8145,Douzy,2149,0,76083,76083,35.4
33437,Saint-Magne-de-Castillon,2149,0,14995,14995,7
77374,Pontcarré,2149,18350,5313,23663,11
12120,Laissac-Sévérac l'Église,2148,0,203435,203435,94.7
38352,Saint-Alban-de-Roche,2148,0,26101,26101,12.2
25237,Fesches-le-Châtel,2147,0,135913,135913,63.3
62034,Annequin,2147,0,35430,35430,16.5
39491,Coteaux du Lizon,2146,69137,7900,77037,35.9
50087,Brix,2146,0,67501,67501,31.5
29280,Telgruc-sur-Mer,2145,22538,27725,50263,23.4
57582,Richemont,2145,50054,4354,54408,25.4
89102,Chevannes,2145,55800,41963,97763,45.6
69032,Bully,2144,0,17113,17113,8
86160,Mirebeau,2144,27699,111417,139116,64.9
59210,Esquelbecq,2143,0,41274,41274,19.3
73155,Méry,2143,0,11856,11856,5.5
63116,Combronde,2142,20950,14131,35081,16.4
14610,Saint-Manvieu-Norrey,2141,0,47642,47642,22.3
53186,Quelaines-Saint-Gault,2141,0,14173,14173,6.6
33337,Preignac,2140,3774,65619,69393,32.4
88409,Saint-Amé,2140,0,5462,5462,2.6
49271,Saint-Clément-de-la-Place,2139,0,34626,34626,16.2
38194,Izeaux,2138,0,11443,11443,5.4
59074,Bertry,2138,0,14691,14691,6.9
83111,Sainte-Anastasie-sur-Issole,2138,0,80103,80103,37.5
22232,Plourhan,2137,52077,33893,85970,40.2
59624,Villers-Outréaux,2137,0,14684,14684,6.9
26144,Grane,2136,56845,25874,82719,38.7
74131,Frangy,2136,0,51593,51593,24.2
60086,Boran-sur-Oise,2135,30280,8868,39148,18.3
17376,Saint-Ouen-d'Aunis,2133,0,31077,31077,14.6
17153,Esnandes,2132,48712,59163,107875,50.6
38501,Tencin,2132,9556,39615,49171,23.1
69267,Villié-Morgon,2132,0,0,0,0
15122,Maurs,2131,37485,18685,56170,26.4
25370,Mathay,2131,152350,134900,287250,134.8
33120,Cérons,2131,16710,65343,82053,38.5
68138,Hirsingue,2131,25630,57165,82795,38.9
72013,Aubigné-Racan,2131,0,10685,10685,5
77128,Couilly-Pont-aux-Dames,2131,28231,8299,36530,17.1
59497,Renescure,2130,0,13013,13013,6.1
26332,Saint-Uze,2129,10875,35047,45922,21.6
11012,Argeliers,2128,34750,32908,67658,31.8
25060,Val-d'Usiers,2128,0,48099,48099,22.6
29225,Pouldreuzic,2128,30606,68162,98768,46.4
56246,Le Sourn,2128,0,14816,14816,7
81052,Cambon,2128,125680,20657,146337,68.8
85095,Froidfond,2128,0,14209,14209,6.7
29137,Logonna-Daoulas,2127,46041,16485,62526,29.4
53103,Le Genest-Saint-Isle,2127,0,92568,92568,43.5
57039,Augny,2127,258790,105458,364248,171.2
72047,Brette-les-Pins,2127,0,135559,135559,63.7
89074,Champigny,2127,9650,392,10042,4.7
22013,Bourbriac,2126,0,38069,38069,17.9
14562,Saint-Aubin-sur-Mer,2125,0,14305,14305,6.7
21605,Sennecey-lès-Dijon,2125,0,61666,61666,29
38381,Saint-Didier-de-la-Tour,2125,0,18634,18634,8.8
54116,Chanteheux,2124,0,9384,9384,4.4
66071,Estagel,2124,0,17691,17691,8.3
64317,Larressore,2123,29880,55168,85048,40.1
39333,Moirans-en-Montagne,2121,117084,61727,178811,84.3
72042,Bouloire,2121,0,39648,39648,18.7
38309,Poisat,2120,100217,81896,182113,85.9
60102,Brenouille,2120,0,3098,3098,1.5
69219,Saint-Laurent-d'Agny,2120,500,68032,68532,32.3
22246,Pommeret,2119,13527,25576,39103,18.5
28358,Saint-Prest,2119,0,61745,61745,29.1
56015,Berric,2119,0,15015,15015,7.1
44173,Saint-Lumine-de-Clisson,2118,8145,39105,47250,22.3
64238,Ger,2118,11400,22109,33509,15.8
11254,Montréal,2116,0,6264,6264,3
38176,Frontonas,2116,0,10924,10924,5.2
16232,Mornac,2115,0,54986,54986,26
17185,Le Gua,2115,0,48599,48599,23
49027,Bégrolles-en-Mauges,2115,16797,87885,104682,49.5
61339,Putanges-le-Lac,2115,9578,12070,21648,10.2
25147,Chemaudin et Vaux,2114,2605,37248,39853,18.9
44171,Saint-Léger-les-Vignes,2114,11965,92000,103965,49.2
77517,Villevaudé,2114,47283,1606,48889,23.1
95078,Boissy-l'Aillerie,2114,0,97130,97130,45.9
37130,Ligueil,2113,11260,36678,47938,22.7
86204,Quinçay,2113,14547,109806,124353,58.9
34256,Saint-Geniès-des-Mourgues,2112,41540,167451,208991,99
52331,La Porte du Der,2112,0,19128,19128,9.1
16146,Garat,2111,0,54882,54882,26
48061,Florac Trois Rivières,2111,90155,51776,141931,67.2
69190,Sainte-Consorce,2109,0,20327,20327,9.6
74116,Etaux,2109,37530,15372,52902,25.1
38454,Saint-Sauveur,2108,0,34067,34067,16.2
45083,Château-Renard,2108,0,6391,6391,3
88270,Liffol-le-Grand,2108,0,23549,23549,11.2
30152,Les Mages,2107,0,65859,65859,31.3
45034,Boigny-sur-Bionne,2106,0,30804,30804,14.6
73204,Le Pont-de-Beauvoisin,2106,0,3118,3118,1.5
73288,Sonnaz,2106,0,26769,26769,12.7
16187,Linars,2105,0,54726,54726,26
42170,Perreux,2105,152650,62118,214768,102
11360,Saint-Nazaire-d'Aude,2104,27680,32537,60217,28.6
18180,Plaimpied-Givaudins,2104,20505,40300,60805,28.9
47179,Monsempron-Libos,2104,0,12121,12121,5.8
59488,Raillencourt-Sainte-Olle,2104,0,27348,27348,13
61211,Juvigny Val d'Andaine,2104,15679,26110,41789,19.9
73130,Grignon,2104,0,49631,49631,23.6
45095,Chilleurs-aux-Bois,2103,0,2614,2614,1.2
47040,Brax,2103,0,48142,48142,22.9
63276,Peschadoires,2103,0,9661,9661,4.6
69018,Beaujeu,2103,65829,0,65829,31.3
34050,Candillargues,2102,25088,15663,40751,19.4
34210,Le Pouget,2101,0,11348,11348,5.4
60188,Cuise-la-Motte,2101,8750,14231,22981,10.9
60245,Formerie,2101,0,10308,10308,4.9
17351,Saint-Just-Luzac,2100,0,48254,48254,23
38484,Serpaize,2100,0,16157,16157,7.7
72168,Loué,2100,0,19082,19082,9.1
35121,Gosné,2098,0,8172,8172,3.9
69177,Sourcieux-les-Mines,2098,0,16745,16745,8
29201,Ploumoguer,2097,79623,3777,83400,39.8
30315,Saze,2097,0,39355,39355,18.8
33434,Saint-Louis-de-Montferrand,2097,0,53611,53611,25.6
38515,Trept,2097,0,10826,10826,5.2
59016,Armbouts-Cappel,2097,0,256055,256055,122.1
86032,Bonneuil-Matours,2096,89857,47704,137561,65.6
87038,Chaptelat,2096,20285,29722,50007,23.9
28334,Saint-Denis-Lanneray,2095,0,114478,114478,54.6
48034,La Canourgue,2095,244654,74392,319046,152.3
64213,Espelette,2094,130819,54414,185233,88.5
74083,Combloux,2094,1044193,21929,1066122,509.1
16366,Segonzac,2093,27827,78311,106138,50.7
28064,Bû,2093,0,2799,2799,1.3
31481,Sainte-Foy-de-Peyrolières,2093,0,73296,73296,35
16206,Mansle-les-Fontaines,2092,54089,26299,80388,38.4
73290,Val-Cenis,2092,306598,36963,343561,164.2
35273,Saint-Germain-en-Coglès,2091,0,64098,64098,30.7
47225,Roquefort,2091,0,47867,47867,22.9
56002,Ambon,2091,14485,19910,34395,16.4
59631,Walincourt-Selvigny,2091,70916,14368,85284,40.8
72308,Saint-Paterne - Le Chevain,2090,5250,61766,67016,32.1
2555,Nogent-l'Artaud,2089,0,1137,1137,0.5
95450,Neuville-sur-Oise,2089,0,62284,62284,29.8
50551,Saint-Sauveur-le-Vicomte,2088,33686,65677,99363,47.6
55186,Fains-Véel,2088,0,25174,25174,12.1
78291,Guerville,2088,39850,19433,59283,28.4
67547,Wittisheim,2086,7275,43940,51215,24.6
80360,Fressenneville,2086,0,13869,13869,6.6
17447,Le Thou,2085,12148,86271,98419,47.2
38479,Porte-des-Bonnevaux,2085,0,22747,22747,10.9
68062,Carspach,2085,0,55931,55931,26.8
44214,Vay,2084,0,33169,33169,15.9
59471,Préseau,2083,0,40127,40127,19.3
5132,Saint-Bonnet-en-Champsaur,2081,0,138455,138455,66.5
17127,Courçon,2081,0,30319,30319,14.6
31042,Bagnères-de-Luchon,2081,0,19920,19920,9.6
67226,Ittenheim,2081,16257,39593,55850,26.8
67448,Schirmeck,2081,23710,150597,174307,83.8
79076,La Chapelle-Saint-Laurent,2080,0,59169,59169,28.4
81182,Montredon-Labessonnié,2080,0,43395,43395,20.9
11258,Moussan,2079,32000,32151,64151,30.9
37152,Mettray,2079,90800,24597,115397,55.5
50151,Créances,2079,0,43440,43440,20.9
76281,La Frénaye,2079,0,15844,15844,7.6
3262,Saint-Victor,2078,10561,48913,59474,28.6
29257,Saint-Pabu,2078,29867,16272,46139,22.2
49041,Brain-sur-Allonnes,2078,44665,20246,64911,31.2
63327,Saint-Bonnet-près-Riom,2078,0,15715,15715,7.6
48099,Bourgs sur Colagne,2077,0,49518,49518,23.8
59411,Mons-en-Pévèle,2077,0,35448,35448,17.1
91095,Bouray-sur-Juine,2077,0,14065,14065,6.8
14516,Potigny,2076,0,32520,32520,15.7
14119,Cagny,2075,0,16700,16700,8
67296,Mittelhausbergen,2075,106959,806095,913054,440
57733,Volstroff,2074,0,13289,13289,6.4
77359,Perthes,2074,0,17268,17268,8.3
85216,Sainte-Gemme-la-Plaine,2074,0,43833,43833,21.1
31184,Flourens,2073,0,50681,50681,24.4
88513,Vincey,2073,0,52130,52130,25.1
22307,Saint-Julien,2072,19692,32862,52554,25.4
24442,Saint-Léon-sur-l'Isle,2072,0,11294,11294,5.5
51391,Muizon,2072,0,36823,36823,17.8
64009,Ahetze,2070,23480,53791,77271,37.3
13049,Lamanon,2069,67900,58152,126052,60.9
54265,Houdemont,2069,0,69094,69094,33.4
83028,Callas,2069,0,25773,25773,12.5
21657,Varois-et-Chaignot,2068,0,50,50,0
34153,Les Matelles,2068,0,38532,38532,18.6
69122,Lucenay,2068,0,18637,18637,9
26345,Suze-la-Rousse,2067,0,31958,31958,15.5
77521,Villiers-sur-Morin,2067,0,8050,8050,3.9
78337,Limetz-Villez,2067,0,10567,10567,5.1
87064,Eymoutiers,2067,0,29439,29439,14.2
77441,Samois-sur-Seine,2066,80700,17201,97901,47.4
62043,Les Attaques,2065,0,62065,62065,30.1
77433,Beautheil-Saints,2064,0,8038,8038,3.9
35226,Pleugueneuc,2063,0,25825,25825,12.5
2720,Sissonne,2061,0,5546,5546,2.7
18281,Vignoux-sur-Barangeon,2061,15850,29778,45628,22.1
33030,Barsac,2061,0,63197,63197,30.7
59357,La Longueville,2061,0,5816,5816,2.8
67543,Wisches,2061,21435,149150,170585,82.8
68028,Bergheim,2061,49230,4927,54157,26.3
19202,Sainte-Féréole,2060,18511,32877,51388,24.9
81244,Saint-Benoît-de-Carmaux,2059,0,47106,47106,22.9
33015,Arveyres,2058,0,40143,40143,19.5
56055,Étel,2058,0,79632,79632,38.7
69056,Chessy,2058,0,18547,18547,9
2B168,Monticello,2057,0,28868,28868,14
49201,La Ménitré,2057,0,7188,7188,3.5
56155,Pénestin,2057,110463,28488,138951,67.6
57708,Verny,2056,0,78735,78735,38.3
14530,Ranville,2055,0,26105,26105,12.7
30214,Ribaute-les-Tavernes,2055,0,64234,64234,31.3
64067,Assat,2055,0,21977,21977,10.7
74136,Le Grand-Bornand,2054,784711,104338,889049,432.8
85162,Rives-d'Autise,2054,19709,32190,51899,25.3
56081,Guiscriff,2053,0,65623,65623,32
14257,Évrecy,2052,0,3629,3629,1.8
18096,Foëcy,2052,8170,29647,37817,18.4
44001,Abbaretz,2052,0,32659,32659,15.9
72262,Loir en Vallée,2052,0,115715,115715,56.4
79213,Pompaire,2052,0,53799,53799,26.2
35097,Domalain,2050,0,30799,30799,15
57572,Rémilly,2050,0,78505,78505,38.3
62705,Rety,2050,0,8155,8155,4
62371,Givenchy-en-Gohelle,2049,0,55200,55200,26.9
7339,Vesseaux,2048,21044,34956,56000,27.3
2B313,San-Nicolao,2048,15100,14697,29797,14.5
35193,Montreuil-le-Gast,2048,0,43993,43993,21.5
31259,Lacroix-Falgarde,2047,20700,33375,54075,26.4
33438,Saint-Maixant,2046,0,20923,20923,10.2
59084,Blaringhem,2046,0,12500,12500,6.1
60341,Lagny-le-Sec,2046,0,8011,8011,3.9
27082,La Bonneville-sur-Iton,2045,0,18194,18194,8.9
33523,Targon,2045,0,20309,20309,9.9
45333,Vennecy,2045,0,6301,6301,3.1
77384,Réau,2045,21276,40545,61821,30.2
84037,Châteauneuf-du-Pape,2045,78050,2054,80104,39.2
87191,Séreilhac,2045,7136,952,8088,4
14123,Cairon,2044,0,45483,45483,22.3
2A103,Cuttoli-Corticchiato,2044,15600,20494,36094,17.7
1360,Saint-Jean-de-Gonville,2042,0,26285,26285,12.9
2A209,Peri,2042,0,20474,20474,10
2A228,Pietrosella,2042,0,1529,1529,0.7
38336,Reventin-Vaugris,2042,0,15711,15711,7.7
44119,Paulx,2042,0,26854,26854,13.2
85050,Le Champ-Saint-Père,2041,0,40977,40977,20.1
2307,La Ferté-Milon,2040,0,1963,1963,1
14277,Fontenay-le-Marmion,2040,0,3608,3608,1.8
15083,Jussac,2040,21400,69118,90518,44.4
18011,Argent-sur-Sauldre,2040,0,0,0,0
82115,Monclar-de-Quercy,2039,0,16551,16551,8.1
72189,Marolles-les-Braults,2038,0,37792,37792,18.5
59262,Godewaersvelde,2037,0,12445,12445,6.1
68266,Réguisheim,2036,0,16068,16068,7.9
83066,Ginasservis,2036,0,20883,20883,10.3
29078,Hanvec,2035,0,15772,15772,7.8
42046,Champdieu,2035,0,18233,18233,9
59641,Warhem,2035,0,39193,39193,19.3
49222,Mozé-sur-Louet,2033,19333,40360,59693,29.4
30326,Tavel,2032,0,29651,29651,14.6
76608,Sainte-Marguerite-sur-Duclair,2032,0,58041,58041,28.6
7325,Ucel,2031,4500,34666,39166,19.3
38340,Les Roches-de-Condrieu,2031,0,51919,51919,25.6
77241,Juilly,2031,25288,25187,50475,24.9
78107,Bréval,2031,6395,10383,16778,8.3
30241,Saint-Chaptes,2030,0,7477,7477,3.7
33001,Abzac,2030,0,39597,39597,19.5
35264,Saint-Didier,2030,0,30499,30499,15
59470,Prémesques,2029,0,33600,33600,16.6
29091,Kerlouan,2028,113668,51101,164769,81.2
50197,Gavray-sur-Sienne,2028,0,58678,58678,28.9
51525,Sarry,2028,0,103079,103079,50.8
62100,Beaurainville,2028,0,32109,32109,15.8
85006,Apremont,2028,0,17317,17317,8.5
87041,Châteauponsac,2028,20846,61552,82398,40.6
33185,Génissac,2026,0,39519,39519,19.5
25133,Châtillon-le-Duc,2025,6250,35680,41930,20.7
38029,La Bâtie-Montgascon,2025,0,17758,17758,8.8
57545,Plappeville,2025,0,100401,100401,49.6
64060,Artiguelouve,2025,10350,59789,70139,34.6
68253,Ottmarsheim,2025,69050,141066,210116,103.8
72035,Bessé-sur-Braye,2025,0,27376,27376,13.5
81284,Le Sequestre,2025,181805,19657,201462,99.5
1163,Foissiat,2024,0,39129,39129,19.3
27278,Garennes-sur-Eure,2024,0,23804,23804,11.8
60647,Trosly-Breuil,2024,0,13709,13709,6.8
73055,Bozel,2024,0,12116,12116,6
77455,Soignolles-en-Brie,2024,0,1919,1919,0.9
16280,Rivières,2023,21385,36076,57461,28.4
38131,Les Côtes-d'Arey,2023,0,15564,15564,7.7
79063,Val en Vignes,2023,0,31476,31476,15.6
14287,Frénouville,2022,0,16274,16274,8
90042,Évette-Salbert,2022,0,70543,70543,34.9
43200,Saint-Julien-Chapteuil,2021,54827,11211,66038,32.7
81281,Sémalens,2021,0,2250,2250,1.1
2A139,Lecci,2020,83119,29626,112745,55.8
63352,Saint-Germain-Lembron,2020,0,13131,13131,6.5
2758,Vailly-sur-Aisne,2019,0,3982,3982,2
4108,Malijai,2019,31300,84626,115926,57.4
11353,Saint-Marcel-sur-Aude,2019,0,31223,31223,15.5
12199,Rignac,2019,0,4343,4343,2.2
55351,Montmédy,2018,0,72144,72144,35.8
85236,Saint-Julien-des-Landes,2018,0,127576,127576,63.2
12169,Naucelle,2017,0,61733,61733,30.6
14408,May-sur-Orne,2017,0,3567,3567,1.8
60149,Chevrières,2017,0,1887,1887,0.9
68205,Meyenheim,2017,0,15918,15918,7.9
95142,Chars,2017,0,92673,92673,45.9
29167,Plogastel-Saint-Germain,2016,37725,64575,102300,50.7
25043,Bart,2015,0,127557,127557,63.3
45154,Gidy,2015,0,2841,2841,1.4
17091,Charron,2014,10474,29343,39817,19.8
38082,Charavines,2014,0,34215,34215,17
38504,Theys,2014,7901,37422,45323,22.5
1148,Dortan,2013,0,76148,76148,37.8
3084,Cosne-d'Allier,2013,0,71915,71915,35.7
22223,Plouisy,2013,0,36046,36046,17.9
30254,Saint-Geniès-de-Comolas,2013,0,29374,29374,14.6
30312,Sauveterre,2013,0,37779,37779,18.8
62847,Verquigneul,2013,0,33219,33219,16.5
66058,Corneilla-la-Rivière,2013,0,16767,16767,8.3
79148,Lezay,2013,0,58136,58136,28.9
10216,Mailly-le-Camp,2012,0,1712,1712,0.9
34203,Pinet,2012,34475,22347,56822,28.2
49260,La Romagne,2012,48732,83605,132337,65.8
52182,Éclaron-Braucourt-Sainte-Livière,2011,0,18213,18213,9.1
1250,Misérieux,2010,0,31834,31834,15.8
35107,Ercé-près-Liffré,2010,57957,7830,65787,32.7
62025,Ambleteuse,2010,0,7996,7996,4
81042,Burlats,2010,0,18779,18779,9.3
36171,Reuilly,2009,0,47434,47434,23.6
45008,Artenay,2009,0,2833,2833,1.4
73212,Val-d'Arc,2009,36850,76211,113061,56.3
49368,Vernantes,2006,0,19544,19544,9.7
54521,Thil,2006,0,17296,17296,8.6
44203,Le Temple-de-Bretagne,2005,0,44568,44568,22.2
45024,Baule,2005,64911,8262,73173,36.5
29097,Lampaul-Guimiliau,2004,30005,14800,44805,22.4
42013,Bellegarde-en-Forez,2004,0,36324,36324,18.1
43080,Craponne-sur-Arzon,2004,114190,83385,197575,98.6
44107,Mouzeil,2004,0,24484,24484,12.2
63349,Saint-Georges-de-Mons,2003,0,13214,13214,6.6
34179,Murviel-lès-Montpellier,2002,0,158729,158729,79.3
38027,Barraux,2002,24851,37199,62050,31
47015,Astaffort,2002,0,45830,45830,22.9
62311,Estevelles,2002,0,53934,53934,26.9
71372,Romanèche-Thorins,2002,0,51137,51137,25.5
72310,Saint-Pavace,2002,0,112493,112493,56.2
77352,Ozouer-le-Voulgis,2002,0,1898,1898,0.9
14060,Bénouville,2001,0,44527,44527,22.3
26357,Tulette,2001,41221,30937,72158,36.1
52194,Eurville-Bienville,2001,0,18122,18122,9.1
33435,Saint-Macaire,2000,0,20452,20452,10.2
35122,La Gouesnière,2000,0,47419,47419,23.7
67418,Rountzenheim-Auenheim,2000,94592,24235,118827,59.4
29056,La Forest-Landerneau,1999,81731,15493,97224,48.6
73100,Domessin,1999,0,2960,2960,1.5
72228,Parcé-sur-Sarthe,1998,0,46467,46467,23.3
73329,Voglans,1998,16086,11054,27140,13.6
74018,Arenthon,1998,13135,14563,27698,13.9
84131,Taillades,1998,70225,19474,89699,44.9
59511,Rosult,1997,0,75128,75128,37.6
64068,Asson,1997,0,21356,21356,10.7
91318,Janville-sur-Juine,1997,14795,13523,28318,14.2
10115,Creney-près-Troyes,1996,0,28503,28503,14.3
85273,Saint-Urbain,1996,0,13328,13328,6.7
16223,Montbron,1995,73329,35577,108906,54.6
68040,Bitschwiller-lès-Thann,1995,40070,33574,73644,36.9
37011,Avoine,1994,909137,109449,1018586,510.8
54366,Messein,1994,0,20307,20307,10.2
67302,Monswiller,1994,12507,140643,153150,76.8
69189,Sainte-Colombe,1994,0,15341,15341,7.7
73034,Beaufort,1994,0,47036,47036,23.6
38081,Charantonnay,1993,0,55923,55923,28.1
45270,Saint-Benoît-sur-Loire,1993,0,11673,11673,5.9
81325,Viviers-lès-Montagnes,1992,0,2218,2218,1.1
45030,Beaune-la-Rolande,1991,0,15090,15090,7.6
54167,Dommartin-lès-Toul,1991,19630,4153,23783,11.9
72287,Saint-Gervais-en-Belin,1991,0,0,0,0
30257,Saint-Gervasy,1990,0,7329,7329,3.7
69235,Saint-Romain-en-Gal,1990,0,15311,15311,7.7
8142,Donchery,1989,0,45690,45690,23
28201,Jouy,1989,0,57957,57957,29.1
2719,Sinceny,1988,0,35719,35719,18
17387,Saint-Porchaire,1988,13036,50639,63675,32
64152,Buros,1988,10000,20752,30752,15.5
40245,Roquefort,1987,0,22694,22694,11.4
64109,Bénéjacq,1987,0,21249,21249,10.7
1105,Civrieux,1986,0,31454,31454,15.8
79298,Saint-Symphorien,1986,0,26767,26767,13.5
1231,Manziat,1985,0,27261,27261,13.7
7338,Vernoux-en-Vivarais,1985,81162,6623,87785,44.2
62543,Mametz,1985,0,176665,176665,89
74161,Marcellaz-Albanais,1985,0,26881,26881,13.5
76035,Aumale,1985,0,37,37,0
81116,Labastide-Saint-Georges,1985,0,6483,6483,3.3
83026,Cabasse,1985,0,8495,8495,4.3
27365,Léry,1984,0,58837,58837,29.7
59499,Rexpoëde,1984,0,38211,38211,19.3
58149,Luzy,1983,0,102286,102286,51.6
61116,Sablons sur Huisne,1983,10253,23238,33491,16.9
80186,Chaulnes,1983,0,35889,35889,18.1
49110,Corzé,1982,0,15164,15164,7.7
33415,Saint-Gervais,1981,0,11187,11187,5.6
68059,Burnhaupt-le-Bas,1981,19372,41565,60937,30.8
2543,Neuilly-Saint-Front,1980,0,45766,45766,23.1
56120,Locqueltas,1980,0,18317,18317,9.3
38558,Villette-de-Vienne,1979,0,15226,15226,7.7
59120,Caëstre,1979,0,12091,12091,6.1
69281,Marennes,1979,9900,11992,21892,11.1
70388,Noidans-lès-Vesoul,1979,0,102373,102373,51.7
13013,Belcodène,1978,0,55595,55595,28.1
35222,Pleine-Fougères,1978,0,16821,16821,8.5
42242,Saint-Joseph,1978,0,46345,46345,23.4
42289,Saint-Symphorien-de-Lay,1976,20678,56018,76696,38.8
35172,Meillac,1975,0,24724,24724,12.5
29077,Guissény,1974,154221,49740,203961,103.3
61309,Perche en Nocé,1974,35533,23132,58665,29.7
70258,Froideconche,1974,0,1898,1898,1
72029,Beaumont-sur-Sarthe,1974,0,92917,92917,47.1
76235,Envermeu,1973,25609,12479,38088,19.3
59559,Sebourg,1972,0,37989,37989,19.3
76563,Saint-Aubin-Routot,1972,0,17787,17787,9
79322,Le Tallud,1972,0,51702,51702,26.2
38238,Moidieu-Détourbe,1971,0,15164,15164,7.7
59388,Marquillies,1971,0,32639,32639,16.6
68331,Sundhoffen,1971,0,40507,40507,20.6
2B309,Santa-Maria-di-Lota,1970,0,29489,29489,15
40179,Mées,1970,0,16864,16864,8.6
56157,Plaudren,1970,0,18225,18225,9.3
69175,Savigny,1970,0,15724,15724,8
17120,Corme-Royal,1969,0,62404,62404,31.7
52060,Bourbonne-les-Bains,1969,0,38833,38833,19.7
77146,Croissy-Beaubourg,1969,0,21048,21048,10.7
46029,Biars-sur-Cère,1968,39780,64207,103987,52.8
62721,Roquetoire,1967,0,175063,175063,89
78030,Auffargis,1967,0,3832,3832,1.9
11315,Rieux-Minervois,1966,0,12752,12752,6.5
62001,Ablain-Saint-Nazaire,1966,0,52964,52964,26.9
44199,Soudan,1965,0,32957,32957,16.8
45335,Vienne-en-Val,1965,0,3820,3820,1.9
57598,Rouhling,1965,0,26855,26855,13.7
73249,Saint-Jeoire-Prieuré,1965,0,24977,24977,12.7
80228,Le Crotoy,1965,0,48658,48658,24.8
28380,Sours,1964,0,57228,57228,29.1
44099,Moisdon-la-Rivière,1964,10110,32940,43050,21.9
53015,La Baconnière,1964,0,8926,8926,4.5
63141,Durtol,1964,0,74477,74477,37.9
72289,Sainte-Jamme-sur-Sarthe,1964,0,110357,110357,56.2
14478,Orbec,1963,0,21851,21851,11.1
85098,La Genétouze,1963,1130,16762,17892,9.1
34082,Combaillaux,1961,0,36539,36539,18.6
41238,Savigny-sur-Braye,1960,0,24242,24242,12.4
10067,Buchères,1959,0,27974,27974,14.3
36230,Vatan,1959,0,39791,39791,20.3
68041,Blodelsheim,1959,12750,34000,46750,23.9
25259,Frasne,1958,0,28404,28404,14.5
38094,Châtonnay,1958,0,21362,21362,10.9
71528,Sornay,1958,0,8060,8060,4.1
60531,Remy,1957,0,1831,1831,0.9
30311,Sauve,1956,0,4066,4066,2.1
80316,Flesselles,1956,0,7625,7625,3.9
7279,Saint-Montan,1955,0,155846,155846,79.7
29021,Plounéour-Brignogan-plages,1955,0,49261,49261,25.2
24068,Le Buisson-de-Cadouin,1954,28450,7100,35550,18.2
91635,Vauhallan,1954,78005,20297,98302,50.3
1374,Saint-Martin-du-Mont,1953,0,37756,37756,19.3
59387,Marquette-en-Ostrevant,1953,0,73473,73473,37.6
63022,Auzat-la-Combelle,1953,0,12695,12695,6.5
73296,Tignes,1953,565765,41493,607258,310.9
80071,Beauval,1953,0,7613,7613,3.9
12301,Villeneuve,1952,0,5693,5693,2.9
26096,Clérieux,1952,19839,39569,59408,30.4
60369,Longueil-Sainte-Marie,1952,0,1827,1827,0.9
79024,Azay-le-Brûlé,1952,0,10850,10850,5.6
84070,Malemort-du-Comtat,1952,41399,31669,73068,37.4
88358,Pouxeux,1952,0,49088,49088,25.1
29120,Lanvéoc,1951,0,25217,25217,12.9
50341,Montebourg,1951,250,61368,61618,31.6
82155,Saint-Antonin-Noble-Val,1951,0,27591,27591,14.1
85298,Vairé,1951,0,113885,113885,58.4
69220,Saint-Laurent-de-Chamousset,1950,3112,97738,100850,51.7
59063,Beauvois-en-Cambrésis,1948,0,13385,13385,6.9
81039,Briatexte,1948,24932,107029,131961,67.7
22180,Plélan-le-Petit,1947,0,51869,51869,26.6
71419,Saint-Germain-du-Bois,1947,16475,3641,20116,10.3
95042,Baillet-en-France,1947,17270,11257,28527,14.7
31252,Labastide-Saint-Sernin,1946,0,13953,13953,7.2
31356,Montaigut-sur-Save,1946,0,16279,16279,8.4
72025,Bazouges Cré sur Loir,1946,0,14107,14107,7.2
71351,Pierre-de-Bresse,1945,16595,239,16834,8.7
56190,Réguiny,1944,0,13535,13535,7
62204,Campagne-lès-Hesdin,1944,0,30779,30779,15.8
68231,Neuf-Brisach,1944,0,33740,33740,17.4
29268,Saint-Thonan,1943,47996,15059,63055,32.5
77405,Saint-Cyr-sur-Morin,1943,0,31996,31996,16.5
42199,Saint-André-d'Apchon,1942,6482,57307,63789,32.8
77127,Coubert,1942,15010,1841,16851,8.7
85196,Saint-André-Goule-d'Oie,1942,0,16241,16241,8.4
72143,Le Grand-Lucé,1941,0,109456,109456,56.4
12197,Réquista,1940,0,105863,105863,54.6
56032,Campénéac,1940,0,29214,29214,15.1
69080,Échalas,1940,0,14926,14926,7.7
56012,Beignon,1939,0,23589,23589,12.2
74037,Boëge,1938,78526,31135,109661,56.6
21416,Mirebeau-sur-Bèze,1937,0,8437,8437,4.4
72165,Lombron,1937,0,36209,36209,18.7
38076,La Chapelle-de-la-Tour,1936,0,16977,16977,8.8
44206,Touvois,1936,0,25460,25460,13.2
59522,Sailly-lez-Lannoy,1936,0,32060,32060,16.6
26002,Albon,1935,2600,31853,34453,17.8
26208,Montoison,1935,13836,23439,37275,19.3
90029,Cravanche,1935,9924,67508,77432,40
91411,Les Molières,1935,0,8926,8926,4.6
18138,Marmagne,1934,7605,37044,44649,23.1
38394,Saint-Hilaire-du-Rosier,1934,0,31255,31255,16.2
82167,Saint-Nauphary,1934,0,16840,16840,8.7
8403,Sault-lès-Rethel,1932,0,36948,36948,19.1
44142,Remouillé,1932,86010,35671,121681,63
56052,Damgan,1930,32300,18377,50677,26.3
43113,Lantriac,1929,18598,10701,29299,15.2
62259,Croisilles,1929,0,9591,9591,5
65340,Orleix,1929,0,18429,18429,9.6
70473,Saint-Sauveur,1929,0,1855,1855,1
67478,Steinbourg,1928,13804,135988,149792,77.7
26005,Allan,1927,38514,18567,57081,29.6
26323,Saint-Paul-lès-Romans,1927,0,39062,39062,20.3
28269,Morancez,1927,0,56150,56150,29.1
60238,Fleurines,1927,0,0,0,0
67305,Mothern,1927,5805,220974,226779,117.7
88327,Nomexy,1927,0,48459,48459,25.1
34295,Saussan,1926,65360,152704,218064,113.2
41147,Les Montils,1925,38463,73777,112240,58.3
49361,Varennes-sur-Loire,1924,0,18745,18745,9.7
38490,Sillans,1923,0,20980,20980,10.9
67184,Hatten,1923,0,52987,52987,27.6
68267,Reiningue,1923,48740,133960,182700,95
69135,Deux-Grosnes,1923,37472,0,37472,19.5
12198,Rieupeyroux,1922,0,44591,44591,23.2
25542,Serre-les-Sapins,1921,13756,33847,47603,24.8
67276,Lutzelhouse,1921,28385,139018,167403,87.1
74166,Marin,1921,34949,99529,134478,70
38223,Maubec,1920,0,23331,23331,12.2
38253,Les Deux Alpes,1920,419500,109207,528707,275.4
60651,Ully-Saint-Georges,1920,0,7975,7975,4.2
67128,Ernolsheim-Bruche,1920,39703,4947,44650,23.3
83030,Camps-la-Source,1920,0,71935,71935,37.5
1005,Ambérieux-en-Dombes,1917,0,30361,30361,15.8
33297,Moulis-en-Médoc,1917,0,1202,1202,0.6
66225,Villelongue-dels-Monts,1917,0,7917,7917,4.1
73121,Frontenex,1917,0,45220,45220,23.6
55533,Vaucouleurs,1916,0,7733,7733,4
2131,Bucy-le-Long,1915,0,3777,3777,2
25318,Jougne,1915,0,114049,114049,59.6
78120,Bullion,1915,0,3731,3731,1.9
84071,Maubec,1915,0,18665,18665,9.7
3306,Le Vernet,1914,0,52434,52434,27.4
18097,Fussy,1914,0,14505,14505,7.6
27616,La Saussaye,1914,35175,56761,91936,48
50616,Le Val-Saint-Père,1914,0,47093,47093,24.6
63092,Charbonnières-les-Varennes,1914,0,14475,14475,7.6
68143,Porte du Ried,1914,0,39336,39336,20.6
40037,Benquet,1913,30635,23676,54311,28.4
40248,Saint-André-de-Seignanx,1913,0,54336,54336,28.4
74275,Talloires-Montmin,1913,0,14777,14777,7.7
85021,La Bernardière,1913,0,0,0,0
14046,Bavent,1912,0,24289,24289,12.7
14100,Bretteville-sur-Laize,1911,0,57774,57774,30.2
24264,Ménesplet,1911,34714,14524,49238,25.8
29047,Le Drennec,1911,122562,14965,137527,72
38197,Janneyrias,1911,0,2135,2135,1.1
1389,Saint-Trivier-sur-Moignans,1910,0,398,398,0.2
1179,Grièges,1909,0,7731,7731,4
2648,Ribemont,1909,0,0,0,0
40126,Hinx,1909,0,29897,29897,15.7
85042,Chaillé-les-Marais,1909,0,40346,40346,21.1
14011,Aurseulles,1908,0,0,0,0
15258,Vic-sur-Cère,1908,60195,8523,68718,36
71235,Hurigny,1908,0,48736,48736,25.5
77302,Montcourt-Fromonville,1908,0,975,975,0.5
86027,Biard,1908,67773,113677,181450,95.1
22121,Lanvollon,1907,0,38621,38621,20.3
45123,Darvoy,1905,0,3704,3704,1.9
59297,Hélesmes,1905,0,71667,71667,37.6
64094,Bardos,1905,0,49503,49503,26
67025,Beinheim,1904,96257,218336,314593,165.2
85227,Saint-Hilaire-des-Loges,1904,12140,29839,41979,22
21209,Couternon,1903,0,46,46,0
68134,Herrlisheim-près-Colmar,1903,60075,39110,99185,52.1
50409,Pont-Hébert,1902,0,28131,28131,14.8
62588,Montreuil-sur-Mer,1902,0,20235,20235,10.6
71269,Lux,1902,0,52295,52295,27.5
71456,Saint-Martin-en-Bresse,1902,19256,21949,41205,21.7
23245,Saint-Sulpice-le-Guérétois,1901,9000,31045,40045,21.1
51282,Gueux,1901,0,33784,33784,17.8
1195,Jasseron,1900,0,36732,36732,19.3
88148,Dommartin-lès-Remiremont,1900,0,4850,4850,2.6
31212,Garidech,1899,0,21300,21300,11.2
83134,Taradeau,1899,0,23655,23655,12.5
6163,Tende,1898,0,10652,10652,5.6
38155,Entre-deux-Guiers,1897,0,129891,129891,68.5
72006,Arçonnay,1897,0,56062,56062,29.6
76051,Bacqueville-en-Caux,1897,0,15308,15308,8.1
26148,Hauterives,1895,0,31195,31195,16.5
56074,Guénin,1895,0,4450,4450,2.3
30290,Saint-Paulet-de-Caisson,1894,0,27638,27638,14.6
14354,Langrune-sur-Mer,1893,0,12744,12744,6.7
61345,Rémalard en Perche,1892,23980,22171,46151,24.4
17065,Breuil-Magné,1891,12700,31140,43840,23.2
22164,Pédernec,1891,0,33861,33861,17.9
33485,Sainte-Terre,1890,0,73429,73429,38.9
38554,Villemoirieu,1890,0,9757,9757,5.2
59042,Bachy,1890,0,32256,32256,17.1
86053,Champigny en Rochereau,1890,0,98217,98217,52
11188,La Palme,1889,0,29212,29212,15.5
33382,Saint-Christoly-de-Blaye,1889,0,19334,19334,10.2
66129,Ortaffa,1889,0,7801,7801,4.1
74176,Menthon-Saint-Bernard,1889,0,14592,14592,7.7
77277,Marles-en-Brie,1889,0,9600,9600,5.1
83101,Ramatuelle,1889,1357851,15137,1372988,726.8
10406,Verrières,1888,0,26961,26961,14.3
14515,Port-en-Bessin-Huppain,1888,0,72767,72767,38.5
19246,Saint-Viance,1888,0,30132,30132,16
42208,Saint-Christo-en-Jarez,1888,0,44236,44236,23.4
60491,Pierrefonds,1888,0,12788,12788,6.8
69295,Simandres,1886,0,11429,11429,6.1
17396,Saint-Sauveur-d'Aunis,1885,0,27464,27464,14.6
1065,Buellas,1884,0,36422,36422,19.3
14666,Sannerville,1884,0,41923,41923,22.3
17309,Saint-Aigulin,1884,0,22246,22246,11.8
53146,Martigné-sur-Mayenne,1884,0,70011,70011,37.2
72276,Saint-Cosme-en-Vairais,1884,0,34936,34936,18.5
14242,Épron,1883,0,41901,41901,22.3
38187,Le Gua,1883,0,72741,72741,38.6
59185,Écaillon,1883,0,22642,22642,12
76271,Fontaine-le-Bourg,1883,0,1287,1287,0.7
26337,Saulce-sur-Rhône,1882,0,18133,18133,9.6
29053,Le Faou,1882,0,24325,24325,12.9
74210,Perrignier,1882,12800,81936,94736,50.3
79034,Bessines,1882,0,25365,25365,13.5
84082,Mormoiron,1882,41000,30534,71534,38
35054,Chanteloup,1881,0,27375,27375,14.6
44006,Assérac,1881,0,26051,26051,13.8
72179,Malicorne-sur-Sarthe,1881,0,10075,10075,5.4
44062,Le Gâvre,1880,16138,23919,40057,21.3
56237,Saint-Thuriau,1880,0,13090,13090,7
76349,Hautot-sur-Mer,1879,0,22836,22836,12.2
46148,Lalbenque,1878,0,10558,10558,5.6
60403,Milly-sur-Thérain,1878,23470,73642,97112,51.7
60644,Trie-Château,1878,42282,41240,83522,44.5
33142,Cubnezais,1877,0,10505,10505,5.6
42003,Ambierle,1877,22530,55389,77919,41.5
65072,Bazet,1877,0,17932,17932,9.6
31193,Le Fousseret,1875,73132,65661,138793,74
34311,Tourbes,1875,32900,20825,53725,28.7
60119,Cambronne-lès-Ribécourt,1875,0,9527,9527,5.1
84150,Visan,1875,0,50478,50478,26.9
7089,Félines,1874,0,9655,9655,5.2
17443,Thairé,1874,27990,52004,79994,42.7
29106,Landrévarzec,1874,0,60157,60157,32.1
30352,Villevieille,1874,10850,139405,150255,80.2
33506,Sauveterre-de-Guyenne,1874,0,18611,18611,9.9
35161,Louvigné-de-Bais,1874,0,28155,28155,15
59349,Ligny-en-Cambrésis,1874,0,12877,12877,6.9
57622,Saint-Privat-la-Montagne,1873,0,92864,92864,49.6
67108,Duppigheim,1873,249036,4826,253862,135.5
37232,Coteaux-sur-Loire,1872,0,17365,17365,9.3
68175,Lapoutroie,1872,92480,95593,188073,100.5
79285,Saint-Pardoux-Soutiers,1872,0,15430,15430,8.2
18003,Les Aix-d'Angillon,1871,21604,14179,35783,19.1
46231,Puy-l'Évêque,1870,0,67992,67992,36.4
62448,Hesdin-l'Abbé,1870,0,63215,63215,33.8
89083,Charbuy,1870,0,36583,36583,19.6
17338,Saint-Georges-du-Bois,1869,2820,77334,80154,42.9
29041,Coray,1869,0,15320,15320,8.2
57134,Châtel-Saint-Germain,1869,0,92666,92666,49.6
77397,Saâcy-sur-Marne,1869,0,7279,7279,3.9
77508,Villeneuve-le-Comte,1869,56805,53136,109941,58.8
1343,Saint-Cyr-sur-Menthon,1867,0,7561,7561,4
42129,Maclas,1867,0,57292,57292,30.7
79086,Cherveux,1867,0,10378,10378,5.6
82149,Réalville,1867,0,55202,55202,29.6
2A288,Sotta,1866,18080,27367,45447,24.4
87047,Compreignac,1866,0,3023,3023,1.6
29237,La Roche-Maurice,1865,35000,14455,49455,26.5
35019,Bazouges-la-Pérouse,1865,0,57170,57170,30.7
56154,Peillac,1865,0,26606,26606,14.3
59377,Marcoing,1865,0,24242,24242,13
71360,Prissé,1865,18350,47638,65988,35.4
77400,Saint-Augustin,1865,0,7263,7263,3.9
45279,Saint-Germain-des-Prés,1864,0,5651,5651,3
53001,Ahuillé,1864,0,81122,81122,43.5
71309,Montcenis,1864,0,29951,29951,16.1
62013,Agny,1863,0,52400,52400,28.1
1361,Saint-Jean-de-Niost,1862,0,31777,31777,17.1
43153,Pont-Salomon,1861,9025,28965,37990,20.4
45197,Marigny-les-Usages,1861,0,27220,27220,14.6
57515,Novéant-sur-Moselle,1861,0,11110,11110,6
37083,Cormery,1860,0,32287,32287,17.4
64448,Poey-de-Lescar,1860,48294,54918,103212,55.5
37067,Cheillé,1859,0,29592,29592,15.9
88462,Le Syndicat,1859,0,14520,14520,7.8
29044,Dinéault,1858,0,29283,29283,15.8
38297,Arandon-Passins,1858,0,9592,9592,5.2
45085,Châtillon-Coligny,1858,0,19051,19051,10.3
65251,Laloubère,1858,0,17750,17750,9.6
28098,Cherisy,1857,0,2484,2484,1.3
58062,Château-Chinon (Ville),1857,0,21882,21882,11.8
68172,Kunheim,1857,40855,32230,73085,39.4
91533,Saclas,1857,0,4677,4677,2.5
29213,Plouzévédé,1856,148081,13707,161788,87.2
76509,Préaux,1856,0,1268,1268,0.7
39476,Saint-Aubin,1855,18403,37649,56052,30.2
60025,Attichy,1855,0,12565,12565,6.8
70413,Plancher-Bas,1855,0,3143,3143,1.7
74097,Cusy,1855,0,14329,14329,7.7
11067,Canet,1853,0,25106,25106,13.5
33084,Cambes,1853,0,13641,13641,7.4
57179,Distroff,1853,0,11873,11873,6.4
71157,Cuiseaux,1853,0,7628,7628,4.1
72195,Mézeray,1853,0,9925,9925,5.4
89443,Véron,1853,17215,12314,29529,15.9
3155,Lurcy-Lévis,1852,0,24930,24930,13.5
26295,Saint-Barthélemy-de-Vals,1852,0,30487,30487,16.5
72127,Étival-lès-le-Mans,1852,0,9919,9919,5.4
14685,Thaon,1851,0,41189,41189,22.3
31355,Mons,1851,0,45253,45253,24.4
45040,Bonny-sur-Loire,1851,0,21546,21546,11.6
56100,Langonnet,1851,0,59166,59166,32
56159,Pleucadeuc,1850,0,22506,22506,12.2
8487,Vireux-Wallerand,1849,0,11871,11871,6.4
38453,Saint-Romans,1849,0,29881,29881,16.2
56125,Malguénac,1849,0,12874,12874,7
84042,Cucuron,1849,24511,8295,32806,17.7
83063,La Garde-Freinet,1848,80150,14808,94958,51.4
7027,Beauchastel,1847,0,6163,6163,3.3
44106,Les Moutiers-en-Retz,1846,11129,56272,67401,36.5
45042,Les Bordes,1846,0,10812,10812,5.9
47210,Port-Sainte-Marie,1846,0,17734,17734,9.6
1424,Tramoyes,1845,0,59481,59481,32.2
35171,Médréac,1845,0,35826,35826,19.4
71202,Fontaines,1845,0,50728,50728,27.5
1134,Crottet,1844,0,7468,7468,4
35163,Luitré-Dompierre,1844,0,22579,22579,12.2
38030,Beaucroissant,1843,0,9864,9864,5.4
7296,Saint-Sernin,1842,8500,31440,39940,21.7
22248,Pommerit-le-Vicomte,1842,0,37304,37304,20.3
74124,Feigères,1842,180752,7218,187970,102
78550,Saint-Germain-de-la-Grange,1842,0,795,795,0.4
41230,Saint-Sulpice-de-Pommeray,1841,2056,70558,72614,39.4
7122,Lachapelle-sous-Aubenas,1840,8900,31406,40306,21.9
22044,Coëtmieux,1840,15474,22208,37682,20.5
2B343,Venzolasca,1840,0,8520,8520,4.6
30348,Vézénobres,1839,0,57482,57482,31.3
34243,Saint-Bauzille-de-Putois,1839,36250,39390,75640,41.1
38256,Montferrat,1839,0,31242,31242,17
38270,La Murette,1838,0,31225,31225,17
49068,Champtocé-sur-Loire,1837,11264,36469,47733,26
56258,La Trinité-sur-Mer,1837,0,71081,71081,38.7
29066,Guengat,1836,59309,58937,118246,64.4
35312,Saint-Senoux,1836,0,16569,16569,9
52058,Bologne,1836,0,201672,201672,109.8
29043,Daoulas,1835,53316,14222,67538,36.8
67191,Herbitzheim,1835,7730,23004,30734,16.7
26338,Sauzet,1834,16300,17670,33970,18.5
95028,Attainville,1834,4200,3198,7398,4
33047,Berson,1833,0,18761,18761,10.2
72205,Montbizot,1833,3641,102996,106637,58.2
77269,Maincy,1833,0,25539,25539,13.9
2226,Courmelles,1831,0,15318,15318,8.4
64373,Mazères-Lezons,1831,54550,54061,108611,59.3
47054,Castelmoron-sur-Lot,1830,0,14768,14768,8.1
51536,Sillery,1830,0,32523,32523,17.8
53008,Aron,1830,0,68005,68005,37.2
14554,Le Castelet,1829,0,40699,40699,22.3
21661,Velars-sur-Ouche,1829,0,10286,10286,5.6
49381,Yzernay,1829,135331,76001,211332,115.5
64057,Arthez-de-Béarn,1829,19150,49248,68398,37.4
67452,Schnersheim,1829,2955,34798,37753,20.6
85303,Vix,1829,0,28663,28663,15.7
37079,Civray-de-Touraine,1828,0,41133,41133,22.5
58264,Saint-Pierre-le-Moûtier,1828,0,12220,12220,6.7
72089,Conlie,1828,0,35662,35662,19.5
46063,Castelnau-Montratier,1827,0,44908,44908,24.6
60284,Grandfresnoy,1826,30447,1709,32156,17.6
25193,Damprichard,1825,0,12713,12713,7
33484,Saint-Symphorien,1825,0,18663,18663,10.2
44075,Issé,1825,0,30609,30609,16.8
45290,Saint-Martin-d'Abbat,1825,0,3548,3548,1.9
56115,Locmaria-Grand-Champ,1825,0,16883,16883,9.3
74212,Glières-Val-de-Borne,1825,32450,55263,87713,48.1
34001,Abeilhan,1824,0,3568,3568,2
42262,Saint-Maurice-en-Gourgois,1824,0,42737,42737,23.4
77447,Seine-Port,1824,0,25414,25414,13.9
97234,Bellefontaine,1824,79900,16515,96415,52.9
28006,Amilly,1823,0,53120,53120,29.1
95446,Nesles-la-Vallée,1823,0,48118,48118,26.4
33490,Saint-Vivien-de-Médoc,1822,0,1760,1760,1
76595,Saint-Jouin-Bruneval,1822,0,16434,16434,9
77339,Noisy-sur-École,1822,0,15170,15170,8.3
44202,Teillé,1820,80858,22236,103094,56.6
69110,Larajasse,1820,0,91222,91222,50.1
85218,Saint-Georges-de-Pointindoux,1820,0,115058,115058,63.2
61278,Messei,1819,51719,48719,100438,55.2
39487,Saint-Laurent-en-Grandvaux,1818,212887,12946,225833,124.2
33454,Saint-Morillon,1817,0,16410,16410,9
35149,Lassy,1817,0,16397,16397,9
42206,Saint-Bonnet-les-Oules,1817,0,42573,42573,23.4
62063,Avesnes-le-Comte,1817,0,15098,15098,8.3
88369,Ramonchamp,1817,0,3674,3674,2
6103,Roquebillière,1816,0,35753,35753,19.7
2B185,Oletta,1816,20400,10978,31378,17.3
30317,Sernhac,1816,0,6689,6689,3.7
53182,Port-Brillet,1816,0,79033,79033,43.5
85049,Champagné-les-Marais,1816,0,38380,38380,21.1
38015,Artas,1815,0,19802,19802,10.9
44224,La Grigonnais,1815,0,28887,28887,15.9
51308,Jonchery-sur-Vesle,1815,0,32256,32256,17.8
19255,Seilhac,1814,0,34421,34421,19
14692,Tilly-sur-Seulles,1813,0,22227,22227,12.3
80706,Saint-Léger-lès-Domart,1813,0,3120,3120,1.7
83043,Collobrières,1813,113626,1571,115197,63.5
89449,Villeblevin,1813,7702,334,8036,4.4
46201,Montcuq-en-Quercy-Blanc,1812,0,44540,44540,24.6
49123,Distré,1812,0,17654,17654,9.7
79125,Fors,1812,10433,24421,34854,19.2
17041,Benon,1811,0,26386,26386,14.6
25364,Mamirolle,1811,23729,31909,55638,30.7
63315,Saint-Amant-Tallende,1811,0,32464,32464,17.9
73007,Aiton,1811,0,68700,68700,37.9
25287,Grandfontaine,1810,0,31891,31891,17.6
27246,Fleury-sur-Andelle,1810,43500,11909,55409,30.6
40264,Saint-Jean-de-Marsacq,1810,19600,40665,60265,33.3
67486,Sundhouse,1810,7992,38126,46118,25.5
72290,Saint-Jean-d'Assé,1810,0,101704,101704,56.2
82142,Pompignan,1810,0,24290,24290,13.4
24002,Agonac,1809,16856,10103,26959,14.9
28415,Villemeux-sur-Eure,1808,0,2418,2418,1.3
66138,Peyrestortes,1808,0,15059,15059,8.3
2238,Crépy,1807,1080,69009,70089,38.8
26083,Châteauneuf-de-Galaure,1807,0,29746,29746,16.5
52332,Val-de-Meuse,1807,0,8291,8291,4.6
8222,Haybes,1806,0,11595,11595,6.4
40291,Saubion,1806,0,40575,40575,22.5
50109,Cérences,1806,0,43709,43709,24.2
76545,Rouxmesnil-Bouteilles,1806,0,21948,21948,12.2
77148,Crouy-sur-Ourcq,1806,0,26518,26518,14.7
89370,Saint-Valérien,1806,0,6407,6407,3.5
25271,Gilley,1805,0,19767,19767,11
14125,Cambes-en-Plaine,1804,0,40143,40143,22.3
1314,Priay,1803,0,25835,25835,14.3
6099,Puget-Théniers,1803,0,40632,40632,22.5
30331,Tresques,1803,0,26310,26310,14.6
38118,Colombe,1803,0,9650,9650,5.4
57534,Peltre,1803,0,89394,89394,49.6
35216,Parthenay-de-Bretagne,1802,0,92342,92342,51.2
77260,Longueville,1802,0,6497,6497,3.6
85301,Vendrennes,1802,0,7708,7708,4.3
15119,Massiac,1801,50408,405,50813,28.2
24487,Saint-Pierre-d'Eyraud,1801,32697,40094,72791,40.4
29198,Plouider,1801,97058,45381,142439,79.1
59173,Deûlémont,1801,0,29824,29824,16.6
33380,Val-de-Livenne,1800,0,16778,16778,9.3
59485,Quiévy,1800,0,12368,12368,6.9
79351,Villiers-en-Plaine,1800,0,24260,24260,13.5
1363,Saint-Jean-le-Vieux,1799,0,25778,25778,14.3
16073,Chalais,1799,30560,84594,115154,64
22117,Lantic,1799,0,28533,28533,15.9
67480,Still,1799,65999,4635,70634,39.3
1273,Neuville-sur-Ain,1798,0,25763,25763,14.3
37257,Thilouze,1798,0,28621,28621,15.9
50417,Quettehou,1798,8235,56555,64790,36
10142,Estissac,1797,0,25661,25661,14.3
50539,Saint-Pierre-Église,1797,45176,56524,101700,56.6
52045,Bettancourt-la-Ferrée,1797,0,16275,16275,9.1
28059,Brezolles,1796,0,2402,2402,1.3
62906,Zutkerque,1795,0,13623,13623,7.6
34130,Laurens,1794,0,3509,3509,2
42120,Lentigny,1794,3243,52940,56183,31.3
56004,Arzal,1794,0,17082,17082,9.5
88428,Saint-Michel-sur-Meurthe,1794,0,17442,17442,9.7
17284,Pont-l'Abbé-d'Arnoult,1793,12825,45672,58497,32.6
19203,Sainte-Fortunade,1793,0,34023,34023,19
33357,Roaillan,1793,0,18336,18336,10.2
43258,Vergongheon,1793,15720,20081,35801,20
51074,Boult-sur-Suippe,1793,0,31865,31865,17.8
77279,Marolles-sur-Seine,1793,0,1267,1267,0.7
10352,Sainte-Maure,1792,0,25590,25590,14.3
38320,Porcieu-Amblagnieu,1792,0,9251,9251,5.2
57482,Ogy-Montoy-Flanville,1792,0,4363,4363,2.4
78057,Bennecourt,1792,0,9161,9161,5.1
27453,Perriers-sur-Andelle,1791,0,11784,11784,6.6
31384,Montlaur,1791,0,29201,29201,16.3
59332,Lannoy,1791,0,29659,29659,16.6
60494,Plailly,1791,0,35894,35894,20
79066,Champdeniers,1791,6137,14762,20899,11.7
79311,Secondigny,1791,38467,46956,85423,47.7
22265,Rospez,1790,0,35560,35560,19.9
59572,Solre-le-Château,1790,0,14180,14180,7.9
85011,Barbâtre,1790,3040,60987,64027,35.8
30173,Mons,1789,0,55920,55920,31.3
89201,Héry,1789,151086,11560,162646,90.9
34226,Quarante,1788,0,10109,10109,5.7
37021,Beaumont-Louestault,1788,5730,19844,25574,14.3
62329,Ferques,1788,0,7113,7113,4
67182,Hangenbieten,1788,7340,694601,701941,392.6
71192,Étang-sur-Arroux,1788,0,40004,40004,22.4
22056,Évran,1787,0,47606,47606,26.6
37206,Saint-Antoine-du-Rocher,1786,10804,19822,30626,17.1
60010,Amblainville,1786,16900,5746,22646,12.7
81130,Lagarrigue,1786,8800,18786,27586,15.4
57343,Illange,1785,0,18761,18761,10.5
24370,Saint-Antoine-de-Breuilh,1784,0,6216,6216,3.5
54432,Pont-Saint-Vincent,1784,0,18168,18168,10.2
56214,Saint-Gildas-de-Rhuys,1784,0,16504,16504,9.3
59088,Bois-Grenier,1784,0,29543,29543,16.6
62262,Cuinchy,1784,0,29440,29440,16.5
21606,Ladoix-Serrigny,1783,0,7753,7753,4.3
29176,Plonévez-Porzay,1783,0,28101,28101,15.8
76275,Fontenay,1783,0,16082,16082,9
28377,Sorel-Moussel,1782,0,2383,2383,1.3
42043,Chambœuf,1782,0,41753,41753,23.4
53243,Saint-Ouën-des-Toits,1782,0,77553,77553,43.5
58218,Prémery,1782,0,100573,100573,56.4
59021,Assevent,1782,0,63565,63565,35.7
30057,Cabrières,1781,0,6560,6560,3.7
36154,Le Pêchereau,1781,0,13077,13077,7.3
50239,Thèreval,1781,0,26342,26342,14.8
13079,Puyloubier,1780,0,50030,50030,28.1
2A008,Albitreccia,1780,6100,1333,7433,4.2
14454,Mouen,1779,0,39587,39587,22.3
63106,Chauriat,1779,0,17063,17063,9.6
63244,Chambaron sur Morge,1779,0,13454,13454,7.6
88178,Les Forges,1779,0,44737,44737,25.1
35211,Paimpont,1778,0,31290,31290,17.6
77404,Sainte-Colombe,1778,0,6411,6411,3.6
17393,Saint-Romain-de-Benet,1777,0,27986,27986,15.7
27582,Saint-Ouen-du-Tilleul,1777,0,7280,7280,4.1
74014,Arâches-la-Frasse,1777,203075,16168,219243,123.4
89196,Valravillon,1777,10555,42028,52583,29.6
51237,Esternay,1776,0,23174,23174,13
77126,Congis-sur-Thérouanne,1776,0,26077,26077,14.7
34245,Saint-Chinian,1775,0,10035,10035,5.7
38067,Chamagnieu,1775,0,9164,9164,5.2
80711,Saint-Ouen,1775,34904,3054,37958,21.4
12241,Sainte-Radegonde,1774,0,27187,27187,15.3
43114,Lapte,1774,0,41584,41584,23.4
45051,Bray-Saint-Aignan,1774,0,10390,10390,5.9
64198,Denguin,1774,39810,52378,92188,52
43135,Le Monastier-sur-Gazeille,1773,43674,9835,53509,30.2
14574,Saint-Désir,1772,0,19725,19725,11.1
27622,Serquigny,1772,0,7639,7639,4.3
41204,Saint-Claude-de-Diray,1772,0,12415,12415,7
79031,Beauvoir-sur-Niort,1772,9612,23882,33494,18.9
61181,Gacé,1771,41010,12802,53812,30.4
68365,Wettolsheim,1771,101554,36397,137951,77.9
85254,Saint-Mesmin,1771,0,48132,48132,27.2
15138,Murat,1770,0,398,398,0.2
59099,Bousies,1770,0,4995,4995,2.8
66124,Font-Romeu-Odeillo-Via,1770,307350,0,307350,173.6
3258,Saint-Rémy-en-Rollat,1769,0,48461,48461,27.4
57650,Sierck-les-Bains,1769,0,25465,25465,14.4
71170,Demigny,1769,0,48638,48638,27.5
79129,Fressines,1769,0,51089,51089,28.9
95353,Maffliers,1768,26710,10222,36932,20.9
63010,Arlanc,1767,0,15968,15968,9
67248,Krautergersheim,1767,8420,35857,44277,25.1
67347,Obermodern-Zutzendorf,1767,28624,47616,76240,43.1
87185,Saint-Victurnien,1767,13941,38644,52585,29.8
1303,Poncin,1766,15446,25305,40751,23.1
62197,Camblain-Châtelain,1766,0,29143,29143,16.5
74157,Lyaud,1766,10078,76886,86964,49.2
27629,Thiberville,1765,0,27180,27180,15.4
35002,Amanlis,1765,0,34359,34359,19.5
61079,Ceton,1765,48200,20492,68692,38.9
62310,Essars,1765,0,29126,29126,16.5
35010,Baguer-Pican,1764,0,15001,15001,8.5
37194,Reugny,1764,11965,31510,43475,24.6
44157,Saint-Étienne-de-Mer-Morte,1764,0,23198,23198,13.2
87177,Saint-Priest-sous-Aixe,1764,2610,821,3431,1.9
60291,Guiscard,1763,0,0,0,0
67460,Schwindratzheim,1763,21821,59248,81069,46
89100,Chéroy,1763,4518,6254,10772,6.1
80338,Fouilloy,1762,0,233,233,0.1
29192,Plougoulm,1761,19264,3346,22610,12.8
29221,Porspoder,1761,0,3172,3172,1.8
34009,Alignan-du-Vent,1761,0,10201,10201,5.8
53246,Saint-Pierre-des-Nids,1761,0,15662,15662,8.9
2245,Cuffies,1760,0,14724,14724,8.4
7110,Joyeuse,1760,25452,122718,148170,84.2
37185,Pocé-sur-Cisse,1760,15910,47772,63682,36.2
63393,Saint-Rémy-sur-Durolle,1760,0,40807,40807,23.2
17179,Les Gonds,1759,29175,55748,84923,48.3
59244,Fontaine-Notre-Dame,1759,0,22864,22864,13
67010,Andlau,1759,7565,54398,61963,35.2
14538,Castine-en-Plaine,1758,0,39119,39119,22.3
30346,Vers-Pont-du-Gard,1758,22500,6911,29411,16.7
46182,Luzech,1758,43173,63920,107093,60.9
68372,Willer-sur-Thur,1758,53426,29586,83012,47.2
92047,Marnes-la-Coquette,1758,0,14333,14333,8.2
2141,La Capelle,1757,0,31331,31331,17.8
24553,Tocane-Saint-Apre,1757,19110,13341,32451,18.5
35027,Boisgervilly,1757,0,34117,34117,19.4
85080,Doix lès Fontaines,1757,25205,11528,36733,20.9
68294,Sainte-Croix-aux-Mines,1756,0,310599,310599,176.9
28024,Barjouville,1755,0,51138,51138,29.1
59126,Cantin,1755,0,24453,24453,13.9
67080,Dachstein,1755,3500,4522,8022,4.6
67507,Villé,1755,6210,278369,284579,162.2
17484,Port-des-Barques,1754,59791,28884,88675,50.6
45167,Huisseau-sur-Mauves,1754,0,7227,7227,4.1
68012,Aspach-Michelbach,1754,0,29518,29518,16.8
85130,Maché,1754,0,14977,14977,8.5
10224,Marigny-le-Châtel,1753,0,0,0,0
62621,Nortkerque,1753,0,13305,13305,7.6
68060,Burnhaupt-le-Haut,1753,0,36781,36781,21
51531,Sermaize-les-Bains,1752,0,10279,10279,5.9
60597,Saint-Sauveur,1752,98070,15780,113850,65
61218,La Lande-Patry,1752,14553,46924,61477,35.1
2A017,Appietto,1751,0,17556,17556,10
51029,Avize,1751,0,34797,34797,19.9
51262,Frignicourt,1751,0,27620,27620,15.8
77124,Conches-sur-Gondoire,1751,0,4329,4329,2.5
7188,Quintenas,1750,65102,9016,74118,42.4
24571,Vergt,1750,28770,9774,38544,22
45029,Beaulieu-sur-Loire,1750,0,20371,20371,11.6
49371,Vezins,1750,9975,72718,82693,47.3
73015,Les Allues,1750,1075150,10476,1085626,620.4
11040,Bizanet,1749,0,27047,27047,15.5
21555,Saint-Julien,1749,0,42,42,0
22208,Plouasne,1749,0,46594,46594,26.6
31507,Saint-Paul-sur-Save,1749,0,14631,14631,8.4
40272,Saint-Martin-de-Hinx,1749,0,39295,39295,22.5
44153,Saint-Aubin-des-Châteaux,1749,0,29334,29334,16.8
85154,Mouilleron-Saint-Germain,1749,0,38216,38216,21.9
12157,Montrozier,1748,0,8657,8657,5
27676,Les Trois Lacs,1748,0,51838,51838,29.7
37002,Ambillou,1748,0,16215,16215,9.3
97233,Le Morne-Vert,1748,41500,15827,57327,32.8
42122,Lézigneux,1747,0,15652,15652,9
77309,Monthyon,1747,0,23825,23825,13.6
83117,Saint-Paul-en-Forêt,1747,0,33706,33706,19.3
89438,Venoy,1747,60080,34177,94257,54
37020,Beaulieu-lès-Loches,1746,31425,30308,61733,35.4
59025,Aubers,1746,0,28913,28913,16.6
22221,Plouguiel,1745,0,34666,34666,19.9
84149,Violès,1745,53407,0,53407,30.6
30228,Sainte-Anastasie,1744,0,6423,6423,3.7
59082,Bierne,1744,0,33589,33589,19.3
71522,Simandre,1744,0,10165,10165,5.8
29278,Spézet,1743,33212,14287,47499,27.3
34267,Saint-Jean-de-Fos,1743,34040,9415,43455,24.9
67342,Oberhaslach,1743,12700,4491,17191,9.9
76378,Jumièges,1743,0,49786,49786,28.6
78368,Mareil-sur-Mauldre,1743,0,4090,4090,2.3
2A114,Figari,1742,0,25549,25549,14.7
60533,Ressons-sur-Matz,1742,35650,15229,50879,29.2
1353,Sainte-Euphémie,1741,0,27574,27574,15.8
78152,Chavenay,1741,30650,4086,34736,20
84025,Cabrières-d'Avignon,1741,0,16969,16969,9.7
13034,Eygalières,1740,37300,3203,40503,23.3
38236,Miribel-les-Échelles,1740,0,119141,119141,68.5
66187,Saint-Paul-de-Fenouillet,1740,0,42544,42544,24.5
71373,Romenay,1740,0,10142,10142,5.8
26045,La Bégude-de-Mazenc,1739,0,60626,60626,34.9
63047,La Bourboule,1739,0,12696,12696,7.3
22143,Matignon,1738,0,46301,46301,26.6
24145,Creysse,1738,32750,38692,71442,41.1
35072,Châtillon-en-Vendelais,1738,0,26112,26112,15
40266,Saint-Julien-en-Born,1738,0,14144,14144,8.1
51440,Pontfaverger-Moronvilliers,1738,0,30888,30888,17.8
59519,Rumegies,1738,0,65385,65385,37.6
86014,Availles-en-Châtellerault,1738,0,39556,39556,22.8
31523,Salies-du-Salat,1737,0,93353,93353,53.7
35154,Livré-sur-Changeon,1737,0,6766,6766,3.9
40229,Pontenx-les-Forges,1737,0,9504,9504,5.5
60009,Allonne,1737,0,68113,68113,39.2
64324,Lasseube,1737,0,37406,37406,21.5
90017,Bourogne,1737,6050,60600,66650,38.4
1370,Saint-Laurent-sur-Saône,1735,0,44317,44317,25.5
35128,Guipel,1735,0,37270,37270,21.5
35178,Mézières-sur-Couesnon,1735,0,6758,6758,3.9
58300,Urzy,1735,0,97920,97920,56.4
68078,Eguisheim,1735,0,170352,170352,98.2
21383,Marcilly-sur-Tille,1734,0,24681,24681,14.2
30112,Fons,1734,0,6387,6387,3.7
37062,Château-la-Vallière,1734,0,16085,16085,9.3
49003,Tuffalun,1734,0,16894,16894,9.7
56122,Loyat,1734,0,26112,26112,15.1
72385,Yvré-le-Pôlin,1734,0,8694,8694,5
76289,Saint Martin de l'If,1734,0,3208,3208,1.9
38288,Oytier-Saint-Oblas,1733,0,48628,48628,28.1
56221,Saint-Jacut-les-Pins,1733,0,24723,24723,14.3
76321,Les Grandes-Ventes,1733,0,40483,40483,23.4
25601,Vercel-Villedieu-le-Camp,1732,148479,20460,168939,97.5
31585,Villeneuve-de-Rivière,1732,11510,35876,47386,27.4
38343,Romagnieu,1732,0,15188,15188,8.8
59261,Glageon,1732,16350,28413,44763,25.8
77047,Bouleurs,1731,0,6741,6741,3.9
4160,Reillanne,1730,44250,4559,48809,28.2
19066,Cublac,1730,0,27611,27611,16
24028,Beaumontois en Périgord,1730,0,6286,6286,3.6
34182,Nézignan-l'Évêque,1730,22920,19215,42135,24.4
97133,Vieux-Fort,1730,13500,7802,21302,12.3
23247,Saint-Vaury,1729,26650,28236,54886,31.7
40280,Saint-Perdon,1729,9630,21398,31028,17.9
45253,Pithiviers-le-Vieil,1729,0,2149,2149,1.2
67336,Nordhouse,1729,32020,31967,63987,37
71479,Saint-Sernin-du-Bois,1729,0,27782,27782,16.1
35197,Mouazé,1728,0,37119,37119,21.5
62423,Helfaut,1728,0,153792,153792,89
74150,Loisin,1728,139205,75231,214436,124.1
81233,Terre-de-Bancalié,1728,0,36051,36051,20.9
14556,Saint-André-sur-Orne,1727,0,38429,38429,22.3
38265,La Motte-d'Aveillans,1727,0,18083,18083,10.5
61463,Les Monts d'Andaine,1727,8775,46255,55030,31.9
82123,Montbartier,1727,0,23176,23176,13.4
31486,Saint-Hilaire,1726,15250,2144,17394,10.1
53039,Le Bourgneuf-la-Forêt,1726,0,75116,75116,43.5
57415,Lorry-lès-Metz,1726,0,85576,85576,49.6
88094,Châtel-sur-Moselle,1726,0,43404,43404,25.1
27003,Acquigny,1725,0,51156,51156,29.7
59123,Camphin-en-Carembault,1725,0,29440,29440,17.1
59576,Spycker,1725,0,210632,210632,122.1
72061,La Chapelle-d'Aligné,1725,0,12505,12505,7.2
21263,Fénay,1724,0,50029,50029,29
84053,Grillon,1724,0,46413,46413,26.9
86245,Senillé-Saint-Sauveur,1724,0,39237,39237,22.8
89198,Gurgy,1724,14250,33727,47977,27.8
38463,Saint-Vérand,1723,0,27845,27845,16.2
50095,Canisy,1723,0,25484,25484,14.8
83133,Tanneron,1723,0,33243,33243,19.3
84009,La Bastide-des-Jourdans,1723,0,7730,7730,4.5
27397,Ménilles,1722,0,9048,9048,5.3
38017,Assieu,1722,7320,44020,51340,29.8
43032,Blavozy,1722,45380,71651,117031,68
59551,Saméon,1722,0,29389,29389,17.1
82136,Orgueil,1721,0,23095,23095,13.4
88095,Châtenois,1721,48361,19226,67587,39.3
35333,Le Theil-de-Bretagne,1720,0,33483,33483,19.5
73226,Saint-Béron,1720,0,2547,2547,1.5
76533,Rogerville,1720,0,15514,15514,9
83082,Montferrat,1720,0,21426,21426,12.5
91017,Angervilliers,1720,0,7934,7934,4.6
42032,Cellieu,1719,0,40277,40277,23.4
80274,Eppeville,1719,0,32764,32764,19.1
34284,Saint-Pons-de-Thomières,1718,31585,6503,38088,22.2
42026,Briennon,1718,0,44572,44572,25.9
67487,Surbourg,1718,9891,47338,57229,33.3
3275,Souvigny,1717,0,23112,23112,13.5
78189,Crespières,1717,0,4029,4029,2.3
22065,Goudelin,1716,0,34752,34752,20.3
44220,Vue,1716,0,52310,52310,30.5
76743,Villers-Écalles,1716,15864,5731,21595,12.6
59027,Aubry-du-Hainaut,1715,0,33038,33038,19.3
62756,Sainte-Marie-Kerque,1715,0,13016,13016,7.6
63084,Chanonat,1715,0,30743,30743,17.9
12138,Marcillac-Vallon,1714,0,70724,70724,41.3
36192,Saint-Gaultier,1714,0,12585,12585,7.3
63004,Les Ancizes-Comps,1714,0,11307,11307,6.6
18109,Henrichemont,1713,16246,12982,29228,17.1
35105,Erbrée,1713,0,25736,25736,15
56141,Moustoir-Ac,1713,0,6904,6904,4
21356,Losne,1712,0,12837,12837,7.5
78049,Bazemont,1712,0,4017,4017,2.3
87028,Val-d'Oire-et-Gartempe,1712,22900,29138,52038,30.4
2114,Brasles,1711,24651,39549,64200,37.5
71275,Marcigny,1711,22505,38338,60843,35.6
33517,Soussans,1710,0,486,486,0.3
74153,Lucinges,1709,0,27311,27311,16
80211,Conty,1709,0,2360,2360,1.4
28056,Boutigny-Prouais,1708,0,17125,17125,10
32334,Pujaudran,1708,0,121504,121504,71.1
74197,Nangy,1708,0,7357,7357,4.3
82044,Corbarieu,1707,0,14863,14863,8.7
84062,Lagnes,1707,0,16638,16638,9.7
22170,Plaine-Haute,1705,0,27042,27042,15.9
42272,Saint-Pierre-de-Bœuf,1705,0,52320,52320,30.7
38561,Viriville,1704,0,18591,18591,10.9
40157,Lit-et-Mixe,1704,0,13867,13867,8.1
73243,Saint-Jean-d'Arvey,1704,0,21659,21659,12.7
74076,Choisy,1704,0,7236,7236,4.2
85086,Falleron,1704,0,14551,14551,8.5
86111,Ingrandes,1704,0,38782,38782,22.8
27151,Charleval,1703,281655,11205,292860,172
30089,Comps,1703,0,6694,6694,3.9
45310,Sermaises,1703,0,2117,2117,1.2
67525,Westhoffen,1703,27645,92494,120139,70.5
69234,Saint-Romain-de-Popey,1703,0,20129,20129,11.8
77229,La Houssaye-en-Brie,1703,0,8655,8655,5.1
17444,Thénac,1702,0,53942,53942,31.7
30092,Connaux,1702,0,24836,24836,14.6
35067,Chasné-sur-Illet,1702,0,6630,6630,3.9
79189,Nanteuil,1702,0,9461,9461,5.6
84135,Uchaux,1702,0,0,0,0
7323,Toulaud,1701,7350,33232,40582,23.9
27348,Igoville,1701,6645,50444,57089,33.6
60641,Tracy-le-Mont,1701,11855,11522,23377,13.7
2676,Saint-Erme-Outre-et-Ramecourt,1700,0,4574,4574,2.7
29010,Bodilis,1700,170168,12555,182723,107.5
42053,Châteauneuf,1700,0,39831,39831,23.4
51423,Pargny-sur-Saulx,1700,0,9974,9974,5.9
83110,Rougiers,1700,0,63692,63692,37.5
56259,La Trinité-Surzur,1699,0,15718,15718,9.3
61497,Valframbert,1699,5400,50211,55611,32.7
76600,Saint-Léonard,1699,0,11025,11025,6.5
2315,Flavy-le-Martel,1698,0,242682,242682,142.9
33307,Noaillan,1698,0,17364,17364,10.2
34340,Villetelle,1698,0,18564,18564,10.9
38401,Saint-Jean-de-Soudain,1698,0,14890,14890,8.8
74314,Vulbens,1698,44496,6654,51150,30.1
34078,Claret,1697,0,31620,31620,18.6
35009,Baguer-Morvan,1697,0,14431,14431,8.5
37231,Saint-Paterne-Racan,1697,41285,18834,60119,35.4
67326,Niederhausbergen,1697,37592,659250,696842,410.6
47326,Virazeil,1696,0,17547,17547,10.3
54025,Art-sur-Meurthe,1696,100145,56638,156783,92.4
11129,Espéraza,1695,24505,18621,43126,25.4
21003,Ahuy,1695,0,49188,49188,29
22015,Bréhand,1695,49350,20458,69808,41.2
34258,Saint-Geniès-de-Fontedit,1695,0,3315,3315,2
39059,Bois-d'Amont,1695,23869,12064,35933,21.2
57644,Seingbouse,1695,0,54039,54039,31.9
78389,Méré,1695,0,732,732,0.4
21408,Messigny-et-Vantoux,1694,15806,0,15806,9.3
38566,Vourey,1694,0,28778,28778,17
28039,Béville-le-Comte,1693,0,9824,9824,5.8
42010,Aveizieux,1693,13694,30687,44381,26.2
44196,Sévérac,1693,0,17577,17577,10.4
49306,Saint-Martin-du-Fouilloux,1693,25848,27407,53255,31.5
59114,Bruille-Saint-Amand,1693,0,63692,63692,37.6
74171,Massongy,1693,0,73708,73708,43.5
87089,Magnac-Laval,1693,18958,28814,47772,28.2
97201,L'Ajoupa-Bouillon,1693,62000,15329,77329,45.7
50591,Le Teilleul,1692,0,41630,41630,24.6
62284,Écourt-Saint-Quentin,1692,0,2105,2105,1.2
69023,Blacé,1692,10320,35922,46242,27.3
14030,Authie,1691,0,37628,37628,22.3
38107,Chonas-l'Amballan,1691,0,13010,13010,7.7
63381,Saint-Ours,1691,0,12788,12788,7.6
67239,Kintzheim,1691,0,32533,32533,19.2
27070,Frenelles-en-Vexin,1690,0,8880,8880,5.3
35094,Dingé,1690,0,21156,21156,12.5
81139,Lautrec,1690,0,25276,25276,15
86046,Cenon-sur-Vienne,1690,0,38463,38463,22.8
15142,Neuvéglise-sur-Truyère,1689,19810,37359,57169,33.8
28094,Chaudon,1689,0,9801,9801,5.8
33394,Saint-Émilion,1689,0,65620,65620,38.9
42267,Saint-Nizier-sous-Charlieu,1689,46113,43820,89933,53.2
53229,Saint-Jean-sur-Mayenne,1689,0,73506,73506,43.5
78576,Saint-Rémy-l'Honoré,1689,0,729,729,0.4
79088,Chiché,1689,0,48046,48046,28.4
27593,Saint-Pierre-des-Fleurs,1688,0,6915,6915,4.1
59320,Illies,1688,0,27953,27953,16.6
11425,Villegailhenc,1687,0,10942,10942,6.5
31587,Villeneuve-lès-Bouloc,1687,0,3389,3389,2
51663,Magenta,1686,0,33505,33505,19.9
54123,Chavigny,1686,0,17170,17170,10.2
86031,Bonnes,1686,0,100450,100450,59.6
2B298,Saint-Florent,1685,0,10186,10186,6
59558,Saulzoir,1685,0,424,424,0.3
62540,Maisnil-lès-Ruitz,1685,0,27806,27806,16.5
79201,Pamproux,1685,0,9366,9366,5.6
97303,Iracoubo,1685,0,13835,13835,8.2
34189,Olonzac,1683,0,6371,6371,3.8
37254,Tauxigny-Saint-Bauld,1683,0,29214,29214,17.4
58046,Cercy-la-Tour,1683,0,86812,86812,51.6
59408,Moncheaux,1683,0,28724,28724,17.1
2820,Viry-Noureuil,1682,0,30221,30221,18
8173,Flize,1682,0,38638,38638,23
34013,Aspiran,1682,0,1916,1916,1.1
40328,Vieux-Boucau-les-Bains,1682,0,37790,37790,22.5
50184,Flamanville,1682,388800,52907,441707,262.6
30073,Castillon-du-Gard,1681,0,12917,12917,7.7
72001,Aigné,1681,0,34390,34390,20.5
86103,Gençay,1681,24030,37856,61886,36.8
22376,Trévé,1680,0,0,0,0
60577,Saint-Germer-de-Fly,1680,33823,13772,47595,28.3
63282,Plauzat,1680,0,10921,10921,6.5
95436,Mours,1680,0,5985,5985,3.6
35070,Châteauneuf-d'Ille-et-Vilaine,1679,0,39808,39808,23.7
76167,Cauville-sur-Mer,1679,0,15144,15144,9
47024,Beaupuy,1678,0,17361,17361,10.3
50260,Juvigny les Vallées,1678,0,41286,41286,24.6
59096,Bourghelles,1678,0,28638,28638,17.1
76617,Saint-Martin-du-Vivier,1678,0,47930,47930,28.6
26275,Rochegude,1677,0,25928,25928,15.5
45148,Fontenay-sur-Loing,1677,0,16449,16449,9.8
67168,Gresswiller,1677,43567,4321,47888,28.6
30145,Lédenon,1676,0,6173,6173,3.7
67550,Wœrth,1676,10038,40552,50590,30.2
1092,Châtillon-la-Palud,1675,0,349,349,0.2
5123,La Roche-des-Arnauds,1675,0,62682,62682,37.4
8003,Aiglemont,1675,0,38477,38477,23
28154,Fontaine-la-Guyon,1675,0,6197,6197,3.7
60135,Cauvigny,1675,0,6957,6957,4.2
76260,Ferrières-en-Bray,1675,0,31642,31642,18.9
91175,Corbreuse,1675,0,9736,9736,5.8
6034,Castagniers,1674,0,32958,32958,19.7
83146,La Verdière,1674,0,17170,17170,10.3
28424,Yèvres,1673,0,91419,91419,54.6
61341,Écouves,1673,15000,49443,64443,38.5
14005,Valambray,1672,0,13457,13457,8
38172,Four,1672,0,20317,20317,12.2
95675,Villeron,1672,14850,20735,35585,21.3
54351,Marbache,1671,0,16091,16091,9.6
85266,Saint-Prouant,1671,0,8507,8507,5.1
87032,Châlus,1671,27064,22649,49713,29.8
26196,Montéléger,1670,9885,33852,43737,26.2
34128,Laroque,1670,21600,35771,57371,34.4
38149,Domarin,1670,0,20293,20293,12.2
57176,Diebling,1670,0,30530,30530,18.3
74021,Arthaz-Pont-Notre-Dame,1670,0,7194,7194,4.3
29270,Saint-Urbain,1669,54035,12936,66971,40.1
45196,Mareau-aux-Prés,1669,0,6877,6877,4.1
58250,Saint-Léger-des-Vignes,1669,0,4305,4305,2.6
72363,Tuffé Val de la Chéronne,1669,0,10182,10182,6.1
50272,Tourneville-sur-Mer,1668,0,48262,48262,28.9
1237,Martignat,1667,0,63059,63059,37.8
59238,Flines-lès-Mortagne,1667,0,62714,62714,37.6
64439,Ousse,1667,14940,49219,64159,38.5
18057,Châteaumeillant,1666,30358,4466,34824,20.9
24229,Le Lardin-Saint-Lazare,1666,173518,29137,202655,121.6
24259,Eyraud-Crempse-Maurens,1666,4275,79775,84050,50.5
50562,Saint-Vaast-la-Hougue,1666,52455,52403,104858,62.9
79339,Vasles,1666,32602,43679,76281,45.8
34325,Valros,1665,1292,9645,10937,6.6
50162,Digosville,1665,0,52372,52372,31.5
6019,Blausasc,1664,0,46923,46923,28.2
7072,Coux,1664,0,5552,5552,3.3
7289,Saint-Privat,1664,21341,28402,49743,29.9
22049,Créhen,1664,0,44330,44330,26.6
31475,Saint-Clar-de-Rivière,1664,0,2067,2067,1.2
43234,Saugues,1664,0,15152,15152,9.1
54196,Flavigny-sur-Moselle,1664,0,16946,16946,10.2
78601,Sonchamp,1664,0,3242,3242,1.9
84050,Gordes,1664,0,16219,16219,9.7
32096,Cazaubon,1663,95693,0,95693,57.5
74080,La Clusaz,1663,1071426,84476,1155902,695.1
24356,Rouffignac-Saint-Cernin-de-Reilhac,1662,27673,23071,50744,30.5
79184,La Mothe-Saint-Héray,1662,0,47999,47999,28.9
79239,Saint-Aubin-le-Cloud,1662,0,43574,43574,26.2
88188,Fresse-sur-Moselle,1662,0,3360,3360,2
41043,Châtillon-sur-Cher,1661,6820,30522,37342,22.5
59247,Forest-sur-Marque,1660,0,27489,27489,16.6
27500,Routot,1659,0,37475,37475,22.6
31080,Boulogne-sur-Gesse,1658,0,34343,34343,20.7
43084,Cussac-sur-Loire,1658,9265,68988,78253,47.2
44197,Sion-les-Mines,1658,0,27808,27808,16.8
14338,Houlgate,1657,0,21049,21049,12.7
36141,Neuvy-Saint-Sépulchre,1657,28926,4859,33785,20.4
62506,Licques,1657,0,10142,10142,6.1
97301,Régina,1657,0,0,0,0
31269,Lamasquère,1655,4520,2056,6576,4
78343,Les Loges-en-Josas,1655,0,13717,13717,8.3
19107,Larche,1654,27233,26398,53631,32.4
29230,Querrien,1654,0,56825,56825,34.4
59224,Féchain,1654,0,23046,23046,13.9
60218,Esches,1654,6850,5322,12172,7.4
68252,Ostheim,1654,0,3954,3954,2.4
85015,Beaufou,1654,0,14124,14124,8.5
72358,Thorigné-sur-Dué,1653,0,30900,30900,18.7
17079,Chaillevette,1652,4000,26017,30017,18.2
27020,Arnières-sur-Iton,1651,0,19417,19417,11.8
62479,Labeuvrière,1651,0,27245,27245,16.5
87140,Saint-Brice-sur-Vienne,1651,7410,36107,43517,26.4
2602,Pinon,1650,0,1633,1633,1
50599,Tollevast,1650,0,51900,51900,31.5
56148,Nostang,1650,52529,5892,58421,35.4
31581,Villaudric,1649,0,3313,3313,2
1276,Niévroz,1648,0,22439,22439,13.6
25222,Étalans,1648,0,19467,19467,11.8
68359,Wattwiller,1648,25093,27735,52828,32.1
8180,La Francheville,1647,0,37834,37834,23
41171,Oucques La Nouvelle,1647,0,4959,4959,3
56239,Saint-Vincent-sur-Oust,1647,0,23496,23496,14.3
68185,Lièpvre,1647,0,291319,291319,176.9
83037,La Celle,1647,0,61707,61707,37.5
74075,Chilly,1646,0,39757,39757,24.2
28021,Bailleau-le-Pin,1645,0,6086,6086,3.7
1420,Thoissey,1644,0,8486,8486,5.2
42249,Saint-Just-la-Pendue,1644,2424,46606,49030,29.8
55132,Cousances-les-Forges,1644,0,32133,32133,19.5
82048,Dieupentale,1644,0,22062,22062,13.4
87020,Bonnac-la-Côte,1644,88182,23313,111495,67.8
32344,Riscle,1643,0,16447,16447,10
59013,Anstaing,1643,0,27208,27208,16.6
70339,Mélisey,1643,0,18898,18898,11.5
71443,Saint-Loup-Géanges,1643,0,45174,45174,27.5
85083,L'Épine,1643,0,55979,55979,34.1
38483,Sermérieu,1642,0,8477,8477,5.2
71189,Épervans,1642,0,45147,45147,27.5
47110,Gontaud-de-Nogaret,1641,0,16978,16978,10.3
63224,Ménétrol,1641,0,12410,12410,7.6
80443,Hornoy-le-Bourg,1641,0,2266,2266,1.4
3019,Beaulon,1640,0,28326,28326,17.3
29186,Plouezoc'h,1640,20940,98333,119273,72.7
80417,Harbonnières,1640,0,29681,29681,18.1
3290,Trévol,1639,23460,22063,45523,27.8
24540,Sorges et Ligueux en Périgord,1639,28646,9154,37800,23.1
46185,Martel,1639,0,53473,53473,32.6
60044,Balagny-sur-Thérain,1639,3825,6808,10633,6.5
72360,Trangé,1639,0,33530,33530,20.5
26042,Beauvallon,1638,7520,33204,40724,24.9
31052,Beaumont-sur-Lèze,1638,18400,8616,27016,16.5
60154,Cinqueux,1638,0,2394,2394,1.5
67526,Westhouse,1638,10653,30285,40938,25
68174,Landser,1638,0,31837,31837,19.4
74098,Cuvat,1638,8625,29448,38073,23.2
1383,Saint-Paul-de-Varax,1637,0,341,341,0.2
4244,Volonne,1637,0,68615,68615,41.9
8361,Renwez,1637,0,25485,25485,15.6
11088,Cazilhac,1637,0,10618,10618,6.5
18172,Orval,1637,0,7213,7213,4.4
22193,Plestan,1637,7700,19758,27458,16.8
33198,Guîtres,1637,0,31931,31931,19.5
33439,Saint-Mariens,1637,0,9162,9162,5.6
36128,Montierchaume,1637,0,60673,60673,37.1
74189,Mont-Saxonnex,1637,0,14894,14894,9.1
17241,Montguyon,1636,0,19317,19317,11.8
56135,Molac,1636,0,11592,11592,7.1
27119,Bueil,1635,0,8591,8591,5.3
29218,Pont-Croix,1635,0,117021,117021,71.6
55184,Euville,1635,0,6599,6599,4
63066,Celles-sur-Durolle,1635,0,37908,37908,23.2
89239,Malay-le-Grand,1635,10310,10865,21175,13
33164,Fargues,1634,0,16710,16710,10.2
76627,Saint-Nicolas-de-la-Taille,1634,6260,12453,18713,11.5
3156,Lusigny,1633,0,21982,21982,13.5
15265,Ydes,1633,54839,8357,63196,38.7
33315,Les Peintures,1633,0,31853,31853,19.5
69059,Civrieux-d'Azergues,1633,0,14717,14717,9
22127,Lézardrieux,1632,0,32421,32421,19.9
26348,Taulignan,1632,0,43936,43936,26.9
34084,Corneilhan,1632,13900,9454,23354,14.3
38184,Grenay,1632,0,45794,45794,28.1
45175,Jouy-le-Potier,1631,0,14071,14071,8.6
68342,Uffholtz,1631,0,27448,27448,16.8
12185,Pont-de-Salars,1630,0,29380,29380,18
22327,Saint-Samson-sur-Rance,1630,0,43424,43424,26.6
26339,Savasse,1630,0,15705,15705,9.6
62349,Fouquereuil,1630,0,26899,26899,16.5
62529,Lorgies,1630,0,26899,26899,16.5
76245,Eslettes,1630,20950,1114,22064,13.5
87152,Saint-Jouvent,1630,0,2641,2641,1.6
33395,Saint-Estèphe,1629,0,14322,14322,8.8
60570,Saint-Crépin-Ibouvillers,1629,0,5241,5241,3.2
77109,Chenoise-Cucharmoy,1629,0,5874,5874,3.6
85220,Saint-Germain-de-Prinçay,1629,41597,8293,49890,30.6
1078,Challex,1628,0,20956,20956,12.9
30091,Congénies,1628,11850,121105,132955,81.7
67485,Stutzheim-Offenheim,1628,28663,30974,59637,36.6
59305,Herzeele,1627,0,31336,31336,19.3
33351,Reignac,1626,0,15156,15156,9.3
40055,Bretagne-de-Marsan,1626,0,20124,20124,12.4
59578,Steenbecque,1626,0,9934,9934,6.1
60212,Ercuis,1626,0,6754,6754,4.2
62609,Neuville-Saint-Vaast,1626,0,45734,45734,28.1
85147,Montournais,1626,0,44192,44192,27.2
1351,Saint-Étienne-sur-Chalaronne,1625,0,8388,8388,5.2
4166,Riez,1625,24052,18889,42941,26.4
63231,La Monnerie-le-Montel,1624,0,37653,37653,23.2
68020,Bantzenheim,1624,0,113131,113131,69.7
71187,Écuisses,1624,0,26095,26095,16.1
58215,Pouilly-sur-Loire,1623,0,32358,32358,19.9
14739,Ver-sur-Mer,1622,0,19886,19886,12.3
31239,L'Isle-en-Dodon,1622,0,33597,33597,20.7
63295,Randan,1622,0,6629,6629,4.1
74312,Vougy,1622,30680,49116,79796,49.2
77531,Voulx,1622,0,1146,1146,0.7
81074,Cunac,1622,25785,15745,41530,25.6
25021,Arc-et-Senans,1621,0,11813,11813,7.3
31036,Auzielle,1621,0,26429,26429,16.3
37196,Richelieu,1620,0,43956,43956,27.1
67351,Seebach,1620,0,178496,178496,110.2
86183,Les Ormes,1620,0,36870,36870,22.8
2504,Montescourt-Lizerolles,1619,0,231391,231391,142.9
13029,Cornillon-Confoux,1619,0,45504,45504,28.1
24462,Saint-Médard-de-Mussidan,1619,29032,77525,106557,65.8
72096,Coulans-sur-Gée,1619,0,14712,14712,9.1
85240,Saint-Malô-du-Bois,1619,0,20744,20744,12.8
18145,Menetou-Salon,1618,0,12262,12262,7.6
72187,Marigné-Laillé,1618,0,3380,3380,2.1
6066,Gilette,1617,0,31835,31835,19.7
7261,Saint-Laurent-du-Pape,1617,33711,5395,39106,24.2
12288,Valady,1617,0,66721,66721,41.3
30281,Saint-Mamert-du-Gard,1617,0,5956,5956,3.7
35117,Gaël,1617,0,31399,31399,19.4
27067,Bézu-Saint-Éloi,1616,0,1317,1317,0.8
51118,Champigny,1616,0,28719,28719,17.8
59609,Vendeville,1615,0,26744,26744,16.6
81063,Castelnau-de-Lévis,1615,13479,15677,29156,18.1
16150,Gensac-la-Pallue,1614,10600,60389,70989,44
57043,Ay-sur-Moselle,1614,0,3276,3276,2
72243,Pontvallain,1614,0,8093,8093,5
88011,Arches,1614,0,40588,40588,25.1
1099,Chazey-sur-Ain,1613,0,27528,27528,17.1
34039,Bouzigues,1613,12500,63360,75860,47
2575,Origny-Sainte-Benoite,1612,0,0,0,0
30077,Cendras,1612,0,50387,50387,31.3
60591,Saint-Paul,1612,0,63211,63211,39.2
68217,Moosch,1612,0,16749,16749,10.4
7259,Saint-Just-d'Ardèche,1611,0,128423,128423,79.7
22179,Fréhel,1611,0,42918,42918,26.6
27391,Marcilly-sur-Eure,1611,0,18947,18947,11.8
29300,Le Trévoux,1611,0,55348,55348,34.4
45072,Chanteau,1611,0,23564,23564,14.6
2795,Vic-sur-Aisne,1610,0,1549,1549,1
12021,Le Bas Ségala,1610,0,37352,37352,23.2
18023,Baugy,1610,0,7420,7420,4.6
34204,Plaissan,1610,0,8696,8696,5.4
78334,Lévis-Saint-Nom,1610,0,2030,2030,1.3
27062,Les Monts du Roumois,1609,0,6592,6592,4.1
59535,Saint-Jans-Cappel,1609,0,9830,9830,6.1
63089,Chappes,1609,0,12168,12168,7.6
67407,Rohrwiller,1609,0,19564,19564,12.2
80677,Roisel,1609,0,11528,11528,7.2
25395,Montfaucon,1608,30833,28332,59165,36.8
59668,Zuydcoote,1608,0,196345,196345,122.1
82076,L'Honor-de-Cos,1608,0,8198,8198,5.1
24194,Gardonne,1607,14135,35775,49910,31.1
62309,Esquerdes,1607,0,3477,3477,2.2
62730,Ruminghem,1607,0,12197,12197,7.6
30029,Barjac,1606,0,65184,65184,40.6
31284,Lauzerville,1606,0,26184,26184,16.3
55573,Void-Vacon,1606,0,6482,6482,4
59651,Wavrechain-sous-Denain,1606,0,60419,60419,37.6
82097,Lavit,1606,0,37646,37646,23.4
91593,Sermaise,1606,0,9335,9335,5.8
40228,Pomarez,1605,0,4358,4358,2.7
40292,Saubrigues,1605,20970,36060,57030,35.5
50058,Blainville-sur-Mer,1604,0,46410,46410,28.9
1446,Villeneuve,1603,0,25388,25388,15.8
22094,Lancieux,1602,0,53447,53447,33.4
22175,Plédéliac,1602,25968,19336,45304,28.3
22220,Plouguernével,1602,0,147524,147524,92.1
29245,Saint-Divy,1602,69823,12416,82239,51.3
85278,Saint-Vincent-sur-Jard,1602,13286,32163,45449,28.4
87111,Oradour-sur-Vayres,1602,50043,704,50747,31.7
25428,Nommay,1601,10795,101349,112144,70
38043,Bilieu,1601,0,27198,27198,17
42169,Périgneux,1601,0,14344,14344,9
70122,Champlitte,1601,0,8218,8218,5.1
71502,Sassenay,1601,0,44019,44019,27.5
1306,Pont-de-Veyle,1600,0,6480,6480,4
16005,Aigre,1600,33465,20114,53579,33.5
31037,Avignonet-Lauragais,1600,0,7804,7804,4.9
62295,Enquin-lez-Guinegatte,1600,0,142400,142400,89
82131,Montpezat-de-Quercy,1600,0,47307,47307,29.6
11288,Pezens,1598,0,10365,10365,6.5
33159,Étauliers,1598,0,14895,14895,9.3
38393,Saint-Hilaire-de-la-Côte,1598,0,17434,17434,10.9
12223,Argences en Aubrac,1597,0,54115,54115,33.9
19148,Neuvic,1597,49222,21893,71115,44.5
30185,Mus,1597,22900,0,22900,14.3
84055,Jonquerettes,1597,26520,29971,56491,35.4
2165,Charmes,1596,0,28676,28676,18
8043,Balan,1596,0,36662,36662,23
30225,Sabran,1596,0,23289,23289,14.6
71133,La Clayette,1596,0,30977,30977,19.4
37217,Saint-Étienne-de-Chigny,1595,8350,18871,27221,17.1
66114,Montescot,1595,0,156,156,0.1
76414,Martin-Église,1595,0,19384,19384,12.2
76716,Turretot,1595,0,14387,14387,9
16418,Vœuil-et-Giget,1594,12305,41441,53746,33.7
33505,La Sauve,1594,0,157381,157381,98.7
34038,Le Bousquet-d'Orb,1594,13200,14841,28041,17.6
42230,Saint-Germain-Laval,1594,8877,13158,22035,13.8
67368,Ottrott,1594,0,57899,57899,36.3
68005,Ammerschwihr,1594,146673,81397,228070,143.1
69280,Jons,1594,0,4711,4711,3
87107,Nieul,1594,0,2583,2583,1.6
1165,Francheleins,1593,0,8223,8223,5.2
59334,Lauwin-Planque,1593,0,22196,22196,13.9
24362,Val de Louyre et Caudeau,1592,12635,8891,21526,13.5
85277,Saint-Vincent-sur-Graon,1592,0,31962,31962,20.1
88349,Plainfaing,1592,0,15478,15478,9.7
22224,Ploulec'h,1591,0,31606,31606,19.9
33218,Lagorce,1591,0,31034,31034,19.5
54391,Moutiers,1591,0,14772,14772,9.3
60451,Neuilly-sous-Clermont,1591,8970,8438,17408,10.9
64419,Nousty,1591,0,16608,16608,10.4
70378,Navenne,1591,0,82302,82302,51.7
11009,Alzonne,1590,0,10313,10313,6.5
31277,Lasserre-Pradère,1590,0,486,486,0.3
35233,Québriac,1590,0,19904,19904,12.5
37119,L'Île-Bouchard,1590,0,43142,43142,27.1
26146,Grignan,1589,0,42778,42778,26.9
47138,Laroque-Timbaut,1589,0,12177,12177,7.7
60380,Mareuil-sur-Ourcq,1589,0,6222,6222,3.9
74146,Larringes,1589,7607,82327,89934,56.6
76125,Bosc-le-Hard,1589,0,1086,1086,0.7
25448,Pelousey,1588,11005,27980,38985,24.5
42159,Noirétable,1587,0,14219,14219,9
44095,La Meilleraye-de-Bretagne,1587,0,26617,26617,16.8
61456,Saint-Sulpice-sur-Risle,1587,24422,16360,40782,25.7
64526,Soumoulou,1587,0,16566,16566,10.4
85202,Sainte-Cécile,1587,0,8079,8079,5.1
27085,Flancourt-Crescy-en-Roumois,1586,0,6498,6498,4.1
62652,Pernes,1586,9388,34263,43651,27.5
66026,Brouilla,1586,0,21258,21258,13.4
14079,Blonville-sur-Mer,1585,20558,125456,146014,92.1
33289,Monségur,1585,0,12904,12904,8.1
67095,Diemeringen,1585,8843,19870,28713,18.1
68089,Fellering,1585,0,16469,16469,10.4
12225,Saint-Georges-de-Luzençon,1584,0,16370,16370,10.3
36101,Luant,1584,0,58708,58708,37.1
63034,Beauregard-l'Évêque,1584,0,15193,15193,9.6
77095,Charny,1584,0,1204,1204,0.8
87103,Nantiat,1584,0,2567,2567,1.6
22184,Plémy,1583,87219,19106,106325,67.2
34067,Cazilhac,1583,14255,33907,48162,30.4
38069,Champier,1583,0,17271,17271,10.9
41252,Suèvres,1583,8460,4766,13226,8.4
57477,Montbronn,1583,0,36483,36483,23
76610,Sainte-Marie-des-Champs,1583,0,2928,2928,1.8
60277,Goincourt,1582,0,62035,62035,39.2
77016,Bagneaux-sur-Loing,1582,0,809,809,0.5
78346,Longnes,1582,0,15862,15862,10
80256,Dreuil-lès-Amiens,1582,0,101424,101424,64.1
22379,Trévou-Tréguignec,1581,0,31408,31408,19.9
28352,Saint-Martin-de-Nigelles,1581,0,9174,9174,5.8
55551,Vigneulles-lès-Hattonchâtel,1581,0,18788,18788,11.9
59418,Mortagne-du-Nord,1581,0,59478,59478,37.6
63150,Enval,1581,0,11956,11956,7.6
71378,Rully,1581,0,43469,43469,27.5
77075,Chalifert,1581,21464,3908,25372,16
77239,Jouy-le-Châtel,1581,0,5701,5701,3.6
30147,Lézan,1580,0,49387,49387,31.3
56233,Saint-Philibert,1580,52006,61137,113143,71.6
71158,Cuisery,1580,21950,9209,31159,19.7
11164,Ginestas,1579,0,24418,24418,15.5
45103,Corbeilles,1579,0,15488,15488,9.8
54129,Cirey-sur-Vezouze,1579,0,5602,5602,3.5
44090,La Marne,1578,0,20752,20752,13.2
60562,Sacy-le-Grand,1578,0,2306,2306,1.5
62195,Calonne-sur-la-Lys,1578,0,26041,26041,16.5
66177,Saint-Jean-Lasseille,1578,0,21151,21151,13.4
15141,Neussargues en Pinatelle,1577,19360,355,19715,12.5
27412,Terres de Bord,1577,0,46767,46767,29.7
25424,Les Premiers Sapins,1576,0,18617,18617,11.8
38139,Creys-Mépieu,1576,0,8136,8136,5.2
39128,Chaussin,1576,18000,9334,27334,17.3
59203,Erre,1576,0,18951,18951,12
21060,Belleneuve,1575,0,6860,6860,4.4
27008,Alizay,1575,0,46708,46708,29.7
49109,Coron,1575,24646,65446,90092,57.2
60065,Berthecourt,1574,7150,6538,13688,8.7
69074,Denicé,1574,87498,33417,120915,76.8
34180,Nébian,1573,0,1792,1792,1.1
11199,Lavalette,1572,0,10196,10196,6.5
57634,Saulny,1572,0,77941,77941,49.6
67538,Wingen-sur-Moder,1572,27700,42361,70061,44.6
73304,Val-d'Isère,1572,2321495,33398,2354893,1498
11081,Caunes-Minervois,1571,0,10190,10190,6.5
39397,Orgelet,1571,20421,45721,66142,42.1
62908,La Capelle-lès-Boulogne,1571,0,53107,53107,33.8
71371,La Roche-Vineuse,1571,2070,40128,42198,26.9
78520,Richebourg,1571,0,15752,15752,10
86207,La Roche-Posay,1571,0,35755,35755,22.8
88351,Plombières-les-Bains,1571,0,4010,4010,2.6
28223,Luray,1570,0,2100,2100,1.3
41247,Soings-en-Sologne,1570,37991,28850,66841,42.6
56028,Caden,1570,0,11125,11125,7.1
18206,Saint-Éloy-de-Gy,1569,0,11890,11890,7.6
18271,Vasselay,1569,0,11890,11890,7.6
34136,Lézignan-la-Cèbe,1569,0,17427,17427,11.1
6067,Gorbio,1568,0,8800,8800,5.6
35106,Ercé-en-Lamée,1568,55155,22820,77975,49.7
40294,Saugnac-et-Cambran,1568,0,13423,13423,8.6
41061,Cormeray,1568,5524,60095,65619,41.8
14254,Éterville,1567,0,34869,34869,22.3
35292,Saint-Marc-le-Blanc,1567,0,48035,48035,30.7
49132,Étriché,1567,0,11989,11989,7.7
56116,Locmariaquer,1567,0,60634,60634,38.7
24396,Saint-Cyprien,1566,20820,76656,97476,62.2
51105,Cernay-lès-Reims,1566,0,27831,27831,17.8
54113,Champenoux,1566,0,9267,9267,5.9
90026,Chèvremont,1566,4650,54635,59285,37.9
19101,Laguenne-sur-Avalouze,1565,0,29696,29696,19
23093,Gouzon,1565,0,23523,23523,15
25190,Dampierre-les-Bois,1565,0,99070,99070,63.3
35310,Saint-Sauveur-des-Landes,1565,0,19163,19163,12.2
63425,Tallende,1565,0,28054,28054,17.9
12084,Creissels,1564,0,16164,16164,10.3
16070,Chabanais,1564,14975,32178,47153,30.1
30184,Moussac,1564,0,12018,12018,7.7
54286,Labry,1564,0,14522,14522,9.3
59105,Bouvignies,1564,0,26693,26693,17.1
62817,Tilloy-lès-Mofflaines,1564,0,43990,43990,28.1
83096,Pourcieux,1564,0,58597,58597,37.5
2371,Harly,1563,0,223388,223388,142.9
24140,Cours-de-Pile,1563,450,34796,35246,22.6
59528,Saint-Aubert,1563,0,10740,10740,6.9
67150,Furdenheim,1563,23073,29738,52811,33.8
91244,Fontenay-le-Vicomte,1563,0,2297,2297,1.5
27218,Épaignes,1562,0,24054,24054,15.4
54575,Villers-la-Montagne,1562,0,14585,14585,9.3
72046,Le Breil-sur-Mérize,1562,0,29199,29199,18.7
79114,Exireuil,1562,0,8682,8682,5.6
76541,Roumare,1561,5217,1067,6284,4
87192,Solignac,1561,7770,22136,29906,19.2
8298,Montcy-Notre-Dame,1560,0,35835,35835,23
17107,Ciré-d'Aunis,1560,0,64548,64548,41.4
85144,Mesnard-la-Barotière,1560,0,6673,6673,4.3
91332,Leudeville,1560,0,2292,2292,1.5
34119,Hérépian,1559,0,14515,14515,9.3
44140,La Regrippière,1559,16978,16145,33123,21.2
44221,La Chevallerais,1559,0,19835,19835,12.7
54149,Crusnes,1559,0,6869,6869,4.4
56128,Melrand,1559,0,3661,3661,2.3
57600,Roussy-le-Village,1559,0,37955,37955,24.3
89480,Vinneuf,1559,8455,287,8742,5.6
2B043,Brando,1558,0,57137,57137,36.7
56014,Berné,1558,0,49800,49800,32
14243,Équemauville,1557,0,11634,11634,7.5
29025,Cast,1557,0,24539,24539,15.8
35315,Saint-Sulpice-la-Forêt,1557,0,79787,79787,51.2
36127,Montgivray,1557,7910,34201,42111,27
59018,Arnèke,1557,0,9513,9513,6.1
59533,Saint-Hilaire-lez-Cambrai,1557,0,10698,10698,6.9
77070,Chailly-en-Brie,1557,0,6064,6064,3.9
3044,Brugheas,1556,0,42626,42626,27.4
37182,Pernay,1556,0,17270,17270,11.1
54054,Bayon,1556,0,6429,6429,4.1
85293,Tiffauges,1556,0,19937,19937,12.8
88029,La Vôge-les-Bains,1556,0,39129,39129,25.1
12076,Conques-en-Rouergue,1555,0,0,0,0
40002,Amou,1555,0,4222,4222,2.7
68355,Waldighofen,1555,0,41713,41713,26.8
76700,Tôtes,1555,0,12548,12548,8.1
21501,Pouilly-en-Auxois,1554,0,23618,23618,15.2
22281,Saint-Carreuc,1554,11372,24647,36019,23.2
71442,Saint-Léger-sur-Dheune,1554,0,42727,42727,27.5
33425,Saint-Laurent-d'Arce,1553,0,8770,8770,5.6
60539,Rieux,1553,0,2270,2270,1.5
89354,Saint-Martin-du-Tertre,1553,3840,10320,14160,9.1
23079,Felletin,1552,0,58697,58697,37.8
40104,Gamarde-les-Bains,1552,0,24306,24306,15.7
47238,Sainte-Colombe-en-Bruilhois,1552,0,35528,35528,22.9
67197,Hindisheim,1552,22175,28695,50870,32.8
68022,Battenheim,1552,0,108116,108116,69.7
82005,Aucamville,1552,0,20828,20828,13.4
10030,Barberey-Saint-Sulpice,1551,0,22148,22148,14.3
59151,Colleret,1551,0,55325,55325,35.7
85013,Bazoges-en-Paillers,1551,0,12971,12971,8.4
16093,Chazelles,1550,25962,27641,53603,34.6
40155,Linxe,1550,0,12614,12614,8.1
70292,Jussey,1550,0,4693,4693,3
72182,Mansigné,1550,0,7772,7772,5
85061,Château-Guibert,1550,0,32758,32758,21.1
91159,Chevannes,1550,0,2278,2278,1.5
91630,Le Val-Saint-Germain,1550,0,9010,9010,5.8
24082,Carsac-Aillac,1549,11790,5927,17717,11.4
59666,Zegerscappel,1549,0,29833,29833,19.3
69085,Fleurieu-sur-Saône,1549,0,112004,112004,72.3
97361,Awala-Yalimapo,1549,0,7284,7284,4.7
22034,Cavan,1548,0,30752,30752,19.9
29109,Landunvez,1548,0,2788,2788,1.8
64415,Navailles-Angos,1547,45944,24222,70166,45.4
81171,Montans,1547,0,84997,84997,54.9
69168,Rochetaillée-sur-Saône,1546,0,111787,111787,72.3
71346,Perrecy-les-Forges,1546,0,24841,24841,16.1
89399,Soucy,1546,0,10274,10274,6.6
33193,Grayan-et-l'Hôpital,1545,0,1493,1493,1
74062,Charvonnex,1545,0,11934,11934,7.7
1339,Saint-Bernard,1544,0,24454,24454,15.8
17232,Meursac,1544,8262,25721,33983,22
46334,Le Vigan,1544,19830,46206,66036,42.8
29133,Locquirec,1543,0,92517,92517,60
72133,Fillé,1543,0,8264,8264,5.4
74238,Saint-Jean-d'Aulps,1543,128974,107817,236791,153.5
81104,Giroussens,1543,0,84777,84777,54.9
19124,Mansac,1542,0,24610,24610,16
56006,Augan,1542,0,18759,18759,12.2
58102,Donzy,1542,0,30743,30743,19.9
59029,Auchy-lez-Orchies,1542,0,26317,26317,17.1
38114,Clonas-sur-Varèze,1541,0,39393,39393,25.6
44139,Quilly,1541,0,34254,34254,22.2
56198,Rohan,1541,0,10729,10729,7
57716,Vigy,1541,0,3752,3752,2.4
1054,Bourg-Saint-Christophe,1540,0,26282,26282,17.1
1272,Neuville-les-Dames,1540,0,321,321,0.2
64477,Saint-Étienne-de-Baïgorry,1540,0,40018,40018,26
78143,Châteaufort,1540,0,12764,12764,8.3
81046,Cadalen,1540,0,84612,84612,54.9
91568,Saint-Maurice-Montcouronne,1540,0,7104,7104,4.6
3212,Quinssaines,1539,4650,36226,40876,26.6
26079,Charpey,1539,3224,31197,34421,22.4
29119,Lanrivoaré,1539,0,2772,2772,1.8
33106,Castets et Castillon,1539,25450,15738,41188,26.8
37242,Savigny-en-Véron,1539,0,84474,84474,54.9
7005,Alba-la-Romaine,1538,22417,32929,55346,36
15204,Saint-Paul-des-Landes,1538,19930,52110,72040,46.8
68225,Munchhouse,1538,0,26693,26693,17.4
69200,Saint-Forgeux,1538,0,18179,18179,11.8
86024,Béruges,1538,16279,91632,107911,70.2
13006,Aureille,1537,0,2829,2829,1.8
15196,Saint-Mamet-la-Salvetat,1537,32380,13477,45857,29.8
27188,Criquebeuf-sur-Seine,1537,0,45581,45581,29.7
29095,Kersaint-Plabennec,1537,114878,12036,126914,82.6
33183,Gauriaguet,1537,0,8679,8679,5.6
41180,Pontlevoy,1537,4273,28243,32516,21.2
67286,Meistratzheim,1537,8800,31190,39990,26
22321,Saint-Nicolas-du-Pélem,1536,0,141446,141446,92.1
38044,Biol,1536,0,13469,13469,8.8
43165,Rosières,1536,50102,63912,114014,74.2
74001,Abondance,1536,198042,79581,277623,180.7
87040,Châteauneuf-la-Forêt,1536,32440,714,33154,21.6
22299,Saint-Hélen,1535,0,40893,40893,26.6
39411,Perrigny,1535,9800,48375,58175,37.9
38560,Val-de-Virieu,1534,0,13452,13452,8.8
42200,Saint-André-le-Puy,1534,0,27805,27805,18.1
60333,Lachapelle-aux-Pots,1534,6170,12575,18745,12.2
62031,Andres,1534,0,9389,9389,6.1
68304,Sentheim,1534,0,32186,32186,21
89077,Champs-sur-Yonne,1534,9478,30010,39488,25.7
21623,Tart,1533,0,35,35,0
35029,Bonnemain,1533,0,19191,19191,12.5
54040,Badonviller,1533,0,5438,5438,3.5
81128,Lacrouzette,1533,0,14323,14323,9.3
17236,Mirambeau,1532,0,18089,18089,11.8
26358,Upie,1532,9095,31055,40150,26.2
27398,Menneval,1532,0,6605,6605,4.3
91198,D'Huison-Longueville,1532,0,2251,2251,1.5
13017,Boulbon,1531,0,28863,28863,18.9
30270,Saint-Jean-du-Pin,1531,0,47855,47855,31.3
42029,Bussières,1531,0,27751,27751,18.1
61163,La Ferrière-aux-Étangs,1531,22895,41005,63900,41.7
16379,Taponnat-Fleurignac,1530,300,27284,27584,18
33202,Hostens,1530,0,15646,15646,10.2
39056,Bletterans,1530,31932,40666,72598,47.4
12131,La Loubière,1529,0,7572,7572,5
44091,Marsac-sur-Don,1529,0,25644,25644,16.8
31057,Belberaud,1528,0,24913,24913,16.3
33387,Saint-Ciers-d'Abzac,1528,0,29805,29805,19.5
70482,Scey-sur-Saône-et-Saint-Albin,1528,0,3925,3925,2.6
76614,Saint-Martin-de-Boscherville,1528,0,43645,43645,28.6
77363,Le Pin,1528,0,1161,1161,0.8
26118,Épinouze,1527,0,25137,25137,16.5
35057,La Chapelle-Bouëxic,1527,0,13780,13780,9
44193,Saint-Vincent-des-Landes,1527,0,25611,25611,16.8
70334,Marnay,1527,0,1032,1032,0.7
78128,Cernay-la-Ville,1526,0,2973,2973,1.9
85268,Saint-Révérend,1526,0,3320,3320,2.2
86290,La Villedieu-du-Clain,1526,30870,34866,65736,43.1
87059,Le Dorat,1526,46732,25972,72704,47.6
14312,Grandcamp-Maisy,1525,0,10557,10557,6.9
30178,Montfaucon,1525,0,22253,22253,14.6
32242,Masseube,1525,0,17998,17998,11.8
72050,Brûlon,1525,0,13857,13857,9.1
33073,Braud-et-Saint-Louis,1524,0,14205,14205,9.3
35271,Saint-Georges-de-Reintembault,1524,0,18661,18661,12.2
59605,Uxem,1524,0,29352,29352,19.3
67004,Sommerau,1524,3387,107492,110879,72.8
72175,Luché-Pringé,1524,0,7641,7641,5
81238,Saint-Amans-Soult,1524,0,16030,16030,10.5
35118,Gahard,1523,0,32716,32716,21.5
42338,Vougy,1523,53702,39513,93215,61.2
72026,Beaufay,1523,0,28242,28242,18.5
88079,Bulgnéville,1523,0,536,536,0.4
3186,Montmarault,1522,0,54374,54374,35.7
18133,Lunery,1522,0,4242,4242,2.8
10220,Maizières-la-Grande-Paroisse,1521,0,15544,15544,10.2
50493,Saint-Jean-des-Champs,1521,0,36811,36811,24.2
76385,Limésy,1521,0,5080,5080,3.3
21223,Daix,1520,0,44109,44109,29
24266,Mensignac,1520,20248,8489,28737,18.9
30146,Lédignan,1520,0,3159,3159,2.1
33290,Montagne,1520,0,59054,59054,38.9
38466,Saint-Vincent-de-Mercuze,1520,26885,28243,55128,36.3
74127,Féternes,1520,26198,78752,104950,69
80488,Longpré-les-Corps-Saints,1520,0,4637,4637,3.1
57746,Willerwald,1519,0,20759,20759,13.7
74172,Maxilly-sur-Léman,1519,12990,78701,91691,60.4
1069,Certines,1518,0,29347,29347,19.3
41157,Mur-de-Sologne,1518,0,31987,31987,21.1
2B307,Santa-Lucia-di-Moriani,1517,0,10886,10886,7.2
62050,Auchy-lès-Hesdin,1517,0,24018,24018,15.8
72275,Saint-Corneille,1517,0,28358,28358,18.7
56171,Pluherlin,1515,0,10735,10735,7.1
62524,Longfossé,1515,0,4374,4374,2.9
77459,Sourdun,1515,0,5463,5463,3.6
26182,Mirabel-aux-Baronnies,1514,0,77796,77796,51.4
1021,Ars-sur-Formans,1513,0,23963,23963,15.8
22242,Plurien,1513,6590,18261,24851,16.4
14266,Feuguerolles-Bully,1512,0,2674,2674,1.8
52114,Châteauvillain,1512,0,8291,8291,5.5
53210,Saint-Denis-d'Anjou,1512,0,67879,67879,44.9
85120,Landevieille,1512,0,3289,3289,2.2
91274,Gometz-la-Ville,1512,0,6975,6975,4.6
28013,Aunay-sous-Auneau,1511,0,8768,8768,5.8
61063,Briouze,1511,33256,40469,73725,48.8
88136,Dogneville,1511,0,37998,37998,25.1
36200,Saint-Marcel,1510,0,11087,11087,7.3
38152,Eclose-Badinières,1510,0,18348,18348,12.2
67263,Lembach,1510,3225,36536,39761,26.3
68084,Eschentzwiller,1510,0,105190,105190,69.7
68177,Lautenbach,1510,0,37263,37263,24.7
73250,Saint-Julien-Mont-Denis,1510,47020,40550,87570,58
79257,Saint-Hilaire-la-Palud,1510,0,20351,20351,13.5
16120,Dirac,1509,0,39231,39231,26
47246,Saint-Hilaire-de-Lusignan,1509,0,34544,34544,22.9
80798,Villers-Bocage,1509,0,5882,5882,3.9
17483,Yves,1508,0,41847,41847,27.8
37111,Genillé,1508,9191,26177,35368,23.5
25285,Grand'Combe-Châteleu,1507,0,17939,17939,11.9
38415,Saint-Marcel-Bel-Accueil,1507,0,7780,7780,5.2
29296,Tréméoc,1506,0,56525,56525,37.5
38068,Champagnier,1506,13065,58177,71242,47.3
62181,Bucquoy,1506,0,7488,7488,5
17453,Trizay,1505,8430,38336,46766,31.1
21473,Ouges,1505,0,43674,43674,29
85111,L'Île-d'Elle,1505,0,31807,31807,21.1
5133,Saint-Chaffrey,1504,0,107291,107291,71.3
7340,Veyras,1504,0,5018,5018,3.3
45092,Chevillon-sur-Huillard,1504,0,20262,20262,13.5
50209,Gonneville-Le Theil,1504,6420,47308,53728,35.7
51171,Cormicy,1504,0,26729,26729,17.8
67285,Matzenheim,1504,7939,27807,35746,23.8
69055,Les Chères,1504,0,13554,13554,9
77529,Voulangis,1504,4050,5857,9907,6.6
83149,Villecroze,1504,0,5859,5859,3.9
85292,Rives-du-Fougerais,1504,61895,32863,94758,63
1183,Guéreins,1503,0,7758,7758,5.2
17311,Saint-Augustin,1503,7050,23670,30720,20.4
25195,Dannemarie-sur-Crète,1503,16660,26482,43142,28.7
38536,Vernioz,1503,0,38422,38422,25.6
54060,Belleville,1503,0,16422,16422,10.9
58067,Chaulgnes,1503,8210,84827,93037,61.9
7309,Satillieu,1502,12318,4246,16564,11
83079,La Môle,1502,0,12036,12036,8
30273,Saint-Julien-de-Peyrolas,1501,0,21903,21903,14.6
74020,Armoy,1501,8527,65348,73875,49.2
89439,Vergigny,1501,8774,9699,18473,12.3
28122,Dammarie,1500,0,43708,43708,29.1
74239,Saint-Jean-de-Sixt,1500,289857,76196,366053,244
35181,Le Minihic-sur-Rance,1499,0,50010,50010,33.4
76448,Montmain,1499,0,42817,42817,28.6
17340,Saint-Pierre-La-Noue,1498,5620,61983,67603,45.1
21273,Fleurey-sur-Ouche,1498,0,8425,8425,5.6
24182,Le Fleix,1498,30384,33349,63733,42.5
25558,Tarcenay-Foucherans,1498,0,10916,10916,7.3
40207,Oeyreluy,1498,0,12824,12824,8.6
47021,Barbaste,1498,0,7263,7263,4.8
74138,Gruffy,1497,0,11564,11564,7.7
77135,Courpalay,1497,0,7608,7608,5.1
79307,Sauzé-Vaussais,1497,0,43234,43234,28.9
4145,Peipin,1496,14255,32949,47204,31.6
7132,Largentière,1496,42541,23569,66110,44.2
42081,Cuzieu,1496,4480,27116,31596,21.1
62852,Vieille-Église,1496,0,11354,11354,7.6
69151,Le Perréon,1496,13120,31761,44881,30
72169,Louplande,1496,5340,8013,13353,8.9
76616,Saint-Martin-du-Manoir,1496,0,13494,13494,9
54332,Maidières,1495,0,16334,16334,10.9
60404,Mogneville,1495,0,626,626,0.4
88470,Le Tholy,1495,0,2516,2516,1.7
38054,Bouvesse-Quirieu,1493,0,7708,7708,5.2
56047,Crédin,1493,0,10395,10395,7
62727,Ruitz,1493,0,24638,24638,16.5
19038,Chameyrat,1492,0,28311,28311,19
63273,Pérignat-sur-Allier,1492,0,14311,14311,9.6
76596,Saint-Laurent-de-Brèvedent,1492,0,13458,13458,9
25022,Arcey,1491,0,3439,3439,2.3
58278,Sermoise-sur-Loire,1490,0,80141,80141,53.8
88115,Corcieux,1490,0,14487,14487,9.7
21005,Aiserey,1489,0,34,34,0
64527,Souraïde,1489,17450,38693,56143,37.7
85140,La Meilleraie-Tillay,1489,0,40468,40468,27.2
71295,Mervans,1488,0,2782,2782,1.9
73085,Chindrieux,1488,4420,8232,12652,8.5
2237,Crécy-sur-Serre,1487,0,7491,7491,5
3200,Neuvy,1487,3950,20016,23966,16.1
41029,Candé-sur-Beuvron,1487,0,56991,56991,38.3
63271,Paslières,1487,0,34477,34477,23.2
64485,Saint-Jean-Pied-de-Port,1487,0,38641,38641,26
29193,Plougourvest,1486,152721,10975,163696,110.2
37216,Saint-Épain,1486,0,40320,40320,27.1
47159,Le Mas-d'Agenais,1486,0,15374,15374,10.3
50403,Pirou,1486,0,31049,31049,20.9
61196,Belforêt-en-Perche,1486,0,17253,17253,11.6
67098,Dinsheim-sur-Bruche,1486,45190,3829,49019,33
67234,Keskastel,1486,34259,18629,52888,35.6
70455,Roye,1486,0,65321,65321,44
7008,Alissas,1485,0,4955,4955,3.3
17346,Saint-Hippolyte,1485,44543,24454,68997,46.5
38304,Pierre-Châtel,1485,34390,15549,49939,33.6
51210,Dizy,1485,0,3671,3671,2.5
33378,Saint-Avit-Saint-Nazaire,1484,0,11202,11202,7.5
38467,Salagnon,1484,0,7661,7661,5.2
42311,La Tour-en-Jarez,1484,0,34771,34771,23.4
56261,La Vraie-Croix,1484,40897,10515,51412,34.6
62045,Aubigny-en-Artois,1484,0,12331,12331,8.3
74140,Habère-Poche,1484,23882,23841,47723,32.2
80625,Trois-Rivières,1484,0,1791,1791,1.2
2A085,Cauro,1483,10800,1111,11911,8
33355,Rions,1483,0,45474,45474,30.7
34139,Lieuran-lès-Béziers,1483,0,8591,8591,5.8
40227,Pissos,1483,0,11669,11669,7.9
43002,Aiguilhe,1483,7500,61707,69207,46.7
45332,Varennes-Changy,1483,0,15206,15206,10.3
86121,Latillé,1483,18095,77067,95162,64.2
8486,Vireux-Molhain,1482,0,9515,9515,6.4
28018,Authon-du-Perche,1482,0,577,577,0.4
38162,Faverges-de-la-Tour,1482,0,12996,12996,8.8
45025,Bazoches-les-Gallerandes,1482,0,5391,5391,3.6
77264,Lumigny-Nesles-Ormeaux,1482,0,7532,7532,5.1
46015,Bagnac-sur-Célé,1481,0,43735,43735,29.5
67414,Rothau,1481,1919,107176,109095,73.7
90089,Rougemont-le-Château,1481,8953,44114,53067,35.8
56021,Brandérion,1480,0,33474,33474,22.6
97131,Terre-de-Haut,1479,0,6670,6670,4.5
24010,Annesse-et-Beaulieu,1478,7500,8254,15754,10.7
56129,Ménéac,1478,0,22257,22257,15.1
62390,Groffliers,1478,0,15724,15724,10.6
11255,Montredon-des-Corbières,1477,39750,22841,62591,42.4
29108,Landudec,1477,112717,47310,160027,108.3
45062,Cercottes,1477,0,2083,2083,1.4
49140,Fontevraud-l'Abbaye,1477,0,14390,14390,9.7
49339,Soulaire-et-Bourg,1477,10961,23910,34871,23.6
52534,Villiers-en-Lieu,1477,0,13377,13377,9.1
60042,Bailleval,1477,8987,619,9606,6.5
6121,Saint-Jean-Cap-Ferrat,1476,0,29059,29059,19.7
56146,Neulliac,1476,0,10277,10277,7
67500,Urmatt,1476,74074,106815,180889,122.6
56131,Meslan,1475,0,47147,47147,32
74025,Ballaison,1475,0,64217,64217,43.5
77323,Moussy-le-Vieux,1475,0,18292,18292,12.4
82062,Finhan,1475,0,19794,19794,13.4
88531,Xonrupt-Longemer,1475,0,2482,2482,1.7
11014,Armissan,1474,0,22795,22795,15.5
14057,Bellengreville,1474,0,11863,11863,8
28173,Gasville-Oisème,1474,0,42950,42950,29.1
57021,Ancy-Dornot,1474,0,8800,8800,6
22228,Plounévez-Moëdec,1473,0,29262,29262,19.9
37058,La Chapelle-sur-Loire,1472,14050,13655,27705,18.8
38450,Saint-Quentin-sur-Isère,1472,0,23788,23788,16.2
59289,Haussy,1472,0,371,371,0.3
59613,Vicq,1472,0,28357,28357,19.3
82027,Campsas,1472,0,19754,19754,13.4
27367,Lieurey,1471,0,22653,22653,15.4
43236,La Séauve-sur-Semène,1471,69506,22895,92401,62.8
71182,Dracy-le-Fort,1471,5072,40445,45517,30.9
17075,Cabariot,1470,8290,24207,32497,22.1
31589,Villenouvelle,1470,0,7170,7170,4.9
77125,Condé-Sainte-Libiaire,1470,0,5725,5725,3.9
82017,Bessens,1470,0,19727,19727,13.4
38051,Bougé-Chambalud,1469,0,37553,37553,25.6
3297,Vallon-en-Sully,1468,0,2052,2052,1.4
22349,Trédrez-Locquémeau,1468,0,29163,29163,19.9
38410,Saint-Lattier,1468,0,23724,23724,16.2
58051,Challuy,1468,0,78958,78958,53.8
74090,Cornier,1468,28550,10700,39250,26.7
76018,Val-de-Saâne,1468,0,11846,11846,8.1
91047,Baulne,1468,0,2157,2157,1.5
22287,Saint-Donan,1467,0,23267,23267,15.9
57742,Walscheid,1467,0,9551,9551,6.5
67127,Ergersheim,1467,71934,3780,75714,51.6
80635,Pont-Remy,1467,0,36326,36326,24.8
29227,Poullaouen,1466,14148,49577,63725,43.5
39043,Beaufort-Orbagna,1466,9050,22354,31404,21.4
43267,Vorey,1466,36488,60999,97487,66.5
59419,Mouchin,1466,0,25020,25020,17.1
67031,Bernardswiller,1466,5760,29749,35509,24.2
89344,Saint-Fargeau,1466,0,66195,66195,45.2
38019,Auberives-sur-Varèze,1465,0,37451,37451,25.6
50363,Moyon Villages,1465,0,21668,21668,14.8
85026,La Boissière-des-Landes,1465,0,29413,29413,20.1
7255,Saint-Julien-en-Saint-Alban,1464,0,4885,4885,3.3
12083,Cransac,1464,0,14711,14711,10
15153,Pleaux,1464,45770,24239,70009,47.8
40118,Habas,1464,0,10895,10895,7.4
57250,Goetzenbruck,1464,0,33740,33740,23
59348,Lieu-Saint-Amand,1464,0,55077,55077,37.6
65375,Rabastens-de-Bigorre,1464,0,33070,33070,22.6
68113,Guémar,1464,37810,3500,41310,28.2
76718,Valliquerville,1464,0,2708,2708,1.8
82108,Meauzac,1464,0,7464,7464,5.1
83083,Montfort-sur-Argens,1464,0,54850,54850,37.5
28278,Nogent-le-Phaye,1463,0,42630,42630,29.1
37150,Mazières-de-Touraine,1463,11000,13571,24571,16.8
38242,Monestier-de-Clermont,1463,0,40985,40985,28
51344,Mardeuil,1463,0,29074,29074,19.9
82038,Caylus,1463,0,20690,20690,14.1
97219,Le Prêcheur,1463,7500,13246,20746,14.2
38084,Charnècles,1462,0,24837,24837,17
49374,Villebernier,1462,0,14244,14244,9.7
61061,Bretoncelles,1462,18778,17132,35910,24.6
78562,Saint-Léger-en-Yvelines,1462,0,2848,2848,1.9
11068,Capendu,1461,0,9476,9476,6.5
25526,Sainte-Suzanne,1461,0,92487,92487,63.3
42318,Usson-en-Forez,1461,0,13090,13090,9
85131,Les Magnils-Reigniers,1461,0,30877,30877,21.1
29226,Poullan-sur-Mer,1460,65517,46314,111831,76.6
39101,Champvans,1460,7393,29632,37025,25.4
57543,Pierrevillers,1460,0,366,366,0.3
89382,Seignelay,1460,19100,9434,28534,19.5
1211,Lent,1459,0,28206,28206,19.3
1398,Savigneux,1459,0,23108,23108,15.8
17158,Ferrières,1459,4472,21257,25729,17.6
59226,Felleries,1459,0,11558,11558,7.9
74102,Dingy-Saint-Clair,1459,38515,74113,112628,77.2
76557,Saint-Arnoult,1459,0,11119,11119,7.6
41229,Saint-Romain-sur-Cher,1458,14943,26792,41735,28.6
42228,Saint-Georges-Haute-Ville,1458,0,13063,13063,9
56011,Béganne,1458,0,20800,20800,14.3
58104,Dornes,1458,0,19626,19626,13.5
72016,Auvers-le-Hamon,1458,0,33908,33908,23.3
33339,Prignac-et-Marcamps,1457,0,8228,8228,5.6
35169,Maxent,1457,0,25641,25641,17.6
36142,Niherne,1457,0,2308,2308,1.6
40257,Sainte-Eulalie-en-Born,1457,0,39763,39763,27.3
42204,Saint-Bonnet-le-Château,1457,65452,13054,78506,53.9
54490,Saizerais,1457,0,14030,14030,9.6
61038,Bellême,1457,29589,16916,46505,31.9
77216,Grez-sur-Loing,1457,0,745,745,0.5
9207,Montgailhard,1456,0,39134,39134,26.9
78048,Bazainville,1456,5850,14599,20449,14
83025,Brue-Auriac,1456,0,14934,14934,10.3
2298,Étreux,1455,0,8021,8021,5.5
22137,Maël-Carhaix,1455,0,133987,133987,92.1
43265,Les Villettes,1455,37323,131394,168717,116
47167,Mézin,1455,0,7054,7054,4.8
50579,Sottevast,1455,0,45766,45766,31.5
57767,Stuckange,1455,0,9323,9323,6.4
4039,Castellane,1454,69750,51413,121163,83.3
14659,Saint-Sylvain,1454,0,11702,11702,8
38448,Saint-Prim,1454,0,37169,37169,25.6
44118,Pannecé,1454,6902,17764,24666,17
45122,Dampierre-en-Burly,1454,0,8516,8516,5.9
49231,Nuaillé,1454,10887,60418,71305,49
51075,Bourgogne-Fresne,1454,0,25840,25840,17.8
59110,Brouckerque,1454,0,28004,28004,19.3
72172,Le Luart,1454,0,8871,8871,6.1
26041,Beausemblant,1453,15730,23919,39649,27.3
37110,Francueil,1453,0,32695,32695,22.5
59038,Avesnes-le-Sec,1453,0,54663,54663,37.6
55154,Dieue-sur-Meuse,1452,0,9242,9242,6.4
63212,Marsat,1452,0,10981,10981,7.6
40326,Vielle-Saint-Girons,1451,0,11808,11808,8.1
50541,Saint-Planchers,1451,0,35117,35117,24.2
91634,Vaugrigneuse,1451,0,6693,6693,4.6
26326,Saint-Restitut,1450,0,22418,22418,15.5
42065,Civens,1450,8450,26283,34733,24
57460,Merten,1450,0,8733,8733,6
74033,Bernex,1450,74481,75126,149607,103.2
88463,Taintrux,1450,0,14098,14098,9.7
28394,Tréon,1448,0,1937,1937,1.3
49120,Denée,1448,14736,28746,43482,30
59313,Hordain,1448,0,54475,54475,37.6
80261,Dury,1448,0,92833,92833,64.1
14249,Esquay-Notre-Dame,1447,0,2559,2559,1.8
2A269,Sari-Solenzara,1447,0,33744,33744,23.3
42181,Régny,1447,3354,41021,44375,30.7
71542,Toulon-sur-Arroux,1447,0,7439,7439,5.1
82094,Lauzerte,1447,0,45305,45305,31.3
12216,Saint-Côme-d'Olt,1446,0,7161,7161,5
37118,Huismes,1446,0,79370,79370,54.9
45134,Épieds-en-Beauce,1446,0,5958,5958,4.1
56219,Saint-Guyomard,1446,0,17592,17592,12.2
22098,Landéhen,1445,4405,17441,21846,15.1
59180,Le Doulieu,1445,0,8828,8828,6.1
59384,Maroilles,1445,0,4078,4078,2.8
63038,Besse-et-Saint-Anastaise,1445,0,10549,10549,7.3
67008,Altorf,1445,79661,3723,83384,57.7
12148,Montbazens,1444,0,24803,24803,17.2
83135,Tavernes,1444,0,14811,14811,10.3
54043,Bainville-sur-Madon,1443,0,14695,14695,10.2
10233,Méry-sur-Seine,1442,0,1483,1483,1
23001,Ahun,1442,0,45214,45214,31.4
17059,Bourgneuf,1441,0,39988,39988,27.8
45222,Nargis,1441,0,14134,14134,9.8
59228,Férin,1441,0,20078,20078,13.9
66222,Vernet-les-Bains,1441,0,43158,43158,30
68069,Dessenheim,1441,0,25010,25010,17.4
3197,Neuilly-le-Réal,1440,0,19384,19384,13.5
22177,Pléguien,1440,0,29163,29163,20.3
29002,Arzano,1440,0,49473,49473,34.4
31563,Vacquiers,1440,0,2893,2893,2
42048,Chandon,1440,0,37359,37359,25.9
53211,Saint-Denis-de-Gastines,1440,0,6544,6544,4.5
70006,Aillevillers-et-Lyaumont,1440,0,9151,9151,6.4
90056,Joncherey,1439,0,8558,8558,5.9
50273,Montsenelle,1438,0,30046,30046,20.9
51329,Loivre,1438,0,25556,25556,17.8
68139,Hirtzbach,1438,7484,38575,46059,32
49155,Grez-Neuville,1437,16380,41646,58026,40.4
61342,Rai,1437,46828,14813,61641,42.9
70428,Pusey,1437,0,74335,74335,51.7
1075,Chaleins,1436,0,7412,7412,5.2
27385,Manneville-sur-Risle,1436,0,32437,32437,22.6
60350,Lassigny,1436,44900,12554,57454,40
35082,Coësmes,1435,0,27935,27935,19.5
59269,Gouzeaucourt,1434,0,18639,18639,13
71204,Fragnes-La Loyère,1434,0,39428,39428,27.5
79057,Brioux-sur-Boutonne,1434,0,41414,41414,28.9
83011,Bargemon,1434,0,17863,17863,12.5
84076,Mirabeau,1434,0,6434,6434,4.5
5183,Villar-Saint-Pancrace,1433,0,102226,102226,71.3
23192,Fursac,1433,0,7936,7936,5.5
67087,Dauendorf,1433,0,17424,17424,12.2
72118,Dollon,1433,0,19373,19373,13.5
84104,Sablet,1433,0,1676,1676,1.2
6025,Le Broc,1432,0,28193,28193,19.7
24376,Saint Aulaye-Puymangou,1432,35239,5008,40247,28.1
59502,Rieux-en-Cambrésis,1432,0,18613,18613,13
62073,Bailleul-Sir-Berthoult,1432,0,40277,40277,28.1
78616,Thoiry,1432,16770,618,17388,12.1
27301,Grossœuvre,1431,0,16830,16830,11.8
38226,Mens,1431,0,40088,40088,28
57350,Jouy-aux-Arches,1431,0,8543,8543,6
60587,Saint-Martin-Longueau,1431,0,2091,2091,1.5
63198,Loubeyrat,1431,0,9440,9440,6.6
77078,Chamigny,1431,0,5573,5573,3.9
7227,Saint-Cyr,1430,0,7367,7367,5.2
24226,Lamothe-Montravel,1430,0,4983,4983,3.5
34014,Assas,1430,0,26645,26645,18.6
47146,Lédat,1430,0,10959,10959,7.7
54135,Colombey-les-Belles,1430,0,47412,47412,33.2
56223,Saint-Jean-la-Poterie,1430,0,20401,20401,14.3
22076,Hénanbihen,1429,13931,17248,31179,21.8
25254,Les Fourgs,1429,0,85105,85105,59.6
25368,Marchaux-Chaudefontaine,1429,8100,25178,33278,23.3
42015,Belmont-de-la-Loire,1429,61755,37074,98829,69.2
46038,Bretenoux,1429,31130,46622,77752,54.4
39154,Clairvaux-les-Lacs,1428,30795,41559,72354,50.7
55117,Clermont-en-Argonne,1428,0,14930,14930,10.5
58193,Neuvy-sur-Loire,1428,0,28470,28470,19.9
62408,Hames-Boucres,1428,0,42920,42920,30.1
67119,Eckwersheim,1428,2680,554749,557429,390.4
6092,Peillon,1427,0,40239,40239,28.2
29086,Irvillac,1427,0,11060,11060,7.8
57003,Abreschviller,1427,0,9290,9290,6.5
57390,Lemberg,1427,0,32888,32888,23
26125,Eurre,1426,0,17273,17273,12.1
32319,Plaisance,1426,0,26288,26288,18.4
41080,Faverolles-sur-Cher,1426,12940,26204,39144,27.5
43132,Mazeyrat-d'Allier,1426,22505,12985,35490,24.9
50554,Saint-Senier-sous-Avranches,1426,0,35086,35086,24.6
60387,Marseille-en-Beauvaisis,1426,0,6996,6996,4.9
68305,Seppois-le-Bas,1426,0,20305,20305,14.2
2383,Homblières,1425,0,203664,203664,142.9
40244,Rivière-Saas-et-Gourby,1425,0,12199,12199,8.6
51492,Saint-Just-Sauvage,1425,0,18594,18594,13
59089,Bollezeele,1425,0,27445,27445,19.3
69099,Haute-Rivoire,1425,33963,71424,105387,74
70561,Villersexel,1425,14710,451,15161,10.6
11430,Villeneuve-la-Comptal,1424,0,12513,12513,8.8
41296,Vouzon,1424,11865,11692,23557,16.5
17109,Clavette,1423,1900,39488,41388,29.1
35104,Epiniac,1423,0,12101,12101,8.5
42284,Saint-Romain-la-Motte,1423,19690,41992,61682,43.3
56022,Brandivy,1423,0,13164,13164,9.3
56188,Quistinic,1423,0,32185,32185,22.6
19036,Chamberet,1422,0,24759,24759,17.4
59423,Neuf-Berquin,1422,0,8688,8688,6.1
59520,Rumilly-en-Cambrésis,1422,0,18483,18483,13
6026,Cabris,1421,0,36281,36281,25.5
26289,Saillans,1421,22150,38624,60774,42.8
42193,Rozier-en-Donzy,1421,25850,25757,51607,36.3
48039,Chanac,1421,75271,50459,125730,88.5
79235,Saint-Amand-sur-Sèvre,1421,0,40423,40423,28.4
80062,Beaucamps-le-Vieux,1421,0,1962,1962,1.4
29081,Huelgoat,1420,0,73824,73824,52
90068,Meroux-Moval,1420,8524,49541,58065,40.9
2128,Bruyères-et-Montbérault,1419,0,54191,54191,38.2
21461,Nolay,1419,0,6171,6171,4.3
27193,Croth,1419,0,16689,16689,11.8
60689,Villers-sur-Coudun,1419,0,12406,12406,8.7
6138,Théoule-sur-Mer,1418,0,6889,6889,4.9
29093,Kernilis,1418,27709,35730,63439,44.7
30339,Val-d'Aigoual,1418,0,70934,70934,50
34173,Montpeyroux,1418,0,7659,7659,5.4
80702,Saint-Fuscien,1418,0,90910,90910,64.1
81115,Labastide-Rouairoux,1418,0,12242,12242,8.6
84084,La Motte-d'Aigues,1418,0,6362,6362,4.5
86081,Colombiers,1418,0,32273,32273,22.8
1213,Leyment,1417,0,24183,24183,17.1
10287,Piney,1417,0,5270,5270,3.7
26054,Bouchet,1417,0,21908,21908,15.5
37183,Perrusson,1417,9110,24597,33707,23.8
58152,Magny-Cours,1417,20420,5295,25715,18.1
63206,Manzat,1417,0,9348,9348,6.6
78192,Dammartin-en-Serve,1417,3355,14208,17563,12.4
24329,Le Pizou,1416,13125,10762,23887,16.9
45031,Bellegarde,1416,0,14519,14519,10.3
57535,Petit-Réderching,1416,0,32634,32634,23
63080,Champeix,1416,0,9205,9205,6.5
67340,Oberbronn,1416,0,51856,51856,36.6
84107,Saint-Christol,1416,0,22973,22973,16.2
14150,Cesny-les-Sources,1415,0,42778,42778,30.2
35098,La Dominelais,1414,0,20579,20579,14.6
37249,Sonzay,1414,37050,15694,52744,37.3
45130,Dry,1414,0,5826,5826,4.1
17307,Sablonceaux,1413,10931,22253,33184,23.5
50349,Montmartin-sur-Mer,1413,0,40884,40884,28.9
58273,Sauvigny-les-Bois,1413,0,5280,5280,3.7
67433,Sand,1413,5439,26125,31564,22.3
71340,Palinges,1413,0,5478,5478,3.9
18160,Nérondes,1412,8800,2762,11562,8.2
22061,Glomel,1412,0,130027,130027,92.1
31161,Deyme,1412,0,23021,23021,16.3
54089,Bouxières-aux-Chênes,1412,0,8356,8356,5.9
72359,Torcé-en-Vallée,1412,0,26395,26395,18.7
17413,Saint-Vivien,1411,0,39155,39155,27.7
59555,Sars-Poteries,1411,0,11177,11177,7.9
18233,Saint-Satur,1410,24250,25402,49652,35.2
51291,Hermonville,1409,0,25041,25041,17.8
14120,Cahagnes,1408,0,52211,52211,37.1
67049,Blaesheim,1408,8316,546979,555295,394.4
85010,Avrillé,1408,0,28268,28268,20.1
71212,Génelard,1407,0,22608,22608,16.1
4001,Aiglun,1406,0,58932,58932,41.9
34036,Le Bosc,1406,0,15791,15791,11.2
67105,Drulingen,1406,11566,17626,29192,20.8
17315,Saint-Christophe,1405,0,38989,38989,27.8
24289,Montcaret,1405,6550,4896,11446,8.1
37205,Saché,1405,0,22365,22365,15.9
77318,Mortcerf,1405,0,7140,7140,5.1
21535,Ruffey-lès-Echirey,1404,0,34,34,0
27017,Angerville-la-Campagne,1404,0,16512,16512,11.8
34089,Creissan,1404,0,7938,7938,5.7
35351,Le Verger,1404,0,71947,71947,51.2
59487,Radinghem-en-Weppes,1404,0,23250,23250,16.6
62606,Neuve-Chapelle,1404,0,23169,23169,16.5
79300,Sainte-Verge,1404,0,21845,21845,15.6
22239,Plumaudan,1403,0,37376,37376,26.6
33205,Illats,1403,0,43021,43021,30.7
59382,Maretz,1403,0,9640,9640,6.9
4079,L'Escale,1402,0,58765,58765,41.9
33023,Ayguemorte-les-Graves,1402,0,12662,12662,9
56079,Guillac,1402,0,21112,21112,15.1
60129,Carlepont,1402,0,0,0,0
16026,Balzac,1401,0,36424,36424,26
59670,Don,1401,0,23200,23200,16.6
74167,Val de Chaise,1401,0,11552,11552,8.2
11332,Saint-André-de-Roquelongue,1400,0,18968,18968,13.5
60695,Vineuil-Saint-Firmin,1399,0,28038,28038,20
68072,Dietwiller,1399,0,97457,97457,69.7
30182,Montpezat,1398,0,103996,103996,74.4
37081,Cléré-les-Pins,1398,0,12968,12968,9.3
76014,Angerville-l'Orcher,1398,0,12610,12610,9
77086,La Chapelle-Gauthier,1398,0,17998,17998,12.9
79326,Thénezay,1398,0,36653,36653,26.2
66015,Banyuls-dels-Aspres,1397,0,18725,18725,13.4
7205,Saint-Alban-d'Ay,1396,2493,3947,6440,4.6
10282,Payns,1396,0,19935,19935,14.3
38104,Chimilin,1396,0,12242,12242,8.8
40132,Labatut,1396,0,10389,10389,7.4
45261,Rebréchien,1396,0,4302,4302,3.1
49284,Saint-Germain-des-Prés,1396,15400,27714,43114,30.9
56200,Ruffiac,1396,0,16983,16983,12.2
60233,Feuquières,1396,0,6849,6849,4.9
61466,La Selle-la-Forge,1396,12423,37389,49812,35.7
79289,Saint-Pierre-des-Échaubrognes,1396,0,39711,39711,28.4
89414,Thorigny-sur-Oreuse,1396,8110,257,8367,6
25380,Métabief,1395,0,83080,83080,59.6
40125,Heugas,1395,0,11942,11942,8.6
42134,Marcilly-le-Châtel,1395,0,12499,12499,9
90041,Étueffont,1395,0,41552,41552,29.8
25394,Montenois,1394,0,88245,88245,63.3
45178,Ladon,1394,0,14293,14293,10.3
62383,Gouy-sous-Bellonne,1394,20840,1734,22574,16.2
69153,Poleymieux-au-Mont-d'Or,1394,0,100796,100796,72.3
80240,Doingt,1394,0,9987,9987,7.2
16058,Boutiers-Saint-Trojan,1393,4710,52120,56830,40.8
35145,Langon,1393,0,19873,19873,14.3
59434,Nivelle,1393,0,52406,52406,37.6
62279,Duisans,1393,0,11575,11575,8.3
62360,Fréthun,1393,0,41868,41868,30.1
62718,Rœux,1393,0,39180,39180,28.1
69139,Montrottier,1393,7370,69820,77190,55.4
71585,Virey-le-Grand,1393,0,38300,38300,27.5
76354,Hénouville,1393,0,39789,39789,28.6
9289,Lorp-Sentaraille,1392,0,168682,168682,121.2
38540,Veurey-Voroize,1392,0,53773,53773,38.6
53124,Prée-d'Anjou,1392,0,62492,62492,44.9
57222,Folkling,1392,0,25448,25448,18.3
74032,Bellevaux,1392,121621,97266,218887,157.2
1447,Villereversure,1391,0,26891,26891,19.3
6117,Saint-Blaise,1391,0,27386,27386,19.7
33259,Lugon-et-l'Île-du-Carnay,1391,0,20937,20937,15.1
54188,Faulx,1391,0,13394,13394,9.6
63211,Marsac-en-Livradois,1391,15637,12570,28207,20.3
87158,Saint-Laurent-sur-Gorre,1391,7350,612,7962,5.7
4111,Mane,1390,3070,3663,6733,4.8
30174,Montaren-et-Saint-Médiers,1390,0,10681,10681,7.7
59602,Tressin,1390,0,23018,23018,16.6
1422,Tossiat,1389,0,26853,26853,19.3
11005,Alairac,1389,29550,9009,38559,27.8
18032,Boulleret,1389,0,25024,25024,18
33544,Le Verdon-sur-Mer,1389,0,1342,1342,1
34076,Ceyras,1389,0,1583,1583,1.1
62452,Heuringhem,1389,0,123621,123621,89
3165,Le Mayet-de-Montagne,1388,0,38024,38024,27.4
7343,Vinezac,1388,3548,23691,27239,19.6
15221,Sansac-de-Marmiesse,1388,19380,47028,66408,47.8
38188,Herbeys,1388,0,53619,53619,38.6
71448,Saint-Martin-Belle-Roche,1388,0,35454,35454,25.5
8346,Prix-lès-Mézières,1387,0,31861,31861,23
25170,Courcelles-lès-Montbéliard,1387,0,87802,87802,63.3
43018,Bains,1387,59117,57712,116829,84.2
67451,Schleithal,1387,5820,152824,158644,114.4
89151,Égriselles-le-Bocage,1387,4480,4920,9400,6.8
61243,Magny-le-Désert,1386,25724,6235,31959,23.1
37059,Charentilly,1385,44589,15372,59961,43.3
45200,Ménestreau-en-Villette,1385,0,11949,11949,8.6
59293,Haverskerque,1385,0,22734,22734,16.4
59579,Steene,1385,0,26675,26675,19.3
81170,Monestiés,1385,13350,31686,45036,32.5
3025,Bessay-sur-Allier,1384,0,18630,18630,13.5
9268,Saint-Lizier,1384,0,167712,167712,121.2
35132,Hirel,1384,0,32814,32814,23.7
53175,Parné-sur-Roc,1384,0,60232,60232,43.5
82135,Nohic,1384,0,18573,18573,13.4
1241,Meillonnas,1383,0,26737,26737,19.3
19194,Saint-Clément,1383,7225,26243,33468,24.2
26311,Saint-Laurent-en-Royans,1383,16481,86617,103098,74.5
57351,Jury,1383,0,68570,68570,49.6
67055,Boofzheim,1383,0,25570,25570,18.5
72364,Vaas,1383,0,6934,6934,5
72378,Vion,1383,0,32164,32164,23.3
77510,Villeneuve-Saint-Denis,1383,0,39319,39319,28.4
1290,Pérouges,1382,0,23586,23586,17.1
22059,Le Fœil,1382,0,21919,21919,15.9
33095,Captieux,1382,0,459,459,0.3
67325,Niederhaslach,1382,28051,3561,31612,22.9
69162,Quincié-en-Beaujolais,1382,19043,0,19043,13.8
85198,Saint-Aubin-des-Ormeaux,1382,0,17708,17708,12.8
85259,Saint-Paul-en-Pareds,1382,0,5912,5912,4.3
38409,Saint-Just-de-Claix,1381,0,22318,22318,16.2
44076,Jans,1381,0,23162,23162,16.8
53219,Saint-Georges-Buttavent,1381,0,51319,51319,37.2
67338,Obenheim,1381,1830,25533,27363,19.8
67359,Ohlungen,1381,0,16792,16792,12.2
77199,Fublaines,1381,0,18833,18833,13.6
7157,Meysse,1380,0,29546,29546,21.4
17147,Écoyeux,1380,11645,43737,55382,40.1
22116,Lanrodec,1380,0,27948,27948,20.3
55288,Lérouville,1380,0,5569,5569,4
68320,Spechbach,1380,0,37019,37019,26.8
76179,Clères,1380,0,943,943,0.7
6127,Saint-Martin-Vésubie,1379,0,27150,27150,19.7
26038,Beaumont-Monteux,1379,35306,60677,95983,69.6
38528,Vaulnaveys-le-Bas,1379,0,53271,53271,38.6
56076,Guern,1379,0,9601,9601,7
88423,Saint-Léonard,1379,0,13407,13407,9.7
7265,Saint-Marcel-lès-Annonay,1378,9975,7099,17074,12.4
32027,Barcelonne-du-Gers,1378,0,43138,43138,31.3
48132,Saint-Alban-sur-Limagnole,1378,23323,14155,37478,27.2
60643,Tricot,1378,0,7635,7635,5.5
69031,Brussieu,1378,15844,69068,84912,61.6
17136,Croix-Chapeau,1377,0,38212,38212,27.8
37143,Manthelan,1377,12430,23903,36333,26.4
70248,Frahier-et-Chatebier,1377,0,2333,2333,1.7
81315,Vielmur-sur-Agout,1377,0,20595,20595,15
7116,Labégude,1376,10650,23486,34136,24.8
21412,Meursault,1376,0,5984,5984,4.3
30336,Vallabrègues,1376,0,9630,9630,7
35246,Roz-Landrieux,1376,0,11701,11701,8.5
35283,Saint-Jean-sur-Vilaine,1376,0,20673,20673,15
66130,Osséja,1376,0,0,0,0
5162,La Saulce,1375,0,1949,1949,1.4
21337,Lamarche-sur-Saône,1375,0,0,0,0
52211,Froncles,1375,0,151034,151034,109.8
60477,Ons-en-Bray,1375,0,11272,11272,8.2
62391,Guarbecque,1375,0,22691,22691,16.5
27322,La Haye-Malherbe,1374,0,40747,40747,29.7
14009,Amfreville,1373,0,17442,17442,12.7
16119,Dignac,1373,0,35696,35696,26
76143,Bretteville-du-Grand-Caux,1373,0,16259,16259,11.8
86045,Celle-Lévescault,1373,0,81802,81802,59.6
35217,Le Pertre,1372,0,20613,20613,15
62620,Norrent-Fontes,1372,0,22641,22641,16.5
88099,Chavelot,1372,0,34502,34502,25.1
26211,Montségur-sur-Lauzon,1371,9376,36909,46285,33.8
27174,Corneville-sur-Risle,1371,0,30969,30969,22.6
28113,Coulombs,1371,0,7956,7956,5.8
51576,Tours-sur-Marne,1371,0,3389,3389,2.5
66121,Néfiach,1371,0,1850,1850,1.3
68120,Hagenthal-le-Bas,1371,17417,26648,44065,32.1
25196,Dasle,1370,0,86726,86726,63.3
54227,Giraumont,1370,0,12720,12720,9.3
72068,La Chartre-sur-le-Loir,1370,0,77256,77256,56.4
14460,Moyaux,1369,0,15239,15239,11.1
2A104,Eccica-Suarella,1369,0,18687,18687,13.7
56254,Trédion,1369,0,12665,12665,9.3
70464,Saint-Germain,1369,0,60178,60178,44
76468,Nointot,1369,12000,10433,22433,16.4
80039,Ault,1369,0,3937,3937,2.9
68093,Flaxlanden,1368,0,95298,95298,69.7
18126,Levet,1367,21592,24745,46337,33.9
34282,Saint-Paul-et-Valmalle,1367,0,7384,7384,5.4
70261,Frotey-lès-Vesoul,1367,0,70714,70714,51.7
88126,Darnieulles,1367,0,34376,34376,25.1
2037,Aulnois-sous-Laon,1366,0,52167,52167,38.2
17009,Angliers,1366,0,19902,19902,14.6
47048,Cancon,1366,0,34880,34880,25.5
77254,Liverdy-en-Brie,1366,0,6942,6942,5.1
85177,Les Velluire-sur-Vendée,1366,0,8963,8963,6.6
4205,Seyne,1365,159734,57214,216948,158.9
6113,Sainte-Agnès,1365,0,7661,7661,5.6
45226,Neuvy-en-Sullias,1365,0,7994,7994,5.9
57372,Kuntzig,1365,0,14346,14346,10.5
17330,Sainte-Gemme,1364,4615,34744,39359,28.9
25529,Sancey,1364,0,37604,37604,27.6
52432,Rolampont,1364,0,6259,6259,4.6
59614,Viesly,1364,0,343,343,0.3
60646,Troissereux,1364,0,53486,53486,39.2
68144,Hombourg,1364,159783,95019,254802,186.8
87128,Saint-Pardoux-le-Lac,1364,0,41399,41399,30.4
88426,Saint-Maurice-sur-Moselle,1364,0,2758,2758,2
29005,Baye,1363,0,46828,46828,34.4
53066,Chemazé,1363,0,61190,61190,44.9
74209,Peillonnex,1363,0,7124,7124,5.2
76141,Bréauté,1363,0,16141,16141,11.8
77295,Moisenay,1363,6900,1292,8192,6
2318,Folembray,1362,0,1348,1348,1
18058,Châteauneuf-sur-Cher,1362,12730,24655,37385,27.4
45129,Douchy-Montcorbon,1362,0,4129,4129,3
77311,Montigny-Lencoup,1362,5000,19288,24288,17.8
25453,Pierrefontaine-les-Varans,1361,0,16077,16077,11.8
64513,Sauveterre-de-Béarn,1361,0,28450,28450,20.9
70321,Magny-Vernois,1361,0,59827,59827,44
31210,Gardouch,1360,0,6633,6633,4.9
66228,Villeneuve-la-Rivière,1360,0,11328,11328,8.3
85126,Longèves,1360,0,8923,8923,6.6
17024,Aulnay,1359,0,37854,37854,27.9
28417,Villiers-le-Morhier,1359,0,7886,7886,5.8
47057,Castillonnès,1359,0,34701,34701,25.5
70433,Quincey,1359,0,70301,70301,51.7
16175,Val des Vignes,1358,22362,72614,94976,69.9
42093,Farnay,1358,0,31818,31818,23.4
1115,Confrançon,1357,0,26234,26234,19.3
16242,Nanteuil-en-Vallée,1357,6799,29703,36502,26.9
17253,Muron,1357,7900,22347,30247,22.3
33348,Queyrac,1357,0,1311,1311,1
35300,Saint-M'Hervé,1357,0,20387,20387,15
57022,Angevillers,1357,0,14262,14262,10.5
68322,Steinbach,1357,9078,22837,31915,23.5
69070,Cublize,1357,0,16040,16040,11.8
77358,Penchard,1357,0,18506,18506,13.6
14014,Colomby-Anguerny,1356,0,9128,9128,6.7
40274,Saint-Martin-d'Oney,1356,0,16782,16782,12.4
42156,Neulise,1356,33867,38441,72308,53.3
87118,Peyrilhac,1356,2954,19229,22183,16.4
21023,Arnay-le-Duc,1355,0,41795,41795,30.8
25293,Granges-Narboz,1355,0,38730,38730,28.6
33007,Arbanats,1355,0,41549,41549,30.7
37204,Rouziers-de-Touraine,1355,35111,15039,50150,37
51002,Saint-Martin-d'Ablois,1355,0,1962,1962,1.4
59336,Lécluse,1355,0,18880,18880,13.9
63151,Escoutoux,1355,0,31416,31416,23.2
2574,Origny-en-Thiérache,1354,0,26579,26579,19.6
3100,Diou,1354,0,23386,23386,17.3
9272,Saint-Paul-de-Jarrat,1354,0,36393,36393,26.9
23025,Bonnat,1354,0,3642,3642,2.7
54563,Vézelise,1354,0,0,0,0
58182,Moulins-Engilbert,1354,0,69841,69841,51.6
67504,Valff,1354,0,41873,41873,30.9
82126,Monteils,1354,0,40034,40034,29.6
14328,Hérouvillette,1353,0,17187,17187,12.7
26008,Ancône,1353,10350,13036,23386,17.3
47078,Damazan,1353,17400,12998,30398,22.5
62827,Tournehem-sur-la-Hem,1353,0,120417,120417,89
68115,Guewenheim,1353,0,28388,28388,21
68157,Jebsheim,1353,208869,27806,236675,174.9
74284,La Tour,1353,0,7072,7072,5.2
79283,Sainte-Néomaye,1353,0,7521,7521,5.6
27351,Incarville,1352,0,40094,40094,29.7
34224,Puissalicon,1352,0,2644,2644,2
35187,Monterfil,1352,0,23793,23793,17.6
37060,Chargé,1352,668,36697,37365,27.6
56080,Guilliers,1352,0,20359,20359,15.1
63350,Saint-Georges-sur-Allier,1352,0,24236,24236,17.9
77084,Changis-sur-Marne,1352,0,5265,5265,3.9
80222,Crécy-en-Ponthieu,1352,0,33479,33479,24.8
1047,Blyes,1351,0,23056,23056,17.1
1337,Saint-Bénigne,1351,0,18554,18554,13.7
49329,Savennières,1351,31861,21870,53731,39.8
53104,Gennes-Longuefuye,1351,0,60651,60651,44.9
59166,Curgies,1351,0,26026,26026,19.3
69084,Fleurie,1351,0,0,0,0
76307,Gonneville-la-Mallet,1351,0,12186,12186,9
1036,Valromey-sur-Séran,1350,0,15046,15046,11.1
2382,Holnon,1350,0,12231,12231,9.1
15092,Lanobre,1350,26500,6908,33408,24.7
17344,Saint-Hilaire-de-Villefranche,1350,0,37603,37603,27.9
35296,Saint-Médard-sur-Ille,1350,0,29000,29000,21.5
72381,Voivres-lès-le-Mans,1350,0,7231,7231,5.4
77203,Germigny-l'Évêque,1350,0,18411,18411,13.6
88132,Deyvillers,1350,0,33949,33949,25.1
57499,Neufgrange,1349,0,18436,18436,13.7
65007,Andrest,1349,0,30472,30472,22.6
68255,Pfaffenheim,1349,0,132452,132452,98.2
82194,Villebrumier,1349,0,18103,18103,13.4
97110,La Désirade,1349,0,24284,24284,18
42270,Saint-Paul-en-Cornillon,1348,0,31584,31584,23.4
59004,Aix-en-Pévèle,1348,0,23006,23006,17.1
76594,Saint-Jean-du-Cardonnay,1348,0,921,921,0.7
84123,Sault,1348,0,21870,21870,16.2
18140,Massay,1347,12328,19462,31790,23.6
27032,Chambois,1347,0,37883,37883,28.1
34002,Adissan,1347,0,14961,14961,11.1
60701,Wavignies,1347,11900,7463,19363,14.4
64123,Bidache,1347,0,35003,35003,26
8419,Signy-l'Abbaye,1346,0,29522,29522,21.9
17323,Saint-Denis-d'Oléron,1346,0,145804,145804,108.3
34312,La Tour-sur-Orb,1346,0,12532,12532,9.3
49022,Beaulieu-sur-Layon,1346,26048,26721,52769,39.2
25429,Novillars,1345,11451,23698,35149,26.1
30347,Vestric-et-Candiac,1345,0,0,0,0
33412,Saint-Germain-d'Esteuil,1345,0,11825,11825,8.8
37282,Yzeures-sur-Creuse,1345,16458,23347,39805,29.6
59113,Bruille-lez-Marchiennes,1345,0,16173,16173,12
67065,Breuschwickersheim,1345,0,522505,522505,388.5
40333,Ygos-Saint-Saturnin,1344,0,19204,19204,14.3
49338,Soulaines-sur-Aubance,1344,12561,21757,34318,25.5
57340,Hundling,1344,0,18368,18368,13.7
31334,Mauzac,1343,0,2310,2310,1.7
45240,Outarville,1343,0,4885,4885,3.6
53121,Javron-les-Chapelles,1343,0,11944,11944,8.9
91080,Boissy-le-Cutté,1343,0,9095,9095,6.8
5118,Val Buëch-Méouge,1342,0,40008,40008,29.8
25058,Beure,1342,0,23645,23645,17.6
26072,Chantemerle-les-Blés,1342,2450,59049,61499,45.8
53157,Montigné-le-Brillant,1342,0,58404,58404,43.5
73153,Marthod,1342,0,31656,31656,23.6
76041,Les Hauts-de-Caux,1342,0,2483,2483,1.9
33082,Cadillac-en-Fronsadais,1341,0,20184,20184,15.1
41025,Bracieux,1341,0,9395,9395,7
68203,Merxheim,1341,0,33092,33092,24.7
80070,Beauquesne,1341,0,5227,5227,3.9
28185,Goussainville,1340,0,13436,13436,10
33187,Gironde-sur-Dropt,1340,10430,10910,21340,15.9
41241,Selles-Saint-Denis,1340,59350,11418,70768,52.8
50294,Martinvast,1340,0,42149,42149,31.5
50543,Saint-Quentin-sur-le-Homme,1340,0,32970,32970,24.6
82171,Saint-Porquier,1340,0,17209,17209,12.8
85264,Saint-Pierre-du-Chemin,1340,0,29279,29279,21.8
11033,Belpech,1339,51177,3964,55141,41.2
16300,Val-de-Bonnieure,1339,15732,16833,32565,24.3
37264,Vallères,1339,0,21315,21315,15.9
67122,Wangenbourg-Engenthal,1339,7842,72724,80566,60.2
76467,Néville,1339,0,8672,8672,6.5
42139,Marlhes,1338,0,27375,27375,20.5
45317,Tavers,1338,0,5513,5513,4.1
62875,Wardrecques,1338,0,119082,119082,89
85212,Sainte-Florence,1338,0,11190,11190,8.4
7288,Saint-Priest,1337,0,4461,4461,3.3
17072,Burie,1337,0,42374,42374,31.7
42075,Craintilleux,1337,0,11979,11979,9
78140,Chapet,1337,0,12443,12443,9.3
78269,Gazeran,1337,12060,2605,14665,11
40201,Mugron,1336,0,20923,20923,15.7
80718,Saint-Sauveur,1336,0,2299,2299,1.7
27196,Les Damps,1335,0,39590,39590,29.7
33220,Lamarque,1335,0,379,379,0.3
37237,Saint-Roch,1335,6924,14817,21741,16.3
46311,Sousceyrac-en-Quercy,1335,0,43555,43555,32.6
47137,Laplume,1335,0,30561,30561,22.9
60013,Angicourt,1335,0,1951,1951,1.5
61447,Saint-Pierre-du-Regard,1335,14799,35756,50555,37.9
68026,Bennwihr,1335,0,3191,3191,2.4
85106,La Guérinière,1335,0,45485,45485,34.1
87063,Eyjeaux,1335,5864,18931,24795,18.6
27516,Treis-Sants-en-Ouche,1334,0,5751,5751,4.3
52050,Biesles,1334,0,146530,146530,109.8
57028,Argancy,1334,0,2708,2708,2
69106,Lachassagne,1334,0,12022,12022,9
89228,Lindry,1334,6996,26097,33093,24.8
2780,Venizel,1333,0,11152,11152,8.4
3314,Villebret,1333,22044,31377,53421,40.1
14592,Sainte-Honorine-du-Fay,1333,0,2357,2357,1.8
66084,Fourques,1333,0,17867,17867,13.4
72247,Pruillé-le-Chétif,1333,9280,27270,36550,27.4
53123,Juvigné,1332,0,6054,6054,4.5
57575,Retonfey,1332,0,3243,3243,2.4
59638,Wannehain,1332,0,22733,22733,17.1
60256,Montchevreuil,1332,3170,4286,7456,5.6
78010,Les Alluets-le-Roi,1332,0,12397,12397,9.3
2292,Étampes-sur-Marne,1331,0,30765,30765,23.1
19227,Saint-Mexant,1331,0,25256,25256,19
31206,Gaillac-Toulza,1331,0,7001,7001,5.3
33480,Saint-Sulpice-de-Faleyrens,1331,0,51711,51711,38.9
40314,Tercis-les-Bains,1331,0,11394,11394,8.6
64233,Garlin,1331,0,20840,20840,15.7
67331,Niederschaeffolsheim,1331,0,16184,16184,12.2
77116,Choisy-en-Brie,1331,0,21918,21918,16.5
95625,Us,1331,4850,61154,66004,49.6
21577,Saint-Usage,1330,0,9972,9972,7.5
33525,Tauriac,1330,0,7511,7511,5.6
47165,Meilhan-sur-Garonne,1330,0,13760,13760,10.3
49369,Vernoil-le-Fourrier,1330,0,12958,12958,9.7
57601,Rozérieulles,1330,0,65942,65942,49.6
58083,Corbigny,1330,0,20682,20682,15.6
60330,Laboissière-en-Thelle,1330,0,4279,4279,3.2
64133,Boeil-Bezing,1330,0,14223,14223,10.7
1403,Serrières-de-Briord,1329,0,22681,22681,17.1
36001,Aigurande,1329,22150,3863,26013,19.6
51204,Damery,1329,0,1924,1924,1.4
70240,Fontaine-lès-Luxeuil,1329,0,8446,8446,6.4
89274,Nailly,1329,1900,4715,6615,5
2521,Montreuil-aux-Lions,1328,0,723,723,0.5
8365,Rimogne,1328,0,20675,20675,15.6
18241,Sancerre,1328,30980,23925,54905,41.3
63415,Sauxillanges,1328,0,8633,8633,6.5
68329,Stosswihr,1328,0,53308,53308,40.1
80333,Fort-Mahon-Plage,1328,0,32885,32885,24.8
16295,Saint-Amant-de-Boixe,1327,13360,16682,30042,22.6
35340,Treffendel,1327,0,23353,23353,17.6
87203,Vicq-sur-Breuilh,1327,39852,21279,61131,46.1
22144,La Méaugon,1326,0,21031,21031,15.9
25112,Chalezeule,1326,28581,23364,51945,39.2
31003,Aigrefeuille,1326,0,32418,32418,24.4
74121,Excenevex,1326,21312,57730,79042,59.6
78108,Les Bréviaires,1326,0,2583,2583,1.9
88481,Uriménil,1326,0,33345,33345,25.1
18127,Lignières,1325,57920,23985,81905,61.8
57208,Farschviller,1325,0,24223,24223,18.3
57712,Vic-sur-Seille,1325,0,4385,4385,3.3
68129,Heimsbrunn,1325,0,92302,92302,69.7
72226,Oizé,1325,0,9605,9605,7.2
72306,Saint-Ouen-en-Belin,1325,0,2768,2768,2.1
2057,Beaurevoir,1324,0,11996,11996,9.1
27015,Andé,1324,0,39264,39264,29.7
17166,Forges,1323,4110,54742,58852,44.5
38334,Revel,1323,0,24583,24583,18.6
45050,Boynes,1323,11350,1645,12995,9.8
63035,Beauregard-Vendon,1323,0,8728,8728,6.6
28023,Bailleau-Armenonville,1322,0,7671,7671,5.8
79259,Saint-Jean-de-Thouars,1322,0,20569,20569,15.6
79302,Saivres,1322,0,7348,7348,5.6
25410,Morre,1321,2816,23275,26091,19.8
62075,Baincthun,1321,6300,44656,50956,38.6
21027,Asnières-lès-Dijon,1320,0,32,32,0
62713,Robecq,1320,0,21783,21783,16.5
64549,Uzein,1320,10848,38974,49822,37.7
67442,Scharrachbergheim-Irmstett,1320,3702,71692,75394,57.1
77208,Gouaix,1320,7393,18694,26087,19.8
85022,Le Bernard,1320,0,26502,26502,20.1
37128,Lignières-de-Touraine,1319,4100,20996,25096,19
49311,Saint-Philbert-du-Peuple,1319,0,12851,12851,9.7
54222,Gerbéviller,1319,0,5450,5450,4.1
55519,Tronville-en-Barrois,1319,0,15902,15902,12.1
62584,Mont-Bernanchon,1319,0,21766,21766,16.5
11217,Marcorignan,1318,0,20382,20382,15.5
76631,Saint-Paër,1318,0,37647,37647,28.6
80406,Hallencourt,1318,0,4021,4021,3.1
84102,Roussillon,1318,0,26866,26866,20.4
86224,Saint-Gervais-les-Trois-Clochers,1318,0,29997,29997,22.8
1285,Parcieux,1317,0,20859,20859,15.8
3106,Durdat-Larequille,1317,1424,47050,48474,36.8
14035,Balleroy-sur-Drôme,1317,0,9117,9117,6.9
22178,Pléhédel,1317,0,23583,23583,17.9
25157,La Cluse-et-Mijoux,1317,0,37644,37644,28.6
35229,Pocé-les-Bois,1317,0,19786,19786,15
38070,Le Champ-près-Froges,1317,0,24471,24471,18.6
49029,Blaison-Saint-Sulpice,1317,3520,26145,29665,22.5
62264,Dannes,1317,0,44521,44521,33.8
2103,Boué,1316,0,23467,23467,17.8
39190,Dampierre,1316,8226,20767,28993,22
46137,Labastide-Marnhac,1316,0,11112,11112,8.4
49352,Toutlemonde,1316,19439,54684,74123,56.3
79281,Saint-Maxire,1316,6752,17737,24489,18.6
1118,Corbonod,1315,0,31762,31762,24.2
7155,Mercuer,1315,7168,22445,29613,22.5
33362,Sablons,1315,0,25650,25650,19.5
36103,Luçay-le-Mâle,1315,0,16509,16509,12.6
54051,Batilly,1315,0,12210,12210,9.3
59064,Bellaing,1315,0,49471,49471,37.6
64249,Guéthary,1315,90400,34171,124571,94.7
15255,Vézac,1314,57137,44520,101657,77.4
25200,Devecey,1314,11460,23152,34612,26.3
27302,Le Bosc du Theil,1314,26805,5651,32456,24.7
36070,Éguzon-Chantôme,1314,0,9648,9648,7.3
37241,Savigné-sur-Lathan,1314,0,12189,12189,9.3
91525,Roinville,1314,0,7638,7638,5.8
14578,Saint-Gatien-des-Bois,1313,0,103927,103927,79.2
17053,Bords,1313,6459,36573,43032,32.8
17073,Bussac-sur-Charente,1313,0,41613,41613,31.7
25475,Quingey,1313,0,9568,9568,7.3
81097,Fréjairolles,1313,17715,12746,30461,23.2
1243,Messimy-sur-Saône,1312,0,6772,6772,5.2
3048,Cérilly,1312,0,20627,20627,15.7
59629,Vred,1311,0,15764,15764,12
62174,Brêmes,1311,0,8024,8024,6.1
71292,Mellecey,1311,5200,36046,41246,31.5
91408,Moigny-sur-École,1311,0,45676,45676,34.8
19019,Beaulieu-sur-Dordogne,1310,0,6604,6604,5
24035,Pays de Belvès,1310,43010,64125,107135,81.8
59637,Wandignies-Hamage,1310,0,15752,15752,12
80639,Poulainville,1310,0,83986,83986,64.1
81081,Dourgne,1310,0,1458,1458,1.1
86235,Saint-Maurice-la-Clouère,1310,0,29501,29501,22.5
95592,Seraincourt,1310,15105,60189,75294,57.5
14579,Seulline,1309,0,48540,48540,37.1
26049,Bésayes,1309,9500,26535,36035,27.5
37192,Reignac-sur-Indre,1309,17907,22722,40629,31
56213,Saint-Gérand-Croixanvec,1309,0,9114,9114,7
2186,Chézy-sur-Marne,1308,0,712,712,0.5
26009,Andancette,1308,0,21532,21532,16.5
33545,Vertheuil,1308,0,11500,11500,8.8
35304,Saint-Ouen-des-Alleux,1308,0,16016,16016,12.2
57568,Rémelfing,1308,0,17876,17876,13.7
7199,Rosières,1307,13059,91132,104191,79.7
14126,Cambremer,1307,0,14549,14549,11.1
27157,Marbois,1307,0,36758,36758,28.1
28096,La Chaussée-d'Ivry,1307,0,1748,1748,1.3
41148,Montlivault,1307,0,9157,9157,7
47101,Fourques-sur-Garonne,1307,0,13522,13522,10.3
51160,Compertrix,1307,0,66432,66432,50.8
53155,Montenay,1307,0,5940,5940,4.5
60501,Le Plessis-Brion,1307,0,6641,6641,5.1
68242,Oberhergheim,1307,30898,10315,41213,31.5
17019,Ars-en-Ré,1306,71300,80641,151941,116.3
18118,Jouet-sur-l'Aubois,1306,7905,413,8318,6.4
27426,Neaufles-Saint-Martin,1306,0,1064,1064,0.8
41143,Mondoubleau,1306,0,39009,39009,29.9
52411,Rives Dervoises,1306,0,11828,11828,9.1
56111,Limerzel,1306,0,9254,9254,7.1
67367,Otterswiller,1306,31975,92116,124091,95
73089,Coise-Saint-Jean-Pied-Gauthier,1306,0,23355,23355,17.9
31281,Launac,1305,0,10917,10917,8.4
43120,Lempdes-sur-Allagnon,1305,790,14615,15405,11.8
56229,Saint-Martin-sur-Oust,1305,0,15876,15876,12.2
78384,Médan,1305,0,12145,12145,9.3
49174,Huillé-Lézigné,1304,0,9977,9977,7.7
90012,Bessoncourt,1304,47817,45494,93311,71.6
5166,Serres,1303,64742,38845,103587,79.5
40187,Moliets-et-Maa,1303,0,29275,29275,22.5
62810,Thélus,1303,0,36649,36649,28.1
72056,Champfleur,1303,0,38508,38508,29.6
82105,Mas-Grenier,1303,0,17486,17486,13.4
7013,Ardoix,1302,18040,6708,24748,19
33071,Branne,1302,0,9085,9085,7
39365,Mont-sous-Vaudrey,1302,50950,12608,63558,48.8
74310,Viuz-la-Chiésaz,1302,0,10057,10057,7.7
14069,Beuvillers,1301,0,14482,14482,11.1
14162,Clécy,1301,0,39332,39332,30.2
35215,Parigné,1301,0,15930,15930,12.2
63132,Cunlhat,1301,15000,11757,26757,20.6
1371,Saint-Marcel,1300,0,271,271,0.2
21590,Savigny-lès-Beaune,1300,0,5653,5653,4.3
25418,Nancray,1300,2440,22905,25345,19.5
28330,Villemaury,1300,0,71037,71037,54.6
62205,Campagne-lès-Wardrecques,1300,0,115700,115700,89
63126,Le Crest,1300,590,23304,23894,18.4
26087,Châtillon-Saint-Jean,1299,9600,26332,35932,27.7
35058,La Chapelle-Chaussée,1299,0,66566,66566,51.2
37276,Villedômer,1299,2500,5700,8200,6.3
42087,Écotay-l'Olme,1299,0,11638,11638,9
88361,Provenchères-et-Colroy,1299,0,12630,12630,9.7
17339,Saint-Germain-de-Lusignan,1298,0,15326,15326,11.8
29202,Plounéour-Ménez,1298,24835,77827,102662,79.1
40295,Saugnac-et-Muret,1298,0,10213,10213,7.9
53018,Ballots,1298,0,8593,8593,6.6
56220,Sainte-Hélène,1298,0,4635,4635,3.6
86244,Saint-Sauvant,1298,0,77334,77334,59.6
4178,Saint-Étienne-les-Orgues,1297,15292,26342,41634,32.1
8107,Château-Porcien,1297,0,24804,24804,19.1
27107,Bourneville-Sainte-Croix,1297,0,5314,5314,4.1
30051,Branoux-les-Taillades,1297,0,40541,40541,31.3
30288,Saint-Nazaire,1297,0,18926,18926,14.6
33101,Cartelègue,1297,0,12090,12090,9.3
68097,Fréland,1297,0,66231,66231,51.1
74152,Lovagny,1297,0,5508,5508,4.2
76169,La Cerlangue,1297,0,11699,11699,9
59424,Neuf-Mesnil,1296,0,46229,46229,35.7
65447,Tournay,1296,0,8229,8229,6.3
19285,Vigeois,1295,0,0,0,0
82117,Montaigu-de-Quercy,1295,0,40546,40546,31.3
1108,Coligny,1294,0,25016,25016,19.3
22388,Vildé-Guingalan,1294,0,34473,34473,26.6
29111,Lanhouarneau,1294,0,2459,2459,1.9
60639,Tillé,1294,0,50742,50742,39.2
63368,Saint-Julien-de-Coppel,1294,0,12411,12411,9.6
66161,Ria-Sirach,1294,0,38755,38755,29.9
73183,Myans,1294,0,23141,23141,17.9
77415,Saint-Jean-les-Deux-Jumeaux,1294,0,5039,5039,3.9
95177,Cormeilles-en-Vexin,1294,20814,59454,80268,62
7022,Baix,1293,0,27683,27683,21.4
62618,Nordausques,1293,0,115077,115077,89
69246,Theizé,1293,31405,11652,43057,33.3
77177,Favières,1293,0,6571,6571,5.1
80507,Marcelcave,1293,0,171,171,0.1
81037,Brassac,1293,0,12080,12080,9.3
1203,Laiz,1292,0,5233,5233,4.1
3107,Ébreuil,1292,0,26427,26427,20.5
7225,Saint-Clair,1292,34066,6656,40722,31.5
11041,Bize-Minervois,1292,35449,19980,55429,42.9
69201,Sainte-Foy-l'Argentière,1292,54806,64757,119563,92.5
79157,Louzy,1292,0,20103,20103,15.6
81101,Le Garric,1292,0,29558,29558,22.9
84148,Villes-sur-Auzon,1292,32689,20961,53650,41.5
86225,Saint-Jean-de-Sauves,1292,0,6600,6600,5.1
33548,Villegouge,1291,0,19431,19431,15.1
50178,Fermanville,1291,23590,40608,64198,49.7
19138,Meyssac,1290,0,6504,6504,5
39173,Cousance,1290,12985,19670,32655,25.3
52197,Fayl-Billot,1290,0,25441,25441,19.7
59194,Englefontaine,1290,0,3641,3641,2.8
68301,Schlierbach,1290,0,25073,25073,19.4
90097,Trévenans,1290,0,45005,45005,34.9
17077,Cercoux,1289,0,15220,15220,11.8
22324,Saint-Quay-Perros,1289,0,25607,25607,19.9
35021,Beaucé,1289,0,15783,15783,12.2
53072,Commer,1289,0,47901,47901,37.2
66226,Villemolaque,1289,0,17277,17277,13.4
67375,Pfulgriesheim,1289,8325,24524,32849,25.5
74215,Praz-sur-Arly,1289,767022,13499,780521,605.5
88081,Bussang,1289,0,2606,2606,2
9264,Saint-Jean-de-Verges,1288,13470,34619,48089,37.3
11295,Portel-des-Corbières,1288,37120,19918,57038,44.3
15268,Le Rouget-Pers,1288,31320,11293,42613,33.1
38135,Courtenay,1288,0,6649,6649,5.2
44141,La Remaudière,1288,31696,13339,45035,35
50564,Terre-et-Marais,1288,0,6980,6980,5.4
54364,Méréville,1288,0,13117,13117,10.2
59196,Ennetières-en-Weppes,1288,0,21329,21329,16.6
62634,Offekerque,1288,0,9775,9775,7.6
68140,Hirtzfelden,1288,0,22354,22354,17.4
1405,Servas,1287,0,24881,24881,19.3
31247,Labarthe-Rivière,1287,0,26658,26658,20.7
42150,Montverdun,1287,0,11531,11531,9
74088,Copponex,1287,19919,23137,43056,33.5
86015,Availles-Limouzine,1287,16717,52053,68770,53.4
43241,Solignac-sur-Loire,1286,43690,53509,97199,75.6
50288,Marcey-les-Grèves,1286,0,31641,31641,24.6
65127,Capvern,1286,0,3841,3841,3
4063,Corbières-en-Provence,1285,9900,14937,24837,19.3
17463,Vergeroux,1285,11330,21161,32491,25.3
21496,Pontailler-sur-Saône,1285,0,0,0,0
23076,Évaux-les-Bains,1285,0,19314,19314,15
72147,La Guierche,1285,0,72204,72204,56.2
84086,Oppède,1285,0,12525,12525,9.7
31495,Saint-Léon,1284,0,6263,6263,4.9
42021,Boisset-Saint-Priest,1284,0,11504,11504,9
57218,Fleury,1284,0,49171,49171,38.3
77457,Solers,1284,11300,1217,12517,9.7
87027,Bussière-Galant,1284,5955,17404,23359,18.2
89311,Pourrain,1284,17401,57977,75378,58.7
11264,Névian,1283,18075,19841,37916,29.6
19061,Cornil,1283,12358,24345,36703,28.6
26212,Montvendre,1283,12984,26007,38991,30.4
33553,Virsac,1283,6240,7245,13485,10.5
49266,Saint-Augustin-des-Bois,1283,0,37183,37183,29
66115,Montesquieu-des-Albères,1283,0,5298,5298,4.1
76751,Yébleron,1283,0,9778,9778,7.6
91106,Breux-Jouy,1283,0,7458,7458,5.8
40102,Gabarret,1282,0,14642,14642,11.4
49362,Varrains,1282,0,12490,12490,9.7
57588,Rodemack,1282,0,31212,31212,24.3
60370,Lormaison,1282,0,4125,4125,3.2
2203,Coincy,1281,0,29609,29609,23.1
19023,Beynat,1281,0,6458,6458,5
56160,Pleugriffet,1281,0,8919,8919,7
67155,Gertwiller,1281,4658,39616,44274,34.6
68227,Muntzenheim,1281,10113,26327,36440,28.4
74205,Onnion,1281,8005,6695,14700,11.5
76446,Montigny,1281,0,875,875,0.7
78262,Galluis,1281,0,553,553,0.4
8497,Warcq,1280,0,29403,29403,23
27656,Toutainville,1280,0,28914,28914,22.6
27693,Sylvains-Lès-Moulins,1280,0,35999,35999,28.1
35355,Vieux-Vy-sur-Couesnon,1280,0,27496,27496,21.5
53029,Bierné-les-Villages,1280,0,57464,57464,44.9
59662,Winnezeele,1280,0,7820,7820,6.1
76522,La Remuée,1280,0,11545,11545,9
80649,Quend,1280,0,31696,31696,24.8
27386,Le Manoir,1279,0,37930,37930,29.7
46330,Vayrac,1279,0,41728,41728,32.6
76503,Pissy-Pôville,1279,0,874,874,0.7
82098,Léojac,1279,0,11137,11137,8.7
4192,Saint-Michel-l'Observatoire,1278,0,3368,3368,2.6
16019,Asnières-sur-Nouère,1278,0,33226,33226,26
17119,Corme-Écluse,1278,1606,20127,21733,17
46143,Lacapelle-Marival,1278,0,37740,37740,29.5
9032,Ax-les-Thermes,1277,53080,183909,236989,185.6
33463,Saint-Pierre-d'Aurillac,1277,33436,10397,43833,34.3
52123,Chevillon,1277,0,11565,11565,9.1
55553,Vignot,1277,0,5154,5154,4
77336,Neufmoutiers-en-Brie,1277,0,6490,6490,5.1
1196,Jayat,1276,0,24668,24668,19.3
6031,Cantaron,1276,0,35981,35981,28.2
22387,Le Vieux-Marché,1276,0,25349,25349,19.9
54362,Mercy-le-Bas,1276,0,5622,5622,4.4
71282,Marmagne,1276,0,20503,20503,16.1
72084,Clermont-Créans,1276,6161,9250,15411,12.1
80523,Méaulte,1276,0,1427,1427,1.1
80827,Woincourt,1276,0,8483,8483,6.6
81308,Valence-d'Albigeois,1276,0,39427,39427,30.9
11190,La Redorte,1275,0,8270,8270,6.5
38004,L'Albenc,1275,0,20605,20605,16.2
68032,Berrwiller,1275,0,88819,88819,69.7
72150,Joué-l'Abbé,1275,0,71642,71642,56.2
80622,Picquigny,1275,0,2194,2194,1.7
16204,Bellevigne,1274,32091,47667,79758,62.6
17102,Chermignac,1274,6350,40377,46727,36.7
64421,Ogeu-les-Bains,1274,31660,27436,59096,46.4
82113,Molières,1274,0,37668,37668,29.6
16348,Saint-Saturnin,1273,0,33096,33096,26
21086,Bligny-lès-Beaune,1273,0,5536,5536,4.3
57261,Gros-Réderching,1273,0,29338,29338,23
68011,Aspach-le-Bas,1273,4729,21424,26153,20.5
69193,Saint-Cyr-sur-le-Rhône,1273,10050,9794,19844,15.6
89441,Vermenton,1273,27250,174,27424,21.5
35234,Quédillac,1272,0,24700,24700,19.4
87049,Coussac-Bonneval,1272,9860,38955,48815,38.4
89130,Deux Rivières,1272,19579,174,19753,15.5
57764,Zoufftgen,1271,0,30944,30944,24.3
62532,Lozinghem,1271,0,20974,20974,16.5
89236,Maillot,1271,1768,8446,10214,8
13095,Saint-Marc-Jaumegarde,1270,0,35695,35695,28.1
27316,Hauville,1270,0,5203,5203,4.1
27343,Houlbec-Cocherel,1270,0,6673,6673,5.3
35338,Torcé,1270,0,19080,19080,15
41091,Fossé,1270,0,48674,48674,38.3
51054,Bétheniville,1270,0,22570,22570,17.8
73105,Les Échelles,1270,0,86959,86959,68.5
6120,Saint-Étienne-de-Tinée,1269,0,24984,24984,19.7
52265,Bayard-sur-Marne,1269,0,11493,11493,9.1
69045,Charentay,1269,0,0,0,0
42174,Poncins,1268,8505,22984,31489,24.8
77154,Dammartin-sur-Tigeaux,1268,0,4938,4938,3.9
80716,Saint-Riquier,1268,0,31399,31399,24.8
90069,Méziré,1268,6620,44238,50858,40.1
11140,Ferrals-les-Corbières,1267,21570,17166,38736,30.6
24550,Thenon,1267,82404,22159,104563,82.5
45329,Triguères,1267,0,3841,3841,3
56029,Calan,1267,25703,28656,54359,42.9
76404,Manéglise,1267,0,11428,11428,9
64329,Lée,1266,0,37379,37379,29.5
2430,Liesse-Notre-Dame,1265,0,3404,3404,2.7
3315,Villefranche-d'Allier,1265,0,45192,45192,35.7
2A189,Olmeto,1265,0,0,0,0
47324,Villeréal,1265,0,32301,32301,25.5
57330,Holving,1265,0,17288,17288,13.7
77022,Barbizon,1265,0,10532,10532,8.3
80714,Saint-Quentin-la-Motte-Croix-au-Bailly,1265,0,3638,3638,2.9
82085,Lacourt-Saint-Pierre,1265,0,11015,11015,8.7
86255,Savigné,1265,0,28487,28487,22.5
11281,Pexiora,1264,0,3742,3742,3
25265,Geneuille,1264,8800,22271,31071,24.6
38191,Huez,1264,0,71894,71894,56.9
65123,Campan,1264,0,9488,9488,7.5
78171,Condé-sur-Vesgre,1264,6550,12674,19224,15.2
85165,L'Oie,1264,0,10571,10571,8.4
17243,Montlieu-la-Garde,1263,0,14913,14913,11.8
22077,Hénansal,1263,23244,15244,38488,30.5
22152,Minihy-Tréguier,1263,0,25090,25090,19.9
29208,Plourin,1263,0,2275,2275,1.8
41159,Neung-sur-Beuvron,1263,7531,10539,18070,14.3
50085,Bricqueville-sur-Mer,1263,0,30567,30567,24.2
68182,Leymen,1263,0,24549,24549,19.4
73278,Saint-Rémy-de-Maurienne,1263,8720,180948,189668,150.2
85256,Saint-Michel-le-Cloucq,1263,4550,8287,12837,10.2
26176,Marsanne,1262,0,12159,12159,9.6
30342,Vénéjan,1262,23481,18415,41896,33.2
31383,Montjoire,1262,0,14155,14155,11.2
33471,Saint-Sauveur,1262,0,11096,11096,8.8
51183,Courcy,1262,0,22428,22428,17.8
55166,Dugny-sur-Meuse,1262,0,8033,8033,6.4
66173,Saint-Féliu-d'Amont,1262,0,1703,1703,1.3
9245,Rieux-de-Pelleport,1261,0,33893,33893,26.9
11178,Labastide-d'Anjou,1261,0,11080,11080,8.8
37131,Limeray,1261,3800,34227,38027,30.2
50237,La Haye-Pesnel,1261,0,30519,30519,24.2
28127,Dangeau,1260,0,2318,2318,1.8
30136,Junas,1260,0,93730,93730,74.4
41120,Lunay,1260,0,15584,15584,12.4
57668,Teting-sur-Nied,1260,0,58469,58469,46.4
89195,Gron,1260,48123,8373,56496,44.8
17267,Nuaillé-d'Aunis,1259,0,18343,18343,14.6
24133,La Coquille,1259,16970,4154,21124,16.8
29067,Guerlesquin,1259,10962,75488,86450,68.7
56163,Ploërdut,1259,0,40243,40243,32
56252,Le Tour-du-Parc,1259,0,11647,11647,9.3
57680,Troisfontaines,1259,0,8196,8196,6.5
58145,Lormes,1259,63021,14835,77856,61.8
64130,Biriatou,1259,0,32716,32716,26
74053,Cervens,1259,32396,54813,87209,69.3
95409,Moisselles,1259,0,2196,2196,1.7
19269,Treignac,1258,0,21904,21904,17.4
26216,Saint-Jean-de-Galaure,1258,0,20709,20709,16.5
38212,Livet-et-Gavet,1258,0,71553,71553,56.9
38359,Saint Antoine l'Abbaye,1258,0,20330,20330,16.2
44222,La Roche-Blanche,1258,1840,15370,17210,13.7
64282,Jatxou,1258,8700,32690,41390,32.9
86048,Chabournay,1258,0,65374,65374,52
25320,Labergement-Sainte-Marie,1257,0,74861,74861,59.6
33040,Béguey,1257,0,38544,38544,30.7
45212,Montcresson,1257,0,12889,12889,10.3
49195,Mazières-en-Mauges,1257,30132,52232,82364,65.5
57603,Russange,1257,0,10838,10838,8.6
58232,Saint-Benin-d'Azy,1257,0,6300,6300,5
79265,Saint-Léger-de-Montbrun,1257,0,19558,19558,15.6
63229,Moissat,1256,0,5770,5770,4.6
77065,Cély,1256,0,10457,10457,8.3
24237,Lembras,1255,5850,27939,33789,26.9
31478,Saint-Félix-Lauragais,1255,0,25514,25514,20.3
38496,Sonnay,1255,0,32082,32082,25.6
45182,Ligny-le-Ribault,1255,0,10827,10827,8.6
59218,Étrœungt,1255,0,9942,9942,7.9
76536,Roncherolles-sur-le-Vivier,1255,0,35847,35847,28.6
85291,Thorigny,1255,0,59320,59320,47.3
11132,Fabrezan,1254,0,16990,16990,13.5
19162,Perpezac-le-Noir,1254,0,0,0,0
21532,Rouvres-en-Plaine,1254,0,28,28,0
27290,Goupil-Othon,1254,0,5406,5406,4.3
42126,Luriecq,1254,0,11235,11235,9
51431,Pierry,1254,0,24920,24920,19.9
57385,Laquenexy,1254,0,62174,62174,49.6
64386,Mirepeix,1254,0,13411,13411,10.7
89295,Perrigny,1254,12996,24532,37528,29.9
8218,Les Hautes-Rivières,1253,0,19507,19507,15.6
26160,Laveyron,1253,13333,20627,33960,27.1
33350,Rauzan,1253,0,8743,8743,7
62330,Festubert,1253,0,20677,20677,16.5
70117,Châlonvillars,1253,0,8183,8183,6.5
87030,Chaillac-sur-Vienne,1253,5080,27403,32483,25.9
11434,Villepinte,1252,13251,3707,16958,13.5
17331,Saint-Genis-de-Saintonge,1252,0,14783,14783,11.8
41256,Theillay,1252,0,10669,10669,8.5
42215,Saint-Denis-de-Cabanne,1252,0,32482,32482,25.9
74219,Quintal,1252,0,9671,9671,7.7
24534,Sigoulès-et-Flaugeac,1251,9600,27850,37450,29.9
77180,Férolles-Attilly,1251,28300,7617,35917,28.7
30226,Saint-Alexandre,1250,0,18240,18240,14.6
31407,Paulhac,1250,0,14020,14020,11.2
35034,La Boussac,1250,0,10630,10630,8.5
41155,Muides-sur-Loire,1250,2609,3764,6373,5.1
43218,Saint-Pierre-Eynac,1250,0,6934,6934,5.5
53168,Nuillé-sur-Vicoin,1250,0,54400,54400,43.5
62200,Cambrin,1250,0,20628,20628,16.5
71379,Sagy,1250,0,5146,5146,4.1
86114,Jardres,1250,0,74474,74474,59.6
91038,Auvers-Saint-Georges,1250,0,8465,8465,6.8
6077,Lucéram,1249,0,35220,35220,28.2
59281,Hantay,1249,0,20683,20683,16.6
61008,Aube,1249,18646,12875,31521,25.2
70171,Corbenay,1249,0,7937,7937,6.4
71444,Saint-Loup-de-Varennes,1249,3470,34341,37811,30.3
79012,Ardin,1249,39018,10295,49313,39.5
81036,Bout-du-Pont-de-Larn,1249,0,10783,10783,8.6
2359,Grugies,1248,0,178367,178367,142.9
61093,Chanu,1248,7100,42165,49265,39.5
70198,Dampierre-sur-Salon,1248,0,6406,6406,5.1
22014,Bourseul,1247,0,33221,33221,26.6
31075,Bonrepos-sur-Aussonnelle,1247,10820,1549,12369,9.9
35279,Saint-Guinoux,1247,0,29566,29566,23.7
37047,Cerelles,1247,7914,13840,21754,17.4
50436,Romagny Fontenay,1247,0,30682,30682,24.6
86256,Savigny-Lévescault,1247,4565,74295,78860,63.2
44136,Préfailles,1246,0,37982,37982,30.5
44159,Saint-Fiacre-sur-Maine,1246,0,23005,23005,18.5
47043,Buzet-sur-Baïse,1246,0,6041,6041,4.8
77063,La Celle-sur-Morin,1246,0,4853,4853,3.9
18103,Graçay,1245,14890,17988,32878,26.4
35231,Poligné,1245,5121,18119,23240,18.7
36247,Vineuil,1245,0,202,202,0.2
43262,Vieille-Brioude,1245,7500,61014,68514,55
62412,Hardinghen,1245,0,7620,7620,6.1
65069,La Barthe-de-Neste,1245,0,3718,3718,3
76263,La Feuillie,1245,0,23519,23519,18.9
82101,Malause,1245,0,133764,133764,107.4
17359,Saint-Mard,1244,1500,51473,52973,42.6
33494,Salaunes,1244,0,780,780,0.6
39441,Prémanon,1244,24900,8854,33754,27.1
77261,Lorrez-le-Bocage-Préaux,1244,0,1311,1311,1.1
19288,Voutezac,1243,0,19838,19838,16
38405,Saint-Joseph-de-Rivière,1243,0,85110,85110,68.5
62323,Fampoux,1243,0,34961,34961,28.1
40269,Saint-Lon-les-Mines,1242,0,9243,9243,7.4
62190,Busnes,1242,0,20496,20496,16.5
62487,Landrethun-le-Nord,1242,0,4941,4941,4
85093,Fougeré,1242,0,58705,58705,47.3
16025,Baignes-Sainte-Radegonde,1241,6580,66358,72938,58.8
63121,Coudes,1241,0,8067,8067,6.5
69233,Saint-Romain-au-Mont-d'Or,1241,0,89733,89733,72.3
22363,Trélévern,1240,0,24634,24634,19.9
28386,Thimert-Gâtelles,1240,0,1659,1659,1.3
28406,Éole-en-Beauce,1240,0,6513,6513,5.3
31028,Aurignac,1240,0,25685,25685,20.7
38003,Agnin,1240,0,31699,31699,25.6
67223,Innenheim,1240,6463,25163,31626,25.5
85296,Treize-Vents,1240,0,15888,15888,12.8
7090,Flaviac,1239,6920,4134,11054,8.9
23031,Boussac,1239,0,18623,18623,15
30325,Sumène,1239,0,26539,26539,21.4
67329,Niedernai,1239,0,25143,25143,20.3
49344,Thorigné-d'Anjou,1238,0,35879,35879,29
14278,Fontenay-le-Pesnel,1237,0,15166,15166,12.3
22107,Bon Repos sur Blavet,1237,0,113912,113912,92.1
33272,Marsas,1237,0,6923,6923,5.6
56109,Lauzach,1237,0,8765,8765,7.1
72340,Souligné-sous-Ballon,1237,0,69507,69507,56.2
9181,Le Mas-d'Azil,1236,0,21983,21983,17.8
25063,Blamont,1236,0,78243,78243,63.3
37175,Nouzilly,1236,8596,5424,14020,11.3
81276,Salvagnac,1236,0,67909,67909,54.9
1229,Malafretaz,1235,0,23876,23876,19.3
3093,Creuzier-le-Neuf,1235,0,33833,33833,27.4
33436,Saint-Magne,1235,0,4390,4390,3.6
35343,Tresbœuf,1235,0,17974,17974,14.6
37049,Chambourg-sur-Indre,1235,0,21438,21438,17.4
45289,Saint-Lyé-la-Forêt,1235,0,3806,3806,3.1
64037,Arbus,1235,0,36464,36464,29.5
71002,L'Abergement-Sainte-Colombe,1235,0,7198,7198,5.8
81317,Villefranche-d'Albigeois,1235,0,15535,15535,12.6
87174,Saint-Paul,1235,0,5083,5083,4.1
89391,Sergines,1235,18610,227,18837,15.3
2439,Les Septvallons,1234,0,2434,2434,2
6015,Berre-les-Alpes,1234,0,34797,34797,28.2
24142,Coux et Bigaroque-Mouzens,1234,7600,60405,68005,55.1
27073,Bois-le-Roi,1234,0,14513,14513,11.8
57356,Kanfen,1234,0,30043,30043,24.3
59134,Cartignies,1234,0,9775,9775,7.9
66160,Reynès,1234,0,51180,51180,41.5
85179,Poiroux,1234,0,24775,24775,20.1
40031,Bégaar,1233,0,29003,29003,23.5
67420,Russ,1233,22650,89229,111879,90.7
72173,Luceau,1233,0,69531,69531,56.4
76392,Londinières,1233,0,9100,9100,7.4
1338,Groslée-Saint-Benoit,1232,0,13731,13731,11.1
8239,Juniville,1232,0,23561,23561,19.1
30165,Méjannes-lès-Alès,1232,0,38509,38509,31.3
81261,Saint-Lieux-lès-Lavaur,1232,0,4024,4024,3.3
26312,Saint-Marcel-lès-Sauzet,1231,0,11861,11861,9.6
27598,Saint-Pierre-du-Vauvray,1231,0,36506,36506,29.7
45049,Bouzy-la-Forêt,1231,0,2393,2393,1.9
27005,Ailly,1230,0,36476,36476,29.7
28027,La Bazoche-Gouet,1230,0,67212,67212,54.6
45097,Chuelles,1230,0,3729,3729,3
59626,Villers-Pol,1230,0,3471,3471,2.8
1390,Saint-Vulbas,1229,368092,20974,389066,316.6
7107,Jaujac,1229,9350,5050,14400,11.7
31249,Labastide-Beauvoir,1229,0,20038,20038,16.3
42115,Jonzieux,1229,0,25145,25145,20.5
49211,Montilliers,1229,45941,51069,97010,78.9
67019,Baldenheim,1229,0,23644,23644,19.2
67097,Dingsheim,1229,4720,23383,28103,22.9
68247,Oderen,1229,0,12770,12770,10.4
72336,Solesmes,1229,0,28583,28583,23.3
1423,Toussieux,1228,0,19449,19449,15.8
30041,Blauzac,1228,0,9436,9436,7.7
40231,Port-de-Lanne,1228,0,9139,9139,7.4
40271,Sainte-Marie-de-Gosse,1228,0,27589,27589,22.5
50149,Couville,1228,0,38626,38626,31.5
76753,Ymare,1228,26147,35076,61223,49.9
77469,Touquin,1228,0,4782,4782,3.9
7126,Lagorce,1227,16350,74925,91275,74.4
11426,Villegly,1227,0,7959,7959,6.5
22204,Ploëzal,1227,0,21971,21971,17.9
27100,Boulleville,1227,0,9168,9168,7.5
53136,La Roche-Neuville,1227,0,55085,55085,44.9
73241,Sainte-Hélène-sur-Isère,1227,0,28944,28944,23.6
74134,Les Gets,1227,2450112,85737,2535849,2066.7
76100,Blainville-Crevon,1227,0,839,839,0.7
88101,Cheniménil,1227,0,1609,1609,1.3
9188,Mercus-Garrabet,1226,0,4733,4733,3.9
31311,La Magdelaine-sur-Tarn,1226,0,0,0,0
35358,La Ville-ès-Nonais,1226,0,29068,29068,23.7
59501,Rieulay,1226,0,14742,14742,12
63354,Saint-Gervais-d'Auvergne,1226,0,1903,1903,1.6
76550,Sahurs,1226,22020,35019,57039,46.5
76684,Tancarville,1226,0,9343,9343,7.6
82042,Cazes-Mondenard,1226,0,38385,38385,31.3
86276,Usson-du-Poitou,1226,14447,49586,64033,52.2
1145,Dompierre-sur-Veyle,1225,0,23682,23682,19.3
31053,Beaupuy,1225,0,29949,29949,24.4
35101,Dourdain,1225,0,4772,4772,3.9
35142,Landéan,1225,0,15000,15000,12.2
45291,Saint-Martin-sur-Ocre,1225,0,15854,15854,12.9
62078,Balinghem,1225,0,7498,7498,6.1
2502,Montcornet,1224,0,13486,13486,11
17265,Nieulle-sur-Seudre,1224,0,28125,28125,23
31575,Vieille-Toulouse,1224,0,19956,19956,16.3
67167,Grendelbruch,1224,0,44459,44459,36.3
5036,Châteauroux-les-Alpes,1223,0,97732,97732,79.9
34343,Viols-le-Fort,1223,0,22788,22788,18.6
40194,Montfort-en-Chalosse,1223,0,19153,19153,15.7
41275,La Ville-aux-Clercs,1223,0,15127,15127,12.4
54036,Avril,1223,0,11355,11355,9.3
57360,Kerbach,1223,0,22358,22358,18.3
59275,Gruson,1223,0,20253,20253,16.6
67173,Griesheim-sur-Souffel,1223,2600,23269,25869,21.2
68240,Illtal,1223,0,32807,32807,26.8
42231,Saint-Germain-Lespinasse,1222,32855,36061,68916,56.4
50388,Orval sur Sienne,1222,0,35357,35357,28.9
67233,Kertzfeld,1222,6362,22593,28955,23.7
24011,Antonne-et-Trigonant,1221,12200,6819,19019,15.6
27263,Le Perrey,1221,0,27581,27581,22.6
28293,Oulins,1221,0,1633,1633,1.3
71333,Oslon,1221,0,33571,33571,27.5
71484,Saint-Usuge,1221,0,5026,5026,4.1
17310,Saint-André-de-Lidon,1220,6440,20324,26764,21.9
53016,Bais,1220,0,8727,8727,7.2
60700,Warluis,1220,0,47840,47840,39.2
8420,Signy-le-Petit,1219,0,31868,31868,26.1
22275,Saint-Barnabé,1219,0,0,0,0
33100,Cars,1219,0,12476,12476,10.2
1431,Vaux-en-Bugey,1218,0,20787,20787,17.1
33465,Saint-Pierre-de-Mons,1218,0,12456,12456,10.2
34223,Puimisson,1218,0,2382,2382,2
46297,Salviac,1218,0,34448,34448,28.3
66127,Opoul-Périllos,1218,0,10145,10145,8.3
67082,Dalhunden,1218,0,14759,14759,12.1
71584,Viré,1218,0,28345,28345,23.3
82050,Dunes,1218,0,130864,130864,107.4
91109,Brières-les-Scellés,1218,0,3068,3068,2.5
32331,Preignan,1217,0,42881,42881,35.2
35138,Laignelet,1217,0,14902,14902,12.2
42324,Veauchette,1217,0,10904,10904,9
59358,Looberghe,1217,0,23439,23439,19.3
60489,Péroy-les-Gombries,1217,0,4765,4765,3.9
71294,Mercurey,1217,20450,33461,53911,44.3
72022,Le Bailleul,1217,0,28303,28303,23.3
76534,Rolleville,1217,0,10977,10977,9
1181,Groissiat,1216,0,45999,45999,37.8
1336,Saint-André-sur-Vieux-Jonc,1216,0,23508,23508,19.3
11418,Villasavary,1216,34007,3600,37607,30.9
36009,Arthon,1216,0,45069,45069,37.1
43010,Arsac-en-Velay,1216,4500,50597,55097,45.3
58260,Saint-Parize-le-Châtel,1216,0,4544,4544,3.7
74262,Scientrier,1216,0,5238,5238,4.3
76090,Beuzeville-la-Grenier,1216,0,9267,9267,7.6
12119,Laguiole,1215,0,41171,41171,33.9
25159,Colombier-Fontaine,1215,0,76914,76914,63.3
59189,Eecke,1215,0,7423,7423,6.1
65350,Oursbelille,1215,0,11607,11607,9.6
69051,Chaussan,1215,13410,38990,52400,43.1
74064,Châtillon-sur-Cluses,1215,0,233436,233436,192.1
76565,Saint-Aubin-sur-Scie,1215,0,14766,14766,12.2
88355,Portieux,1215,0,30554,30554,25.1
12305,Viviez,1214,34782,12199,46981,38.7
17375,Saint-Nazaire-sur-Charente,1214,5659,19992,25651,21.1
26106,La Coucourde,1214,3530,11697,15227,12.5
34214,Pouzolles,1214,0,2375,2375,2
37186,Pont-de-Ruan,1214,0,19325,19325,15.9
41199,Saint-Amand-Longpré,1214,0,15015,15015,12.4
42020,Boisset-lès-Montrond,1214,0,10877,10877,9
76728,La Vaupalière,1214,0,830,830,0.7
81051,Cahuzac-sur-Vère,1214,0,66701,66701,54.9
86120,Lathus-Saint-Rémy,1214,0,49101,49101,40.4
17262,Nieul-lès-Saintes,1213,0,30898,30898,25.5
29224,Pouldergat,1213,0,38478,38478,31.7
66048,Cerbère,1213,0,5009,5009,4.1
76576,Saint-Eustache-la-Forêt,1213,0,9244,9244,7.6
82089,Lamagistère,1213,0,130326,130326,107.4
2093,Blérancourt,1212,0,1200,1200,1
27114,Breuilpont,1212,0,6368,6368,5.3
28398,Unverre,1212,0,66228,66228,54.6
34242,Saint-Bauzille-de-Montmel,1212,21980,22583,44563,36.8
69093,Grandris,1212,0,14326,14326,11.8
80190,Chépy,1212,0,8058,8058,6.6
14355,Ponts sur Seulles,1211,0,14847,14847,12.3
58227,Saint-Amand-en-Puisaye,1211,0,54681,54681,45.2
62882,Wavrans-sur-l'Aa,1211,0,2620,2620,2.2
71149,Couches,1211,0,27095,27095,22.4
85158,Mouzeuil-Saint-Martin,1211,6190,7946,14136,11.7
86221,Saint-Genest-d'Ambière,1211,0,27562,27562,22.8
89227,Ligny-le-Châtel,1211,6345,165,6510,5.4
42334,Violay,1210,5177,21932,27109,22.4
57192,Enchenberg,1210,0,27886,27886,23
76039,Les Authieux-sur-le-Port-Saint-Ouen,1210,0,34562,34562,28.6
76434,Mesnil-Raoul,1210,3106,827,3933,3.3
3043,Broût-Vernet,1209,0,24729,24729,20.5
12286,Vabres-l'Abbaye,1209,0,2533,2533,2.1
32233,Marciac,1209,0,22288,22288,18.4
33195,Grignols,1209,0,402,402,0.3
42283,Saint-Romain-en-Jarez,1209,0,28327,28327,23.4
48127,Monts-de-Randon,1209,52156,14240,66396,54.9
59243,Fontaine-au-Pire,1209,0,8307,8307,6.9
68006,Bernwiller,1209,0,17215,17215,14.2
76250,Étainhus,1209,0,10905,10905,9
89218,Laroche-Saint-Cydroine,1209,3350,42254,45604,37.7
95628,Valmondois,1209,0,31912,31912,26.4
1418,Thil,1208,0,38945,38945,32.2
7322,Thueyts,1208,13635,4964,18599,15.4
68367,Widensolen,1208,3126,20966,24092,19.9
68368,Wihr-au-Val,1208,0,48491,48491,40.1
71520,Sevrey,1208,0,33214,33214,27.5
86193,Pleumartin,1208,0,27493,27493,22.8
27504,Sacquenville,1207,0,14195,14195,11.8
80598,Nouvion,1207,0,29888,29888,24.8
88371,Raon-aux-Bois,1207,0,30353,30353,25.1
19011,Arnac-Pompadour,1206,0,11598,11598,9.6
21315,Hauteville-lès-Dijon,1206,0,34997,34997,29
21699,Villers-les-Pots,1206,0,0,0,0
40180,Meilhan,1206,0,28368,28368,23.5
47086,Duras,1206,37140,59408,96548,80.1
57633,Sarreinsming,1206,0,16482,16482,13.7
60619,Silly-le-Long,1206,0,4722,4722,3.9
64216,Espoey,1206,4288,12589,16877,14
67246,Kogenheim,1206,16138,22297,38435,31.9
73058,La Bridoire,1206,0,1786,1786,1.5
15154,Polminhac,1205,0,5383,5383,4.5
60590,Saint-Omer-en-Chaussée,1205,0,5912,5912,4.9
86077,Civaux,1205,36475,48737,85212,70.7
28135,Droue-sur-Drouette,1204,0,6987,6987,5.8
33028,Baron,1204,0,118875,118875,98.7
35362,Le Tronchet,1204,0,28546,28546,23.7
77292,Messy,1204,0,915,915,0.8
84052,Grambois,1204,0,5402,5402,4.5
2011,Ambleny,1203,0,1158,1158,1
24295,Montrem,1203,0,6557,6557,5.5
30253,Saint-Florent-sur-Auzonnet,1203,0,37603,37603,31.3
76650,Saint-Sauveur-d'Émalleville,1203,0,14246,14246,11.8
1258,Montceaux,1202,0,6204,6204,5.2
26183,Mirabel-et-Blacons,1202,47147,32672,79819,66.4
57194,Entrange,1202,0,29264,29264,24.3
62403,Hallines,1202,0,106978,106978,89
22340,Tonquédec,1201,0,23859,23859,19.9
45006,Ardon,1201,0,10361,10361,8.6
57454,Mécleuves,1201,0,59546,59546,49.6
65223,Horgues,1201,0,11474,11474,9.6
86068,Chaunay,1201,12500,27046,39546,32.9
1444,Villebois,1200,0,20479,20479,17.1
25084,Boussières,1200,4344,21143,25487,21.2
25245,Fontain,1200,1495,21143,22638,18.9
27011,Amfreville-Saint-Amand,1200,0,4916,4916,4.1
38362,Saint-Aupre,1200,0,20386,20386,17
41074,Dhuizon,1200,4683,10013,14696,12.2
62638,Oisy-le-Verger,1200,0,1493,1493,1.2
63236,Mont-Dore,1200,0,8761,8761,7.3
80696,Sains-en-Amiénois,1200,45019,76934,121953,101.6
81297,Terssac,1200,43049,11649,54698,45.6
2798,Viels-Maisons,1199,0,653,653,0.5
34056,Castelnau-de-Guers,1199,0,13317,13317,11.1
41094,Fresnes,1199,10384,22032,32416,27
47169,Moirax,1199,0,27447,27447,22.9
85138,Martinet,1199,0,75799,75799,63.2
87046,Cognac-la-Forêt,1199,11970,527,12497,10.4
90076,Pérouse,1199,2470,41831,44301,36.9
22218,Plougrescant,1198,0,23799,23799,19.9
38190,Hières-sur-Amby,1198,0,6185,6185,5.2
69061,Cogny,1198,11642,25434,37076,30.9
80160,Cagny,1198,0,76805,76805,64.1
6074,Lantosque,1197,0,23566,23566,19.7
25309,Houtaud,1197,0,34214,34214,28.6
30191,Orsan,1197,0,17467,17467,14.6
42175,Pouilly-lès-Feurs,1197,0,21697,21697,18.1
53255,Sainte-Suzanne-et-Chammes,1197,15500,8562,24062,20.1
59545,Saint-Souplet,1197,0,8225,8225,6.9
73129,Grésy-sur-Isère,1197,0,28236,28236,23.6
2540,Nesles-la-Montagne,1196,0,27645,27645,23.1
11018,Arzens,1196,0,7758,7758,6.5
17457,La Devise,1196,3600,49487,53087,44.4
57211,Fèves,1196,0,2428,2428,2
77008,Armentières-en-Brie,1196,0,17561,17561,14.7
85239,Saint-Maixent-sur-Vie,1196,0,2602,2602,2.2
87182,Saint-Sulpice-les-Feuilles,1196,12981,20355,33336,27.9
4045,Céreste-en-Luberon,1195,13350,24358,37708,31.6
24164,Excideuil,1195,22015,15025,37040,31
29079,Henvic,1195,0,71651,71651,60
39199,Domblans,1195,12815,31762,44577,37.3
11301,Puichéric,1194,0,7745,7745,6.5
65198,Gerde,1194,0,8962,8962,7.5
66025,Bourg-Madame,1194,0,0,0,0
77039,Boissise-la-Bertrand,1194,0,16636,16636,13.9
78605,Tacoignières,1194,2440,11972,14412,12.1
79096,Combrand,1194,0,33965,33965,28.4
82018,Bioule,1194,0,9692,9692,8.1
2239,Crézancy,1193,0,27575,27575,23.1
7009,Andance,1193,11535,19639,31174,26.1
2A065,Cargèse,1193,0,5496,5496,4.6
60567,Saint-Aubin-en-Bray,1193,26610,9780,36390,30.5
73231,Saint-Étienne-de-Cuines,1193,0,170919,170919,143.3
7152,Mauves,1192,0,52449,52449,44
10317,Les Riceys,1192,0,20808,20808,17.5
33311,Paillet,1192,0,36551,36551,30.7
56133,Missiriac,1192,0,14501,14501,12.2
68038,Bischwihr,1192,4596,24497,29093,24.4
84136,Vacqueyras,1192,65708,38922,104630,87.8
11285,Peyriac-de-Mer,1191,0,18418,18418,15.5
40246,Sabres,1191,58200,9371,67571,56.7
57119,Buhl-Lorraine,1191,0,7754,7754,6.5
73067,La Chambre,1191,5880,170633,176513,148.2
77141,Coutevroult,1191,0,4638,4638,3.9
80136,Bray-sur-Somme,1191,0,1332,1332,1.1
82031,Castelmayran,1191,0,15296,15296,12.8
89124,Courlon-sur-Yonne,1191,4290,219,4509,3.8
17448,Tonnay-Boutonne,1190,0,33147,33147,27.9
28022,Bailleau-l'Évêque,1190,0,34675,34675,29.1
76707,Tourville-sur-Arques,1190,0,14462,14462,12.2
19100,Lagraulière,1189,5811,22562,28373,23.9
24091,Cénac-et-Saint-Julien,1189,12745,2036,14781,12.4
2B150,Lumio,1189,0,0,0,0
36069,Écueillé,1189,0,14927,14927,12.6
40123,Herm,1189,0,10179,10179,8.6
26155,Lapeyrouse-Mornay,1188,4993,19557,24550,20.7
27548,Saint-Germain-sur-Avre,1188,0,13972,13972,11.8
46156,Bellefont-La Rauze,1188,0,10031,10031,8.4
50648,Yvetot-Bocage,1188,3598,37368,40966,34.5
57101,Bousbach,1188,0,21718,21718,18.3
57156,Courcelles-sur-Nied,1188,0,2893,2893,2.4
60678,Villeneuve-les-Sablons,1188,5251,3822,9073,7.6
64374,Mazerolles,1188,0,18601,18601,15.7
30171,Molières-sur-Cèze,1187,0,48178,48178,40.6
31580,Villate,1187,0,1474,1474,1.2
47283,Saint-Vite,1187,0,6838,6838,5.8
60074,Blaincourt-lès-Précy,1187,0,4930,4930,4.2
91284,Les Granges-le-Roi,1187,0,6900,6900,5.8
1235,Marlieux,1186,0,247,247,0.2
2397,Jussy,1186,0,169506,169506,142.9
3126,Hauterive,1186,0,32490,32490,27.4
22199,Pleumeur-Gautier,1186,0,23561,23561,19.9
32155,Le Houga,1186,29807,789,30596,25.8
38218,Marcilloles,1186,0,12939,12939,10.9
50647,Yquelon,1186,0,28703,28703,24.2
53100,Fougerolles-du-Plessis,1186,0,15637,15637,13.2
69071,Curis-au-Mont-d'Or,1186,0,85756,85756,72.3
71325,La Motte-Saint-Jean,1186,0,4598,4598,3.9
21353,Longecourt-en-Plaine,1185,0,27,27,0
32079,Castelnau d'Auzan Labarrère,1185,0,0,0,0
33317,Périssac,1185,0,17836,17836,15.1
41231,Saint-Viâtre,1185,7968,9888,17856,15.1
43163,Riotord,1185,4771,9490,14261,12
57514,Nousseviller-Saint-Nabor,1185,0,21663,21663,18.3
59445,Ohain,1185,6801,19440,26241,22.1
7182,Prades,1184,9420,4865,14285,12.1
16153,Mainxe-Gondeville,1184,732,44300,45032,38
24516,Salignac-Eyvigues,1184,9600,4530,14130,11.9
38473,Sardieu,1184,0,12917,12917,10.9
39017,Arlay,1184,450,31470,31920,27
67408,Romanswiller,1184,13660,64306,77966,65.8
29263,Saint-Ségal,1183,0,18644,18644,15.8
61494,Trun,1183,19300,2499,21799,18.4
77001,Achères-la-Forêt,1183,0,9849,9849,8.3
23095,Le Grand-Bourg,1182,0,6546,6546,5.5
32162,Jegun,1182,0,41648,41648,35.2
53141,Louvigné,1182,0,51441,51441,43.5
56207,Saint-Barthélemy,1182,0,2776,2776,2.3
76558,Saint-Aubin-Celloville,1182,0,33762,33762,28.6
7342,Villevocance,1181,0,6084,6084,5.2
12215,Saint-Christophe-Vallon,1181,0,48731,48731,41.3
14740,La Vespière-Friardel,1181,0,13146,13146,11.1
38323,Pressins,1181,0,10356,10356,8.8
53200,Saint-Baudelle,1181,0,43887,43887,37.2
74057,Champanges,1181,8476,61189,69665,59
90023,Chaux,1181,7190,35178,42368,35.9
6137,Spéracèdes,1180,0,30128,30128,25.5
28158,Fontenay-sur-Eure,1180,0,34384,34384,29.1
79133,Germond-Rouvre,1180,0,15904,15904,13.5
32149,Gondrin,1179,0,0,0,0
38556,Ville-sous-Anjou,1179,0,30139,30139,25.6
39171,Courlaoux,1179,2000,37156,39156,33.2
53224,Saint-Germain-le-Fouilloux,1179,0,51310,51310,43.5
60120,Cambronne-lès-Clermont,1179,0,6253,6253,5.3
76499,Petiville,1179,0,8985,8985,7.6
86124,Lavoux,1179,0,70244,70244,59.6
95088,Bonneuil-en-France,1179,0,14621,14621,12.4
24328,Piégut-Pluviers,1178,11220,7894,19114,16.2
47300,Sérignac-sur-Garonne,1178,0,26967,26967,22.9
62792,Serques,1178,0,104842,104842,89
64320,Laruns,1178,87153,14952,102105,86.7
69067,Courzieu,1178,0,9402,9402,8
69077,Dracé,1178,17546,0,17546,14.9
14001,Ablon,1177,0,8794,8794,7.5
26071,Chanos-Curson,1177,16794,51789,68583,58.3
31224,Gourdan-Polignan,1177,0,11267,11267,9.6
47016,Aubiac,1177,0,26944,26944,22.9
68095,Fortschwihr,1177,3598,24189,27787,23.6
2296,Étreillers,1176,0,10655,10655,9.1
15188,Saint-Georges,1176,8245,26012,34257,29.1
32290,Montréal,1176,0,4522,4522,3.8
34094,Espondeilhan,1176,0,6813,6813,5.8
45228,Nibelle,1176,0,8913,8913,7.6
78620,Toussus-le-Noble,1176,0,9747,9747,8.3
85094,Foussais-Payré,1176,13410,7716,21126,18
60628,Therdonne,1175,0,46075,46075,39.2
69214,Saint-Jean-la-Bussière,1175,0,13888,13888,11.8
71412,Saint-Eusèbe,1175,0,18880,18880,16.1
71523,Simard,1175,0,4837,4837,4.1
77209,Gouvernes,1175,0,2905,2905,2.5
79038,Boismé,1175,0,33425,33425,28.4
82132,Montricoux,1175,0,9538,9538,8.1
32425,Ségoufielle,1174,12410,83516,95926,81.7
19062,Corrèze,1173,8242,22258,30500,26
53048,Chailland,1173,0,5331,5331,4.5
57083,Bining,1173,0,27034,27034,23
61375,Boischampré,1173,6266,2478,8744,7.5
2B281,Sisco,1172,6000,42981,48981,41.8
44039,Cheix-en-Retz,1172,1875,35727,37602,32.1
59326,Killem,1172,0,22572,22572,19.3
3286,Toulon-sur-Allier,1171,0,15763,15763,13.5
18028,Berry-Bouy,1171,3500,22429,25929,22.1
35212,Pancé,1171,0,17042,17042,14.6
38246,Montagnieu,1171,0,10269,10269,8.8
41258,Thésée,1171,13955,21518,35473,30.3
63180,Joze,1171,0,5380,5380,4.6
66214,Tresserre,1171,0,15696,15696,13.4
76621,Saint-Martin-Osmonville,1171,0,27355,27355,23.4
77439,Salins,1171,0,828,828,0.7
17285,Port-d'Envaux,1170,0,29803,29803,25.5
22002,Andel,1170,87680,14122,101802,87
24479,Saint-Pardoux-la-Rivière,1170,10850,7840,18690,16
37176,Noyant-de-Touraine,1170,0,31746,31746,27.1
39235,Fraisans,1170,36300,18463,54763,46.8
83145,Varages,1170,0,12001,12001,10.3
2187,Chierry,1169,0,27021,27021,23.1
50585,Surtainville,1169,11725,36770,48495,41.5
68235,Niederhergheim,1169,10641,9226,19867,17
69083,Éveux,1169,0,9331,9331,8
77528,Voisenon,1169,0,16288,16288,13.9
91599,Soisy-sur-École,1169,0,40729,40729,34.8
7292,Saint-Romain-d'Ay,1168,6529,3302,9831,8.4
21351,Longchamp,1168,0,26,26,0
27037,Barc,1168,0,5035,5035,4.3
48103,Montrodat,1168,4900,27846,32746,28
74063,Châtel,1168,1875667,60515,1936182,1657.7
2A092,Conca,1167,0,27215,27215,23.3
59026,Aubigny-au-Bac,1167,0,16260,16260,13.9
63396,Saint-Saturnin,1167,0,20919,20919,17.9
69170,Rontalon,1167,0,37450,37450,32.1
76254,Étretat,1167,0,10526,10526,9
90071,Montreux-Château,1167,9050,40714,49764,42.6
16370,Sireuil,1166,0,30314,30314,26
27108,Bourth,1166,0,32792,32792,28.1
29136,Locunolé,1166,0,40059,40059,34.4
29168,Plogoff,1166,0,83453,83453,71.6
30140,Lasalle,1166,0,58328,58328,50
33441,Saint-Martin-Lacaussade,1166,0,11934,11934,10.2
35259,Saint-Broladre,1166,0,9916,9916,8.5
50029,Barenton,1166,0,28689,28689,24.6
62595,Moulle,1166,0,103774,103774,89
74283,Thusy,1166,11186,15790,26976,23.1
84020,Bonnieux,1166,0,23767,23767,20.4
85200,Saint-Avaugourd-des-Landes,1166,0,23410,23410,20.1
1098,Chazey-Bons,1165,0,12984,12984,11.1
1123,Cormoranche-sur-Saône,1165,0,4718,4718,4
45259,Quiers-sur-Bezonde,1165,0,11945,11945,10.3
76657,Saint-Vigor-d'Ymonville,1165,0,10508,10508,9
3301,Vaux,1164,0,1627,1627,1.4
27439,Normanville,1164,0,13690,13690,11.8
42293,Saint-Victor-sur-Rhins,1164,7550,32998,40548,34.8
53267,Vaiges,1164,0,8326,8326,7.2
61075,Ceaucé,1164,7256,14445,21701,18.6
63072,Chabreloche,1164,0,26988,26988,23.2
72073,Chaufour-Notre-Dame,1164,0,23813,23813,20.5
84044,Entrechaux,1164,0,1362,1362,1.2
89208,Joux-la-Ville,1164,11604,5619,17223,14.8
17044,Berneuil,1163,0,19374,19374,16.7
33052,Les Billaux,1163,0,22686,22686,19.5
73263,Saint-Offenge,1163,3586,6434,10020,8.6
74052,Cernex,1163,12900,20908,33808,29.1
88032,Ban-de-Laveline,1163,0,11307,11307,9.7
2A300,San-Gavino-di-Carbini,1162,9543,27098,36641,31.5
38555,Villeneuve-de-Marc,1162,0,12677,12677,10.9
40307,Sore,1162,0,9143,9143,7.9
71004,Allériot,1162,8281,13409,21690,18.7
5045,Crots,1161,0,92777,92777,79.9
22101,Langoat,1161,0,23064,23064,19.9
25156,Pays-de-Clerval,1161,0,2678,2678,2.3
36140,Neuvy-Pailloux,1161,7844,23582,31426,27.1
38351,Saint-Agnin-sur-Bion,1161,0,12667,12667,10.9
49330,Sceaux-d'Anjou,1161,8920,33647,42567,36.7
54403,Norroy-lès-Pont-à-Mousson,1161,0,12685,12685,10.9
63093,Charbonnières-les-Vieilles,1161,0,7659,7659,6.6
66167,Saillagouse,1161,0,0,0,0
72053,Challes,1161,0,73993,73993,63.7
73286,Serrières-en-Chautagne,1161,0,6423,6423,5.5
76020,Anneville-Ambourville,1161,0,33162,33162,28.6
76295,Gaillefontaine,1161,0,21932,21932,18.9
85014,Bazoges-en-Pareds,1161,70875,25368,96243,82.9
87122,Razès,1161,0,1881,1881,1.6
22105,Languenan,1160,0,30903,30903,26.6
27378,La Madeleine-de-Nonancourt,1160,0,1552,1552,1.3
45227,Nevoy,1160,0,15013,15013,12.9
63203,Malauzat,1160,0,8773,8773,7.6
74038,Bogève,1160,0,18636,18636,16.1
77440,Sammeron,1160,0,4518,4518,3.9
11210,Luc-sur-Orbieu,1159,16622,15703,32325,27.9
42253,Saint-Léger-sur-Roanne,1159,1337,34202,35539,30.7
57104,Boust,1159,0,28217,28217,24.3
60423,Montmacq,1159,0,5889,5889,5.1
61324,Passais Villages,1159,7950,14383,22333,19.3
69165,Régnié-Durette,1159,24661,0,24661,21.3
71289,Matour,1159,18674,15750,34424,29.7
77519,Villiers-Saint-Georges,1159,0,4179,4179,3.6
78033,Aulnay-sur-Mauldre,1159,0,10787,10787,9.3
87082,Ladignac-le-Long,1159,2690,35494,38184,32.9
19037,Chamboulive,1158,0,21973,21973,19
28332,Sainte-Gemme-Moronval,1158,0,1549,1549,1.3
24409,Saint-Front-de-Pradoux,1157,11650,55402,67052,58
28253,Mignières,1157,0,33714,33714,29.1
34328,Vendémian,1157,13260,6249,19509,16.9
38026,La Balme-les-Grottes,1157,0,5973,5973,5.2
59130,Cappelle-Brouck,1157,0,22283,22283,19.3
63201,Luzillat,1157,0,4729,4729,4.1
74240,Saint-Jean-de-Tholome,1157,0,6047,6047,5.2
76291,Froberville,1157,0,7508,7508,6.5
85188,La Réorthe,1157,9867,24453,34320,29.7
14026,Audrieu,1156,0,14173,14173,12.3
22240,Plumaugat,1156,0,30796,30796,26.6
31261,Lafitte-Vigordane,1156,0,1988,1988,1.7
38373,Saint-Cassien,1156,0,19639,19639,17
56030,Camoël,1156,0,16010,16010,13.8
60464,Nointel,1156,18896,6131,25027,21.6
64518,Sendets,1156,13065,34132,47197,40.8
68379,Wolfgantzen,1156,0,20063,20063,17.4
86007,Antran,1156,0,26310,26310,22.8
22021,Brusvily,1155,0,30770,30770,26.6
24296,Mouleydier,1155,5575,25713,31288,27.1
28309,Prunay-le-Gillon,1155,0,33655,33655,29.1
41126,Mareuil-sur-Cher,1155,0,21224,21224,18.4
41207,Saint-Dyé-sur-Loire,1155,2230,8092,10322,8.9
42062,Chevrières,1155,5514,57891,63405,54.9
42239,Saint-Jean-Saint-Maurice-sur-Loire,1155,2532,34083,36615,31.7
60666,Ver-sur-Launette,1155,0,4522,4522,3.9
66056,Corbère-les-Cabanes,1155,0,1558,1558,1.3
67360,Ohnenheim,1155,6000,24329,30329,26.3
1365,Saint-Jean-sur-Veyle,1154,0,4674,4674,4.1
12066,Clairvaux-d'Aveyron,1154,0,47617,47617,41.3
21352,Longeault-Pluvault,1154,0,26,26,0
22371,Trémorel,1154,0,0,0,0
29276,Sibiril,1154,7260,2193,9453,8.2
38471,Le Sappey-en-Chartreuse,1154,0,44579,44579,38.6
46083,Cressensac-Sarrazac,1154,0,37650,37650,32.6
60034,Avrechy,1154,0,6394,6394,5.5
68260,Raedersheim,1154,0,28478,28478,24.7
7127,Lalevade-d'Ardèche,1153,10099,4738,14837,12.9
23013,Auzances,1153,0,15137,15137,13.1
29205,Plounévézel,1153,0,38992,38992,33.8
69257,Vaux-en-Beaujolais,1153,7703,24479,32182,27.9
80485,Ô-de-Selle,1153,0,1592,1592,1.4
57505,Niderviller,1152,0,7500,7500,6.5
68317,Soultzeren,1152,0,46243,46243,40.1
40288,Sarbazan,1151,0,13146,13146,11.4
51346,Mareuil-le-Port,1151,0,1666,1666,1.4
54437,Pulligny,1151,0,11722,11722,10.2
59546,Saint-Sylvestre-Cappel,1151,0,7032,7032,6.1
60504,Ponchon,1151,0,4781,4781,4.2
77221,Guermantes,1151,0,2845,2845,2.5
1010,Anglefort,1150,0,27777,27777,24.2
10100,Clérey,1150,0,16422,16422,14.3
16163,Hiersac,1150,1650,43028,44678,38.9
42162,Ouches,1150,0,33936,33936,29.5
57171,Delme,1150,0,3806,3806,3.3
65395,Saint-Pé-de-Bigorre,1150,0,10986,10986,9.6
80235,Dargnies,1150,8790,3307,12097,10.5
19207,Saint-Germain-les-Vergnes,1149,0,21803,21803,19
22234,Plouvara,1149,0,23270,23270,20.3
39016,Arinthod,1149,20248,33439,53687,46.7
63131,Culhat,1149,0,5279,5279,4.6
2497,Mons-en-Laonnois,1148,0,43842,43842,38.2
38161,Faramans,1148,0,12525,12525,10.9
38499,Susville,1148,0,12020,12020,10.5
59622,Villers-en-Cauchies,1148,0,14922,14922,13
62164,Bourlon,1148,0,1428,1428,1.2
87054,Cussac,1148,6358,505,6863,6
87146,Saint-Germain-les-Belles,1148,20048,18408,38456,33.5
11144,Fitou,1147,39700,1766,41466,36.2
19094,Juillac,1147,11020,18306,29326,25.6
24156,La Douze,1147,0,6406,6406,5.6
26138,La Garde-Adhémar,1147,0,17734,17734,15.5
60006,Les Ageux,1147,0,1676,1676,1.5
69239,Saint-Vérand,1147,34374,10337,44711,39
76001,Allouville-Bellefosse,1147,22798,2122,24920,21.7
76382,Lanquetot,1147,0,8741,8741,7.6
87119,Pierre-Buffière,1147,7606,18392,25998,22.7
16385,Touvre,1146,0,29794,29794,26
33261,Lussac,1146,0,44523,44523,38.9
33541,Vensac,1146,0,1107,1107,1
62265,Delettes,1146,0,101994,101994,89
62793,Servins,1146,0,30873,30873,26.9
86112,L'Isle-Jourdain,1146,0,46351,46351,40.4
89046,Bléneau,1146,13840,51746,65586,57.2
7079,Désaignes,1145,28982,32782,61764,53.9
42248,Saint-Just-en-Chevalet,1145,900,21479,22379,19.5
1151,Druillat,1144,0,22116,22116,19.3
17441,Tesson,1144,3850,19058,22908,20
45293,Saint-Maurice-sur-Fessard,1144,0,15412,15412,13.5
68222,Muespach-le-Haut,1144,0,30688,30688,26.8
85062,Châteauneuf,1144,0,7639,7639,6.7
85099,Le Girouard,1144,0,72322,72322,63.2
85176,Pissotte,1144,8350,7506,15856,13.9
85247,Saint-Martin-des-Tilleuls,1144,0,14658,14658,12.8
21458,Noiron-sous-Gevrey,1143,0,5481,5481,4.8
22008,Bobital,1143,0,30450,30450,26.6
42246,Saint-Julien-Molin-Molette,1143,0,23386,23386,20.5
77512,Villeneuve-sur-Bellot,1143,0,18822,18822,16.5
86083,Coulombiers,1143,0,68099,68099,59.6
88247,Igney,1143,0,28743,28743,25.1
4096,Jausiers,1142,137560,341054,478614,419.1
7145,Lussas,1142,8996,35424,44420,38.9
11286,Peyriac-Minervois,1142,0,7407,7407,6.5
15215,Saint-Simon,1142,16970,38693,55663,48.7
22385,La Vicomté-sur-Rance,1142,0,30423,30423,26.6
34254,Saint-Félix-de-Lodez,1142,0,1301,1301,1.1
37171,Noizay,1142,6672,30997,37669,33
38465,Saint-Victor-de-Morestel,1142,0,5896,5896,5.2
45035,Boiscommun,1142,0,8655,8655,7.6
72151,Juigné-sur-Sarthe,1142,0,26559,26559,23.3
80296,L'Étoile,1142,0,1965,1965,1.7
1022,Artemare,1141,0,12717,12717,11.1
2089,Billy-sur-Aisne,1141,0,9546,9546,8.4
3040,Bressolles,1141,0,15359,15359,13.5
7198,Rompon,1141,0,3807,3807,3.3
62474,Isques,1141,0,38571,38571,33.8
67206,Hoffen,1141,0,31439,31439,27.6
68010,Aspach,1141,5540,30608,36148,31.7
71506,Savigny-en-Revermont,1141,0,2133,2133,1.9
1386,Saint-Sorlin-en-Bugey,1140,0,19455,19455,17.1
14707,Tourville-sur-Odon,1140,0,25367,25367,22.3
22212,Plouëc-du-Trieux,1140,0,20413,20413,17.9
22280,Saint-Carné,1140,0,30370,30370,26.6
24218,Jumilhac-le-Grand,1140,17450,3761,21211,18.6
33547,Villandraut,1140,0,11658,11658,10.2
45009,Aschères-le-Marché,1140,0,3513,3513,3.1
52405,Le Montsaugeonnais,1140,0,14119,14119,12.4
60017,Ansauvillers,1140,0,25708,25708,22.6
41101,Herbault,1139,0,43653,43653,38.3
54400,Nomeny,1139,0,6740,6740,5.9
63085,Chapdes-Beaufort,1139,0,38516,38516,33.8
74158,Machilly,1139,0,18202,18202,16
82052,Escatalens,1139,0,9918,9918,8.7
3140,Lavault-Sainte-Anne,1138,0,26787,26787,23.5
26023,Barbières,1138,2200,23068,25268,22.2
31162,Donneville,1138,0,18554,18554,16.3
37272,Villandry,1138,17550,13464,31014,27.3
57655,Solgne,1138,0,43580,43580,38.3
76374,Incheville,1138,0,3273,3273,2.9
26121,Espeluche,1137,6100,10955,17055,15
27470,Pont-Saint-Pierre,1137,0,7481,7481,6.6
32459,Valence-sur-Baïse,1137,0,4372,4372,3.8
33260,Lugos,1137,0,4041,4041,3.6
38011,Anthon,1137,0,1270,1270,1.1
59323,Jenlain,1137,0,3209,3209,2.8
82080,Labastide-du-Temple,1137,0,5797,5797,5.1
21638,Til-Châtel,1136,4634,16169,20803,18.3
27170,Cormeilles,1136,0,17494,17494,15.4
41052,Chitenay,1136,0,43538,43538,38.3
43141,Montfaucon-en-Velay,1136,10213,9098,19311,17
56073,Guémené-sur-Scorff,1136,0,36311,36311,32
64396,Mont,1136,167112,30588,197700,174
74015,Arbusigny,1136,0,4893,4893,4.3
77027,Beaumont-du-Gâtinais,1136,0,1197,1197,1.1
77232,Isles-lès-Villenoy,1136,0,15492,15492,13.6
3247,Saint-Menoux,1135,0,17435,17435,15.4
17100,Chérac,1135,0,35972,35972,31.7
29029,Cléden-Poher,1135,12069,38383,50452,44.5
29035,Coat-Méal,1135,0,8888,8888,7.8
38198,Jarcieu,1135,0,29015,29015,25.6
57202,Etzling,1135,0,20749,20749,18.3
69036,Cercié,1135,3080,0,3080,2.7
71250,Laizé,1135,0,28991,28991,25.5
77280,Mary-sur-Marne,1135,0,16666,16666,14.7
82173,Saint-Sardos,1135,0,15231,15231,13.4
21632,Thorey-en-Plaine,1134,0,26,26,0
22384,Uzel,1134,0,0,0,0
23189,Saint-Dizier-Masbaraud,1134,0,35557,35557,31.4
2B143,Linguizzetta,1134,86100,8634,94734,83.5
31098,Cadours,1134,18980,9486,28466,25.1
33046,Bernos-Beaulac,1134,5500,377,5877,5.2
38481,Sérézin-de-la-Tour,1134,0,13780,13780,12.2
41044,Châtres-sur-Cher,1134,0,23895,23895,21.1
45144,Férolles,1134,0,2205,2205,1.9
46045,Cajarc,1134,0,33488,33488,29.5
54162,Domgermain,1134,0,2366,2366,2.1
57414,Lorquin,1134,0,7383,7383,6.5
64301,Lagor,1134,0,30534,30534,26.9
80606,Oisemont,1134,0,1566,1566,1.4
86268,Tercé,1134,5105,67563,72668,64.1
5101,Vallouise-Pelvoux,1133,0,78152,78152,69
24172,Les Eyzies,1133,20030,15728,35758,31.6
39297,Longchaumois,1133,17962,4332,22294,19.7
41262,Tour-en-Sologne,1133,200,7938,8138,7.2
47060,Caudecoste,1133,0,25937,25937,22.9
56105,Lanvénégen,1133,0,36215,36215,32
57061,Béning-lès-Saint-Avold,1133,0,36122,36122,31.9
57254,Gorze,1133,0,6764,6764,6
59257,Fromelles,1133,0,18762,18762,16.6
60355,Laversines,1133,0,44428,44428,39.2
63204,Malintrat,1133,0,8568,8568,7.6
64086,Ayherre,1133,50105,29442,79547,70.2
69155,Pomeys,1133,7402,56788,64190,56.7
22279,Saint-Caradec,1132,0,0,0,0
25555,Taillecourt,1132,0,71660,71660,63.3
27133,Caumont,1132,0,4638,4638,4.1
31346,Mirepoix-sur-Tarn,1132,0,0,0,0
32252,Miélan,1132,0,17163,17163,15.2
38433,Saint-Nizier-du-Moucherotte,1132,22245,134009,156254,138
43223,Saint-Romain-Lachalm,1132,0,9066,9066,8
54383,Mont-sur-Meurthe,1132,0,4677,4677,4.1
56035,Caro,1132,0,13772,13772,12.2
68001,Algolsheim,1132,0,19647,19647,17.4
71491,Saint-Yan,1132,0,4389,4389,3.9
71513,Senozan,1132,4760,28915,33675,29.7
83051,Entrecasteaux,1132,0,42412,42412,37.5
95658,Vigny,1132,0,52011,52011,45.9
1325,Rignieux-le-Franc,1131,0,19302,19302,17.1
34197,Péret,1131,0,1289,1289,1.1
40286,Samadet,1131,0,26131,26131,23.1
40309,Souprosse,1131,0,26604,26604,23.5
45307,La Selle-sur-le-Bied,1131,0,3429,3429,3
62458,Houlle,1131,0,100659,100659,89
79242,Voulmentin,1131,0,32173,32173,28.4
11103,Couiza,1130,0,14875,14875,13.2
18004,Allogny,1130,0,8563,8563,7.6
67400,Riedseltz,1130,0,124507,124507,110.2
86010,Aslonnes,1130,4250,25818,30068,26.6
3104,Doyet,1129,0,40334,40334,35.7
8343,Pouru-Saint-Remy,1129,0,25934,25934,23
56228,Saint-Marcel,1129,0,13735,13735,12.2
60015,Angy,1129,0,4689,4689,4.2
62836,Vaudricourt,1129,0,18631,18631,16.5
62811,Thérouanne,1128,0,100392,100392,89
63397,Saint-Sauves-d'Auvergne,1128,0,3531,3531,3.1
71481,Saint-Symphorien-d'Ancelles,1128,3826,28813,32639,28.9
24490,Saint Privat en Périgord,1127,7595,3941,11536,10.2
24543,Sourzac,1127,7300,6143,13443,11.9
28325,Saint-Aubin-des-Bois,1127,0,32839,32839,29.1
32012,Aubiet,1127,0,14316,14316,12.7
49272,Saint-Clément-des-Levées,1127,0,10980,10980,9.7
63143,Effiat,1127,0,4606,4606,4.1
23219,Saint-Maurice-la-Souterraine,1126,0,21311,21311,18.9
40080,Cazères-sur-l'Adour,1126,0,5261,5261,4.7
43102,Grazac,1126,14380,26394,40774,36.2
60405,Moliens,1126,0,5524,5524,4.9
79116,Faye-l'Abbesse,1126,0,32031,32031,28.4
2135,Buironfosse,1125,0,20061,20061,17.8
11022,Azille,1125,0,7297,7297,6.5
37001,Abilly,1125,8339,19528,27867,24.8
46191,Mercuès,1125,0,9499,9499,8.4
61294,Mortrée,1125,12587,7058,19645,17.5
74003,Alex,1125,5341,57147,62488,55.5
74266,Servoz,1125,7207,498348,505555,449.4
3053,Chantelle,1124,0,22990,22990,20.5
14406,Moulins-en-Bessin,1124,0,13780,13780,12.3
28233,Marboué,1124,0,61419,61419,54.6
44138,Puceul,1124,0,17889,17889,15.9
44207,Trans-sur-Erdre,1124,0,13733,13733,12.2
45245,Ouzouer-sur-Trézée,1124,0,13084,13084,11.6
53170,Oisseau,1124,0,14820,14820,13.2
62712,Rivière,1124,0,31614,31614,28.1
67310,Mussig,1124,0,21624,21624,19.2
71119,Chaudenay,1124,0,4888,4888,4.3
1189,Injoux-Génissiat,1123,0,13524,13524,12
28099,Chuisnes,1123,0,4155,4155,3.7
37052,Chançay,1123,3140,20060,23200,20.7
59608,Vendegies-sur-Écaillon,1123,0,283,283,0.3
81283,Senouillac,1123,0,61701,61701,54.9
90001,Andelnans,1123,10555,39179,49734,44.3
1388,Saint-Trivier-de-Courtes,1122,0,21691,21691,19.3
1454,Virignin,1122,0,12505,12505,11.1
5151,Saint-Martin-de-Queyrières,1122,0,77393,77393,69
25508,Roulans,1122,0,55927,55927,49.8
49364,Vaudelnay,1122,0,10931,10931,9.7
59478,Quaëdypre,1122,0,21609,21609,19.3
19082,Favars,1121,0,21271,21271,19
28357,Saint-Piat,1121,0,6505,6505,5.8
30299,Saint-Siffret,1121,0,8614,8614,7.7
31553,Thil,1121,0,9377,9377,8.4
35302,Saint-Onen-la-Chapelle,1121,0,21767,21767,19.4
37193,Restigné,1121,0,10399,10399,9.3
59214,Estrées,1121,0,15619,15619,13.9
64400,Montaut,1121,2770,11988,14758,13.2
74302,Les Villards-sur-Thônes,1121,0,56944,56944,50.8
84028,Cairanne,1121,0,1311,1311,1.2
3173,Molinet,1120,0,4342,4342,3.9
12001,Agen-d'Aveyron,1120,0,20188,20188,18
33014,Les Artigues-de-Lussac,1120,0,43513,43513,38.9
33174,Fronsac,1120,0,16858,16858,15.1
33552,Virelade,1120,0,34343,34343,30.7
36224,Tournon-Saint-Martin,1120,0,6157,6157,5.5
39339,Chassal-Molinges,1120,122941,4123,127064,113.4
54171,Doncourt-lès-Conflans,1120,0,10399,10399,9.3
54518,Thiaucourt-Regniéville,1120,0,6686,6686,6
76043,Auzebosc,1120,0,2072,2072,1.8
77435,Saint-Sauveur-sur-École,1120,0,9325,9325,8.3
14558,Saint-Aubin-d'Arquenay,1119,0,24900,24900,22.3
22188,Plerneuf,1119,0,22662,22662,20.3
27238,Ferrières-Haut-Clocher,1119,0,9955,9955,8.9
28405,Vert-en-Drouais,1119,0,1497,1497,1.3
33221,Lamothe-Landerron,1119,0,9110,9110,8.1
77162,Doue,1119,0,18427,18427,16.5
80442,Hombleux,1119,0,21328,21328,19.1
86145,Marçay,1119,0,25567,25567,22.8
17411,Saint-Trojan-les-Bains,1118,78475,121107,199582,178.5
27474,Poses,1118,0,33155,33155,29.7
30131,Goudargues,1118,0,16314,16314,14.6
37228,Saint-Nicolas-de-Bourgueil,1118,0,10371,10371,9.3
42322,La Valla-en-Gier,1118,0,26195,26195,23.4
51025,Auménancourt,1118,0,19869,19869,17.8
60069,Betz,1118,0,4377,4377,3.9
61232,Lonlay-l'Abbaye,1118,7030,37773,44803,40.1
76673,Servaville-Salmonville,1118,0,764,764,0.7
76727,Vatteville-la-Rue,1118,0,8520,8520,7.6
80552,Moislains,1118,0,8010,8010,7.2
85009,Auchay-sur-Vendée,1118,7175,7335,14510,13
1061,Brens,1117,0,12449,12449,11.1
10298,Pont-sur-Seine,1117,3390,6903,10293,9.2
27390,Marcilly-la-Campagne,1117,0,13137,13137,11.8
28302,Pontgouin,1117,0,4133,4133,3.7
38279,Notre-Dame-de-Mésage,1117,0,43150,43150,38.6
40019,Aureilhan,1117,0,6112,6112,5.5
7317,Talencieux,1116,3593,5750,9343,8.4
22337,Sévignac,1116,5055,13470,18525,16.6
24147,Cubjac-Auvézère-Val d'Ans,1116,5600,14031,19631,17.6
29229,Quéménéven,1116,0,35825,35825,32.1
31583,Villematier,1116,0,0,0,0
54186,Eulmont,1116,0,6604,6604,5.9
71558,Varennes-Saint-Sauveur,1116,0,4594,4594,4.1
74048,Brenthonne,1116,5730,48587,54317,48.7
4123,Mison,1115,53484,33241,86725,77.8
11091,Chalabre,1115,0,12249,12249,11
29062,Gouézec,1115,0,17573,17573,15.8
30260,Saint-Hilaire-d'Ozilhan,1115,0,4383,4383,3.9
34293,La Salvetat-sur-Agout,1115,112385,19726,132111,118.5
41294,Villiers-sur-Loir,1115,0,13791,13791,12.4
76390,Les Loges,1115,0,7235,7235,6.5
87088,Magnac-Bourg,1115,35789,17879,53668,48.1
3111,Estivareilles,1114,0,1557,1557,1.4
4034,La Brillanne,1114,0,12949,12949,11.6
7236,Saint-Félicien,1114,11470,49017,60487,54.3
18165,Neuvy-sur-Barangeon,1114,8550,16095,24645,22.1
18235,Sainte-Solange,1114,0,8442,8442,7.6
27654,Tourville-la-Campagne,1114,0,4791,4791,4.3
38310,Poliénas,1114,0,18003,18003,16.2
39501,Sampans,1114,2532,22610,25142,22.6
44016,La Boissière-du-Doré,1114,2060,11537,13597,12.2
51328,Loisy-sur-Marne,1114,0,17572,17572,15.8
66150,Prats-de-Mollo-la-Preste,1114,0,0,0,0
2566,Ognes,1113,0,19998,19998,18
12105,La Fouillade,1113,0,3246,3246,2.9
59639,Wargnies-le-Grand,1113,0,3141,3141,2.8
78460,Oinville-sur-Montcient,1113,0,10359,10359,9.3
79208,La Peyratte,1113,0,29181,29181,26.2
90065,Lepuix,1113,0,33152,33152,29.8
7295,Saint-Sauveur-de-Montagut,1112,17300,3710,21010,18.9
17121,La Couarde-sur-Mer,1112,15550,68662,84212,75.7
47306,Le Temple-sur-Lot,1112,0,8974,8974,8.1
87081,Jourgnac,1112,0,517,517,0.5
18246,Savigny-en-Sancerre,1111,13090,20016,33106,29.8
43058,La Chapelle-d'Aurec,1111,3672,100329,104001,93.6
43130,Mazet-Saint-Voy,1111,9682,25450,35132,31.6
62350,Fouquières-lès-Béthune,1111,0,18334,18334,16.5
78451,Nézel,1111,0,10340,10340,9.3
79025,Azay-sur-Thouet,1111,0,29128,29128,26.2
89461,Villeneuve-l'Archevêque,1111,23454,2154,25608,23
1452,Virieu-le-Grand,1110,0,12371,12371,11.1
21105,Bressey-sur-Tille,1110,0,32211,32211,29
37278,Villeperdue,1110,0,17669,17669,15.9
41237,Sassay,1110,0,20397,20397,18.4
47068,Cocumont,1110,0,11484,11484,10.3
85169,Palluau,1110,0,9478,9478,8.5
88012,Archettes,1110,0,27914,27914,25.1
5164,Savines-le-Lac,1109,0,88622,88622,79.9
11356,Saint-Martin-Lalande,1109,0,9745,9745,8.8
31082,Bourg-Saint-Bernard,1109,23962,5409,29371,26.5
36199,Sainte-Lizaigne,1109,0,26185,26185,23.6
50188,Folligny,1109,0,26840,26840,24.2
60150,Chiry-Ourscamp,1109,0,5635,5635,5.1
64126,Bidos,1109,5300,23882,29182,26.3
67174,Gumbrechtshoffen,1109,0,40613,40613,36.6
74177,Menthonnex-en-Bornes,1109,45000,19937,64937,58.6
95002,Ableiges,1109,0,50954,50954,45.9
1149,Douvres,1108,0,18909,18909,17.1
10140,Ervy-le-Châtel,1108,0,20628,20628,18.6
21200,Couchey,1108,0,5313,5313,4.8
31084,Boussens,1108,0,38802,38802,35
54284,Joudreville,1108,0,4882,4882,4.4
65370,Pouzac,1108,0,8317,8317,7.5
69014,Aveize,1108,52887,55535,108422,97.9
72252,Requeil,1108,0,5555,5555,5
77453,Sivry-Courtry,1108,29626,1051,30677,27.7
80271,Épehy,1108,0,7938,7938,7.2
85055,La Chapelle-Palluau,1108,0,9461,9461,8.5
86099,Fleuré,1108,0,25315,25315,22.8
88251,Jeanménil,1108,0,5528,5528,5
89085,Charmoy,1108,11900,38724,50624,45.7
35064,La Chapelle-de-Brain,1107,0,15793,15793,14.3
39228,Foncine-le-Haut,1107,10381,11208,21589,19.5
48027,Mont Lozère et Goulet,1107,57151,22434,79585,71.9
53249,Vimartin-sur-Orthe,1107,0,7919,7919,7.2
2554,Nogentel,1106,0,25564,25564,23.1
8025,Attigny,1106,0,24258,24258,21.9
22090,Kermaria-Sulard,1106,0,21972,21972,19.9
22391,Yvignac-la-Tour,1106,0,29464,29464,26.6
35078,Cherrueix,1106,0,9405,9405,8.5
65284,Louey,1106,0,10566,10566,9.6
71390,Saint-Berain-sous-Sanvignes,1106,0,17771,17771,16.1
80656,Quevauvillers,1106,0,1527,1527,1.4
11280,Pépieux,1105,0,7167,7167,6.5
67481,Stotzheim,1105,5300,34173,39473,35.7
76675,Sierville,1105,0,755,755,0.7
14042,Baron-sur-Odon,1104,0,1952,1952,1.8
15163,Roannes-Saint-Mary,1104,10550,9680,20230,18.3
91132,Chamarande,1104,0,7476,7476,6.8
8263,Lumes,1103,0,25337,25337,23
14557,Saint-Arnoult,1103,0,87305,87305,79.2
16088,Chassors,1103,0,41269,41269,37.4
35285,Saint-Just,1103,0,15735,15735,14.3
35332,Teillay,1103,12621,16053,28674,26
38035,Beauvoir-de-Marc,1103,0,12034,12034,10.9
38347,Roybon,1103,0,12034,12034,10.9
57510,Noisseville,1103,0,54687,54687,49.6
59610,Verchain-Maugré,1103,0,21248,21248,19.3
67110,Durrenbach,1103,0,26688,26688,24.2
85045,La Chaize-Giraud,1103,0,2399,2399,2.2
1064,Briord,1102,0,18807,18807,17.1
2785,Vermand,1102,0,9984,9984,9.1
12130,Livinhac-le-Haut,1102,0,11073,11073,10
33300,Naujac-sur-Mer,1102,0,1065,1065,1
35322,Le Sel-de-Bretagne,1102,0,16038,16038,14.6
38341,Rochetoirin,1102,0,9664,9664,8.8
41016,Billy,1102,0,23221,23221,21.1
46197,Le Montat,1102,0,9305,9305,8.4
56108,Larré,1102,0,7809,7809,7.1
59594,Thun-Saint-Amand,1102,0,41458,41458,37.6
78615,Thiverval-Grignon,1102,0,476,476,0.4
84014,Beaumont-de-Pertuis,1102,0,4944,4944,4.5
7207,Saint-Alban-Auriolles,1101,0,67231,67231,61.1
16064,Brigueuil,1101,10790,22652,33442,30.4
45345,Vimory,1101,0,14833,14833,13.5
47264,Saint-Pardoux-Isaac,1101,0,20504,20504,18.6
65362,Pierrefitte-Nestalas,1101,0,45084,45084,40.9
76556,Saint-Antoine-la-Forêt,1101,0,8391,8391,7.6
81032,Blan,1101,0,22384,22384,20.3
89453,Villefargeau,1101,2700,21539,24239,22
22354,Tréglamus,1100,0,19697,19697,17.9
42145,Montagny,1100,41258,32460,73718,67
44019,Bouée,1100,0,24451,24451,22.2
53125,Landivy,1100,0,14503,14503,13.2
60185,Crouy-en-Thelle,1100,0,4569,4569,4.2
62766,Saint-Omer-Capelle,1100,0,8349,8349,7.6
64059,Artigueloutan,1100,0,32478,32478,29.5
71162,Curgy,1100,0,24611,24611,22.4
85040,La Caillère-Saint-Hilaire,1100,0,23248,23248,21.1
95535,Sagy,1100,12002,50541,62543,56.9
25004,Abbévillers,1099,8552,69571,78123,71.1
28388,Thivars,1099,0,32023,32023,29.1
40293,Saubusse,1099,0,24691,24691,22.5
67322,Neuwiller-lès-Saverne,1099,10435,29615,40050,36.4
81294,Técou,1099,0,60382,60382,54.9
2312,La Flamengrie,1098,0,19580,19580,17.8
27031,Aviron,1098,0,12913,12913,11.8
32426,Seissan,1098,0,12959,12959,11.8
67355,Oermingen,1098,13067,13765,26832,24.4
71117,Châtenoy-en-Bresse,1098,0,30189,30189,27.5
90072,Morvillars,1098,500,38307,38807,35.3
11267,Ornaisons,1097,0,14863,14863,13.5
12201,Rodelle,1097,0,5433,5433,5
27126,Campigny,1097,0,24780,24780,22.6
52449,Saints-Geosmes,1097,0,5033,5033,4.6
54371,Moineville,1097,0,10186,10186,9.3
59133,Carnin,1097,0,18166,18166,16.6
73282,Saint-Thibaud-de-Couz,1097,0,75113,75113,68.5
17485,Le Grand-Village-Plage,1096,0,118723,118723,108.3
33111,Caudrot,1096,0,8923,8923,8.1
53099,Forcé,1096,0,47698,47698,43.5
62839,Vaulx-Vraucourt,1096,0,5449,5449,5
18125,Léré,1095,27205,19727,46932,42.9
30120,Gagnières,1095,0,44444,44444,40.6
80093,Berteaucourt-les-Dames,1095,0,1884,1884,1.7
85232,Saint-Hilaire-le-Vouhis,1095,5840,5575,11415,10.4
15160,Reilhac,1094,15558,37066,52624,48.1
36232,Vendœuvres,1094,0,1733,1733,1.6
38048,Bonnefamille,1094,0,30697,30697,28.1
39370,Mouchard,1094,3880,10594,14474,13.2
61043,Berd'huis,1094,9158,12820,21978,20.1
8067,Blagny,1093,0,38697,38697,35.4
41175,Pezou,1093,0,5551,5551,5.1
1366,Sainte-Julie,1092,0,18636,18636,17.1
16030,Barret,1092,5250,58391,63641,58.3
38174,La Frette,1092,0,11914,11914,10.9
38287,Oyeu,1092,10145,5844,15989,14.6
55302,Longeville-en-Barrois,1092,0,13166,13166,12.1
62393,Guemps,1092,0,8288,8288,7.6
76490,Ourville-en-Caux,1092,21705,7072,28777,26.4
22099,Lanfains,1091,0,17304,17304,15.9
41045,Chaumont-sur-Loire,1091,0,41814,41814,38.3
50425,Rauville-la-Bigot,1091,0,34317,34317,31.5
59430,Neuvilly,1091,0,7496,7496,6.9
68341,Uffheim,1091,0,21206,21206,19.4
70459,Saint-Barthélemy,1091,0,12549,12549,11.5
73135,La Tour-en-Maurienne,1091,21100,29298,50398,46.2
74139,Habère-Lullin,1091,28022,17527,45549,41.7
76638,Saint-Pierre-en-Val,1091,0,3138,3138,2.9
5145,Saint-Jean-Saint-Nicolas,1090,0,72521,72521,66.5
22254,Prat,1090,0,21654,21654,19.9
28371,Saussay,1090,0,1458,1458,1.3
35144,Langan,1090,0,55856,55856,51.2
58057,Chantenay-Saint-Imbert,1090,0,7286,7286,6.7
73164,Montcel,1090,0,6030,6030,5.5
77191,Fontenailles,1090,0,14033,14033,12.9
79293,Saint-Rémy,1090,0,14691,14691,13.5
81147,Lombers,1090,0,22740,22740,20.9
22256,Quemper-Guézennec,1089,0,19500,19500,17.9
27249,Fontaine-Bellenger,1089,0,32295,32295,29.7
49253,Le Puy-Notre-Dame,1089,0,10610,10610,9.7
54375,Montauville,1089,0,11898,11898,10.9
64461,Puyoô,1089,0,29322,29322,26.9
26305,Saint-Gervais-sur-Roubion,1088,0,10483,10483,9.6
30142,Laval-Pradel,1088,0,34008,34008,31.3
38230,Meyrié,1088,0,13221,13221,12.2
17104,Chevanceaux,1087,0,12835,12835,11.8
19176,Rosiers-d'Égletons,1087,0,13946,13946,12.8
33253,Loupiac,1087,0,33331,33331,30.7
56215,Saint-Gonnery,1087,0,7568,7568,7
59149,Clary,1087,0,7469,7469,6.9
62233,Conchil-le-Temple,1087,0,11564,11564,10.6
67252,Kurtzenhouse,1087,5895,18059,23954,22
71318,Montpont-en-Bresse,1087,0,6336,6336,5.8
79334,Val-du-Mignon,1087,0,14650,14650,13.5
86017,Ayron,1087,35530,56488,92018,84.7
23075,Dun-le-Palestel,1086,0,32422,32422,29.9
24341,Proissans,1086,4852,6842,11694,10.8
40142,Laluque,1086,0,25545,25545,23.5
53025,Bazougers,1086,0,6525,6525,6
60196,La Drenne,1086,9150,3494,12644,11.6
60631,Thiers-sur-Thève,1086,0,0,0,0
80730,Saveuse,1086,0,69625,69625,64.1
2703,Seboncourt,1085,0,9830,9830,9.1
9047,Bélesta,1085,0,9635,9635,8.9
12162,Moyrazès,1085,0,33208,33208,30.6
50185,Fleury,1085,0,18333,18333,16.9
76123,Bosc-Guérard-Saint-Adrien,1085,0,742,742,0.7
78290,Guernes,1085,12798,10098,22896,21.1
80661,Rainneville,1085,0,4229,4229,3.9
7269,Saint-Martin-de-Valamas,1084,12784,23177,35961,33.2
26353,Les Tourrettes,1084,0,10444,10444,9.6
59117,Bugnicourt,1084,0,15104,15104,13.9
61234,Lonrai,1084,4000,32036,36036,33.2
80746,Talmas,1084,0,4225,4225,3.9
26129,Eymeux,1083,0,21953,21953,20.3
42287,Saint-Sauveur-en-Rue,1083,34867,22158,57025,52.7
50142,Vicq-sur-Mer,1083,1514,34065,35579,32.9
51326,Livry-Louvercy,1083,0,55046,55046,50.8
57296,Hargarten-aux-Mines,1083,0,6523,6523,6
74085,Les Contamines-Montjoie,1083,81240,11341,92581,85.5
85054,La Chapelle-Hermier,1083,0,68466,68466,63.2
86028,Bignoux,1083,0,64524,64524,59.6
14410,Méry-Bissières-en-Auge,1082,0,12044,12044,11.1
16217,Merpins,1082,9600,40484,50084,46.3
69108,Lancié,1082,9359,0,9359,8.6
70408,Pesmes,1082,0,5460,5460,5
71016,Azé,1082,0,27638,27638,25.5
71588,Vitry-en-Charollais,1082,0,4195,4195,3.9
74216,Présilly,1082,7282,4240,11522,10.6
78007,Aigremont,1082,0,1531,1531,1.4
86274,Les Trois-Moutiers,1082,0,5527,5527,5.1
8024,Asfeld,1081,0,20673,20673,19.1
12101,Flagnac,1081,0,10862,10862,10
35235,Rannée,1081,0,16241,16241,15
47075,La Croix-Blanche,1081,0,8284,8284,7.7
62603,Nesles,1081,0,36543,36543,33.8
76013,Angerville-la-Martel,1081,0,7014,7014,6.5
89067,Cézy,1081,4850,8473,13323,12.3
30085,Collias,1080,0,4245,4245,3.9
31026,Auriac-sur-Vendinelle,1080,0,5268,5268,4.9
35018,La Bazouge-du-Désert,1080,0,13224,13224,12.2
53273,Villiers-Charlemagne,1080,0,6489,6489,6
60130,Catenoy,1080,0,5728,5728,5.3
60586,Saint-Martin-le-Nœud,1080,0,42350,42350,39.2
72335,Sillé-le-Philippe,1080,0,20189,20189,18.7
74292,Vaulx,1080,5181,14625,19806,18.3
89255,Michery,1080,700,199,899,0.8
3052,Chamblet,1079,0,38547,38547,35.7
6094,Péone,1079,0,24316,24316,22.5
10358,Saint-Parres-lès-Vaudes,1079,0,18835,18835,17.5
17074,Bussac-Forêt,1079,0,12741,12741,11.8
23195,Saint-Fiel,1079,0,17621,17621,16.3
24538,Siorac-en-Périgord,1079,18143,52817,70960,65.8
41154,Morée,1079,0,5480,5480,5.1
47128,Lafox,1079,0,24700,24700,22.9
66134,Passa,1079,0,14463,14463,13.4
76287,Fresquiennes,1079,0,737,737,0.7
88151,Dompaire,1079,0,15507,15507,14.4
14197,Cresserons,1078,0,7257,7257,6.7
14311,Grainville-sur-Odon,1078,0,1906,1906,1.8
41085,La Ferté-Saint-Cyr,1078,0,7553,7553,7
43233,Sanssac-l'Église,1078,2710,44855,47565,44.1
59399,Merris,1078,0,6586,6586,6.1
61382,Saint-Denis-sur-Sarthon,1078,6830,31858,38688,35.9
79001,L'Absie,1078,0,30665,30665,28.4
88124,Darney,1078,0,8380,8380,7.8
33130,Coimères,1077,0,11014,11014,10.2
37213,Saint-Christophe-sur-le-Nais,1077,5300,11953,17253,16
42214,Saint-Cyr-les-Vignes,1077,1520,19522,21042,19.5
50228,Hambye,1077,0,31162,31162,28.9
51453,Recy,1077,0,54741,54741,50.8
79347,Viennay,1077,0,28237,28237,26.2
89326,Rosoy,1077,9836,7157,16993,15.8
26174,Margès,1076,3534,47345,50879,47.3
27311,Harcourt,1076,0,4639,4639,4.3
35186,Mont-Dol,1076,0,9150,9150,8.5
41051,Chissay-en-Touraine,1076,0,19772,19772,18.4
45344,Villorceau,1076,0,4434,4434,4.1
54385,Morfontaine,1076,0,10047,10047,9.3
62440,Hermies,1076,0,5350,5350,5
62550,Marconnelle,1076,0,17036,17036,15.8
62869,Wailly,1076,0,30264,30264,28.1
72122,Duneau,1076,0,6565,6565,6.1
74147,Lathuile,1076,0,8872,8872,8.2
82090,Lamothe-Capdeville,1076,0,9369,9369,8.7
89420,Treigny-Perreuse-Sainte-Colombe,1076,28320,48585,76905,71.5
10368,Savières,1075,0,1105,1105,1
53151,Méral,1075,0,7116,7116,6.6
62471,Bellinghem,1075,4384,95675,100059,93.1
2818,Villiers-Saint-Denis,1074,0,585,585,0.5
7313,Serrières,1074,26171,5533,31704,29.5
10051,Bouilly,1074,0,15337,15337,14.3
33518,Tabanac,1074,0,7906,7906,7.4
35289,Saint-Malo-de-Phily,1074,0,9692,9692,9
73306,Valloire,1074,265824,29711,295535,275.2
74141,Hauteville-sur-Fier,1074,136827,14544,151371,140.9
8385,Saint-Laurent,1073,0,24648,24648,23
42108,L'Hôpital-le-Grand,1073,600,9614,10214,9.5
46028,Bétaille,1073,0,35007,35007,32.6
59019,Artres,1073,0,20670,20670,19.3
64353,Louvie-Juzon,1073,13450,13619,27069,25.2
68029,Bergholtz,1073,0,26479,26479,24.7
74206,Orcier,1073,7250,46715,53965,50.3
85143,Mervent,1073,0,7040,7040,6.6
38002,Les Adrets,1072,14820,19919,34739,32.4
42172,Planfoy,1072,0,21933,21933,20.5
44044,Conquereuil,1072,0,15293,15293,14.3
57026,Apach,1072,0,15431,15431,14.4
74162,Marcellaz,1072,0,5603,5603,5.2
30249,Saint-Dionisy,1071,0,3945,3945,3.7
42042,Chambles,1071,0,9596,9596,9
43021,Beaulieu,1071,0,44564,44564,41.6
62693,Rebreuve-Ranchicourt,1071,0,17674,17674,16.5
74126,Fessy,1071,7090,46628,53718,50.2
76252,Étalondes,1071,18513,3080,21593,20.2
4018,Banon,1070,22440,2820,25260,23.6
14006,Amayé-sur-Orne,1070,0,1892,1892,1.8
30328,Théziers,1070,0,4206,4206,3.9
37129,Ligré,1070,0,29033,29033,27.1
42163,La Pacaudière,1070,0,31575,31575,29.5
43230,Saint-Vincent,1070,7212,44522,51734,48.3
45010,Ascoux,1070,3360,1330,4690,4.4
46055,Capdenac,1070,0,31598,31598,29.5
56145,Néant-sur-Yvel,1070,0,16113,16113,15.1
22347,Trédarzec,1069,0,21236,21236,19.9
30127,Gaujac,1069,0,15599,15599,14.6
48017,Banassac-Canilhac,1069,6600,37959,44559,41.7
68386,Zimmersheim,1069,0,74469,74469,69.7
74108,Duingt,1069,0,8258,8258,7.7
79210,Le Pin,1069,0,30409,30409,28.4
84143,Venasque,1069,31060,34906,65966,61.7
87168,Saint-Mathieu,1069,6695,470,7165,6.7
26031,La Bâtie-Rolland,1068,14977,10290,25267,23.7
27161,Claville,1068,0,9502,9502,8.9
68130,Heiteren,1068,0,18536,18536,17.4
76240,Épreville,1068,0,6930,6930,6.5
76453,Morgny-la-Pommeraye,1068,0,730,730,0.7
21183,Collonges-et-Premières,1067,0,24,24,0
42074,Coutouvre,1067,7495,31487,38982,36.5
49089,Chazé-sur-Argos,1067,10604,1064,11668,10.9
54065,Bertrichamps,1067,0,4714,4714,4.4
56189,Radenac,1067,0,7429,7429,7
60327,Jouy-sous-Thelle,1067,630,23431,24061,22.6
62549,Marconne,1067,0,0,0,0
71545,Tramayes,1067,0,14499,14499,13.6
77504,Villemaréchal,1067,0,3711,3711,3.5
81078,Damiatte,1067,0,15958,15958,15
84051,Goult,1067,0,21749,21749,20.4
27335,Heudreville-sur-Eure,1066,0,31613,31613,29.7
35110,Feins,1066,0,22899,22899,21.5
53036,Bouère,1066,0,6405,6405,6
58304,Varzy,1066,12853,22303,35156,33
60598,Saint-Sulpice,1066,0,4428,4428,4.2
62486,Lambres,1066,0,17591,17591,16.5
79276,Saint-Martin-de-Saint-Maixent,1066,0,5925,5925,5.6
80241,Domart-en-Ponthieu,1066,0,1834,1834,1.7
84002,Ansouis,1066,0,4783,4783,4.5
1158,Farges,1065,0,13709,13709,12.9
41095,Fréteval,1065,0,5409,5409,5.1
63400,Saint-Sylvestre-Pragoulin,1065,0,4353,4353,4.1
67532,Willgottheim,1065,8400,20263,28663,26.9
81225,Rivières,1065,0,58514,58514,54.9
10382,Traînel,1064,0,6575,6575,6.2
38368,Saint-Blaise-du-Buis,1064,0,18076,18076,17
44086,Lusanger,1064,0,17845,17845,16.8
50431,Remilly Les Marais,1064,0,15737,15737,14.8
2287,Essigny-le-Grand,1063,0,0,0,0
29059,Garlan,1063,0,63736,63736,60
39415,Petit-Noir,1063,0,6296,6296,5.9
62819,Tilques,1063,13880,94607,108487,102.1
62870,Wailly-Beaucamp,1063,0,11309,11309,10.6
72183,Marçon,1063,0,59944,59944,56.4
77478,Ussy-sur-Marne,1063,0,4140,4140,3.9
35361,Le Vivier-sur-Mer,1062,0,9031,9031,8.5
45278,Sainte-Geneviève-des-Bois,1062,0,10889,10889,10.3
51153,Chouilly,1062,0,21105,21105,19.9
54176,Einville-au-Jard,1062,0,15926,15926,15
59619,Villereau,1062,0,2997,2997,2.8
60578,Saintines,1062,0,9565,9565,9
72119,Domfront-en-Champagne,1062,0,20718,20718,19.5
2593,Pasly,1061,0,8876,8876,8.4
9124,Le Fossat,1061,0,18871,18871,17.8
17208,Longèves,1061,0,15458,15458,14.6
26273,Rochefort-Samson,1061,5346,21507,26853,25.3
37170,Neuvy-le-Roi,1061,7950,11776,19726,18.6
45046,Boulay-les-Barres,1061,0,1496,1496,1.4
60635,Thiverny,1061,0,10912,10912,10.3
62905,Zudausques,1061,0,2295,2295,2.2
85297,Triaize,1061,0,22424,22424,21.1
29265,Sainte-Sève,1060,12471,63557,76028,71.7
38407,La Sure en Chartreuse,1060,0,18008,18008,17
53262,Soulgé-sur-Ouette,1060,0,46131,46131,43.5
57358,Kédange-sur-Canner,1060,0,6792,6792,6.4
67535,Wimmenau,1060,1625,28564,30189,28.5
73208,Pugny-Chatenod,1060,0,5864,5864,5.5
76315,Grainville-la-Teinturière,1060,0,6865,6865,6.5
81266,Saint-Paul-Cap-de-Joux,1060,0,15854,15854,15
86009,Archigny,1060,0,24125,24125,22.8
87066,Flavignac,1060,5124,14368,19492,18.4
23177,Saint-Agnant-de-Versillat,1059,0,20043,20043,18.9
30026,Avèze,1059,0,17081,17081,16.1
33264,Maransin,1059,0,20657,20657,19.5
33336,Préchac,1059,0,10830,10830,10.2
34103,Fontès,1059,0,1207,1207,1.1
37045,La Celle-Saint-Avant,1059,400,18383,18783,17.7
68076,Durrenentzen,1059,0,18380,18380,17.4
87116,Peyrat-de-Bellac,1059,6400,18024,24424,23.1
89139,Diges,1059,2981,47818,50799,48
8457,Tournes,1058,0,24304,24304,23
13111,Vauvenargues,1058,0,29737,29737,28.1
16101,Claix,1058,0,27506,27506,26
24108,La Chapelle-Gonaguet,1058,7601,5909,13510,12.8
24568,Vélines,1058,0,3687,3687,3.5
29182,Plouégat-Guérand,1058,0,63437,63437,60
30116,Fournès,1058,0,4159,4159,3.9
57452,La Maxe,1058,0,52456,52456,49.6
74184,Minzier,1058,0,25555,25555,24.2
1096,Chaveyriat,1057,11750,4281,16031,15.2
17296,Rétaud,1057,4810,17609,22419,21.2
22229,Plounévez-Quintin,1057,0,97336,97336,92.1
25078,Bouclans,1057,0,12486,12486,11.8
28251,Mézières-en-Drouais,1057,0,1414,1414,1.3
40210,Onesse-Laharie,1057,0,15103,15103,14.3
40212,Orthevielle,1057,0,7866,7866,7.4
47301,Seyches,1057,0,10936,10936,10.3
59543,Saint-Remy-du-Nord,1057,0,37704,37704,35.7
21710,Vitteaux,1056,0,22423,22423,21.2
33298,Moulon,1056,0,20598,20598,19.5
56018,Billiers,1056,28478,10055,38533,36.5
8191,Givonne,1055,0,24235,24235,23
26188,Mollans-sur-Ouvèze,1055,0,1234,1234,1.2
29016,Brasparts,1055,0,54848,54848,52
60430,Morienval,1055,0,4131,4131,3.9
62752,Saint-Josse,1055,0,11224,11224,10.6
74193,La Muraz,1055,0,4544,4544,4.3
80584,Naours,1055,0,4112,4112,3.9
81064,Castelnau-de-Montmiral,1055,0,57965,57965,54.9
22011,Boqueho,1054,0,21346,21346,20.3
34035,La Boissière,1054,39557,5693,45250,42.9
60166,Coudun,1054,0,9215,9215,8.7
62552,Maresquel-Ecquemicourt,1054,0,16688,16688,15.8
64250,Guiche,1054,22457,27389,49846,47.3
67160,Gœrsdorf,1054,1900,25502,27402,26
71398,Saint-Christophe-en-Bresse,1054,0,6143,6143,5.8
78381,Maulette,1054,12058,10568,22626,21.5
8140,Dom-le-Mesnil,1053,0,24189,24189,23
22035,Les Champs-Géraux,1053,0,28052,28052,26.6
54449,Rehainviller,1053,0,4652,4652,4.4
68061,Buschwiller,1053,15517,20467,35984,34.2
74077,Clarafond-Arcine,1053,7785,25434,33219,31.5
18005,Allouis,1052,18077,7972,26049,24.8
32370,Saint-Clar,1052,0,3970,3970,3.8
38291,Pajay,1052,0,11477,11477,10.9
42197,Sainte-Agathe-la-Bouteresse,1052,0,9425,9425,9
64040,Arette,1052,0,22655,22655,21.5
64063,Arzacq-Arraziguet,1052,15661,16472,32133,30.5
68291,Rumersheim-le-Haut,1052,0,18258,18258,17.4
74168,Marlioz,1052,0,25410,25410,24.2
74315,Yvoire,1052,0,45801,45801,43.5
76418,Maulévrier-Sainte-Gertrude,1052,0,8017,8017,7.6
38101,Cheyssieu,1051,0,26867,26867,25.6
43038,Bournoncle-Saint-Pierre,1051,9240,51507,60747,57.8
67040,Bindernheim,1051,2100,22138,24238,23.1
68204,Metzeral,1051,0,42189,42189,40.1
69107,Lamure-sur-Azergues,1051,0,12423,12423,11.8
69218,Saint-Lager,1051,0,0,0,0
77077,Chambry,1051,0,14333,14333,13.6
24521,Sarliac-sur-l'Isle,1050,0,5864,5864,5.6
38335,Revel-Tourdan,1050,0,26842,26842,25.6
44134,Pouillé-les-Côteaux,1050,0,12829,12829,12.2
49205,Miré,1050,0,30430,30430,29
68055,Bruebach,1050,0,73145,73145,69.7
85121,Le Langon,1050,0,6889,6889,6.6
88484,Uzemain,1050,0,26405,26405,25.1
12026,Bertholène,1049,0,99350,99350,94.7
25186,Cussey-sur-l'Ognon,1049,3130,18483,21613,20.6
27102,Bouquetot,1049,0,4298,4298,4.1
56232,Saint-Perreux,1049,0,14965,14965,14.3
62042,Athies,1049,0,29505,29505,28.1
62476,Izel-lès-Équerchin,1049,0,1305,1305,1.2
77101,Châtenay-sur-Seine,1049,2800,14856,17656,16.8
1170,Béard-Géovreissiat,1048,0,39644,39644,37.8
26149,Hostun,1048,20208,21244,41452,39.6
30014,Arpaillargues-et-Aureillac,1048,0,8053,8053,7.7
33061,Bonnetan,1048,0,22631,22631,21.6
39396,Orchamps,1048,6720,16538,23258,22.2
57593,Roncourt,1048,0,51960,51960,49.6
64188,Chéraute,1048,0,27233,27233,26
77265,Luzancy,1048,4395,4081,8476,8.1
15175,Saint-Cernin,1047,28210,17335,45545,43.5
27678,Les Ventes,1047,0,12314,12314,11.8
30355,Saint-Paul-les-Fonts,1047,0,15278,15278,14.6
58261,Saint-Père,1047,0,20874,20874,19.9
60526,Ravenel,1047,0,5801,5801,5.5
61462,Sarceaux,1047,4900,2211,7111,6.8
67103,Dossenheim-sur-Zinsel,1047,1468,28214,29682,28.3
71417,Saint-Gengoux-le-National,1047,0,16059,16059,15.3
80086,Bernaville,1047,0,4081,4081,3.9
85072,La Copechagnière,1047,0,8756,8756,8.4
3157,Magnet,1046,0,28655,28655,27.4
7084,Eclassan,1046,0,17219,17219,16.5
33021,Auros,1046,15053,8516,23569,22.5
45280,Saint-Gondon,1046,0,13537,13537,12.9
54077,Blâmont,1046,0,3711,3711,3.5
59054,Bavinchove,1046,0,6391,6391,6.1
59474,Prisches,1046,0,8286,8286,7.9
64416,Navarrenx,1046,0,21865,21865,20.9
80168,Candas,1046,0,4077,4077,3.9
86061,Charroux,1046,9230,23556,32786,31.3
86065,Château-Larcher,1046,0,23899,23899,22.8
7134,Laurac-en-Vivarais,1045,11436,16464,27900,26.7
12200,Rivière-sur-Tarn,1045,0,10800,10800,10.3
23036,Bussière-Dunoise,1045,0,17066,17066,16.3
41046,Chaumont-sur-Tharonne,1045,11200,8580,19780,18.9
41248,Couëtron-au-Perche,1045,16216,31213,47429,45.4
42331,Villemontais,1045,16798,30837,47635,45.6
76408,Manneville-la-Goupil,1045,0,12375,12375,11.8
91041,Avrainville,1045,0,10498,10498,10
8139,Deville,1044,0,16253,16253,15.6
14396,Maltot,1044,8000,1846,9846,9.4
16415,Vindelle,1044,0,27142,27142,26
55496,Sorcy-Saint-Martin,1044,0,4213,4213,4
59263,Gœulzin,1044,0,14546,14546,13.9
66096,Latour-de-France,1044,0,25527,25527,24.5
14044,Basly,1043,0,7021,7021,6.7
29001,Argol,1043,0,13481,13481,12.9
37271,Villaines-les-Rochers,1043,0,16603,16603,15.9
49257,Les Rairies,1043,0,7980,7980,7.7
56241,Sauzon,1043,0,12649,12649,12.1
59231,Ferrière-la-Petite,1043,0,37204,37204,35.7
6035,Castellar,1042,0,5848,5848,5.6
32083,Castéra-Verduzan,1042,0,36715,36715,35.2
33543,Verdelais,1042,0,10656,10656,10.2
38042,Bévenais,1042,0,5577,5577,5.4
54151,Cutry,1042,0,9730,9730,9.3
61344,Rânes,1042,8989,2201,11190,10.7
63281,Pionsat,1042,0,1617,1617,1.6
64007,Agnos,1042,0,22440,22440,21.5
73096,Cruet,1042,7200,18634,25834,24.8
82110,Mirabel,1042,0,30809,30809,29.6
90087,Roppe,1042,0,36353,36353,34.9
91130,Chalo-Saint-Mars,1042,0,2624,2624,2.5
1083,Chaneins,1041,0,217,217,0.2
35194,Montreuil-sous-Pérouse,1041,0,15640,15640,15
55215,Gondrecourt-le-Château,1041,0,20347,20347,19.5
57665,Tenteling,1041,0,19031,19031,18.3
60642,Tracy-le-Val,1041,0,5290,5290,5.1
87169,Saint-Maurice-les-Brousses,1041,12340,14110,26450,25.4
17186,Le Gué-d'Alleré,1040,0,15152,15152,14.6
42180,Précieux,1040,0,9318,9318,9
57162,Cuvry,1040,0,51564,51564,49.6
91679,Villiers-le-Bâcle,1040,25315,10803,36118,34.7
10084,Charmont-sous-Barbuise,1039,0,3864,3864,3.7
31503,Saint-Martory,1039,29110,55840,84950,81.8
41139,Meusnes,1039,0,19092,19092,18.4
67409,Roppenheim,1039,58076,12590,70666,68
68246,Obersaasheim,1039,0,18033,18033,17.4
82049,Donzac,1039,0,111632,111632,107.4
95594,Seugy,1039,0,6007,6007,5.8
8183,Fromelennes,1038,0,6664,6664,6.4
19237,Saint-Privat,1038,0,3080,3080,3
35025,Billé,1038,0,12710,12710,12.2
40181,Messanges,1038,0,23321,23321,22.5
50433,Réville,1038,26965,32650,59615,57.4
72230,Parigné-le-Pôlin,1038,0,5560,5560,5.4
79268,Saint-Loup-Lamairé,1038,0,26547,26547,25.6
3316,Villeneuve-sur-Allier,1037,0,13959,13959,13.5
27643,Tillières-sur-Avre,1037,0,29164,29164,28.1
28363,Sainville,1037,0,5446,5446,5.3
35060,La Chapelle du Lou du Lac,1037,0,20136,20136,19.4
60138,Chamant,1037,0,0,0,0
79277,Saint-Martin-de-Sanzay,1037,0,16135,16135,15.6
91463,Oncy-sur-École,1037,0,36130,36130,34.8
3283,Thiel-sur-Acolin,1036,0,13946,13946,13.5
16243,Nercillac,1036,3960,38763,42723,41.2
35247,Roz-sur-Couesnon,1036,0,8810,8810,8.5
35330,Taillis,1036,0,15565,15565,15
42155,Nervieux,1036,8810,18778,27588,26.6
49090,Cheffes,1036,0,7926,7926,7.7
76514,Quévreville-la-Poterie,1036,0,29592,29592,28.6
7348,Vogüé,1035,7300,63201,70501,68.1
10381,Torvilliers,1035,0,14780,14780,14.3
27117,Broglie,1035,0,4462,4462,4.3
31374,Montesquieu-Lauragais,1035,0,5048,5048,4.9
64315,Laroin,1035,32330,30559,62889,60.8
72377,Villaines-sous-Malicorne,1035,0,7503,7503,7.2
80618,Pendé,1035,0,3158,3158,3.1
85005,Antigny,1035,0,22615,22615,21.9
1236,Marsonnas,1034,0,19990,19990,19.3
33083,Camarsac,1034,0,22329,22329,21.6
52125,Chamarandes-Choignes,1034,0,113578,113578,109.8
57571,Rémering-lès-Puttelange,1034,0,14131,14131,13.7
64300,Lacq,1034,120017,27842,147859,143
2495,Mondrepuis,1033,0,20278,20278,19.6
16308,Saint-Claud,1033,5308,21253,26561,25.7
27497,Rougemontiers,1033,0,23334,23334,22.6
50032,La Barre-de-Semilly,1033,0,15278,15278,14.8
57557,Puttelange-lès-Thionville,1033,0,25149,25149,24.3
76750,Yainville,1033,0,29506,29506,28.6
85242,Saint-Mars-la-Réorthe,1033,0,4419,4419,4.3
87005,Aureil,1033,2150,14649,16799,16.3
25110,Chaffois,1032,0,29498,29498,28.6
27169,Conteville,1032,0,7711,7711,7.5
33458,Saint-Paul,1032,0,10562,10562,10.2
35237,Renac,1032,0,14723,14723,14.3
35249,Sainte-Anne-sur-Vilaine,1032,0,15019,15019,14.6
35280,Saint-Hilaire-des-Landes,1032,0,31635,31635,30.7
36165,Pouligny-Saint-Pierre,1032,0,5673,5673,5.5
42219,Saint-Étienne-le-Molard,1032,0,9246,9246,9
51449,Prunay,1032,0,18341,18341,17.8
68151,Husseren-Wesserling,1032,0,10723,10723,10.4
22005,Belle-Isle-en-Terre,1031,0,18461,18461,17.9
36035,Chaillac,1031,0,20793,20793,20.2
61040,Bellou-en-Houlme,1031,10365,27613,37978,36.8
69047,Charnay,1031,0,9291,9291,9
81011,Ambres,1031,0,3367,3367,3.3
81168,Mirandol-Bourgnounac,1031,0,23587,23587,22.9
84068,Lourmarin,1031,116528,10049,126577,122.8
87097,Val d'Issoire,1031,3993,17547,21540,20.9
3063,Chassenard,1030,0,3993,3993,3.9
4173,Saint-André-les-Alpes,1030,50200,36421,86621,84.1
8116,Bairon et ses environs,1030,0,24922,24922,24.2
11198,Laure-Minervois,1030,0,6681,6681,6.5
12253,Salles-Curan,1030,0,7303,7303,7.1
18075,Cours-les-Barres,1030,0,326,326,0.3
21585,Saulon-la-Chapelle,1030,0,4939,4939,4.8
37043,Cangey,1030,19015,27957,46972,45.6
39193,Le Deschaux,1030,29324,20905,50229,48.8
40152,Lesperon,1030,0,14717,14717,14.3
45297,Saint-Père-sur-Loire,1030,0,6032,6032,5.9
53158,Montjean,1030,0,44826,44826,43.5
63052,Le Breuil-sur-Couze,1030,0,6695,6695,6.5
67412,Rossfeld,1030,1400,19043,20443,19.8
70282,Gy,1030,3760,4658,8418,8.2
16340,Saint-Même-les-Carrières,1029,6110,38501,44611,43.4
17277,Essouvert,1029,0,28662,28662,27.9
26156,Larnage,1029,0,45277,45277,44
31418,Pin-Balma,1029,0,25157,25157,24.4
38231,Meyrieu-les-Étangs,1029,0,11226,11226,10.9
45202,Messas,1029,0,4240,4240,4.1
50594,Teurthéville-Hague,1029,0,32367,32367,31.5
57765,Diesen,1029,1516,17570,19086,18.5
69105,Lacenas,1029,0,21846,21846,21.2
74260,Savigny,1029,14495,4032,18527,18
76135,Bouville,1029,0,3437,3437,3.3
85281,Sérigné,1029,5595,6751,12346,12
1073,Ceyzérieu,1028,0,11457,11457,11.1
12044,Camarès,1028,0,40225,40225,39.1
14724,Varaville,1028,0,13059,13059,12.7
15038,Champs-sur-Tarentaine-Marchal,1028,25873,5261,31134,30.3
16134,Exideuil-sur-Vienne,1028,11694,21150,32844,31.9
23002,Ajain,1028,0,16788,16788,16.3
24437,Saint-Laurent-des-Vignes,1028,9861,22886,32747,31.9
31270,Landorthe,1028,0,21293,21293,20.7
35108,Essé,1028,0,20012,20012,19.5
38046,Bizonnes,1028,0,5502,5502,5.4
42212,Saint-Cyr-de-Favières,1028,6842,29143,35985,35
47117,Hautefage-la-Tour,1028,0,7878,7878,7.7
50274,Les Loges-Marchis,1028,0,25293,25293,24.6
54080,Blénod-lès-Toul,1028,0,34084,34084,33.2
64328,Ledeuix,1028,0,22138,22138,21.5
79172,Mazières-en-Gâtine,1028,0,8473,8473,8.2
87117,Peyrat-le-Château,1028,0,14641,14641,14.2
1373,Saint-Martin-du-Frêne,1027,0,38849,38849,37.8
12177,Palmas d'Aveyron,1027,0,97266,97266,94.7
28239,Marville-Moutiers-Brûlé,1027,0,1374,1374,1.3
37189,Preuilly-sur-Claise,1027,17980,17827,35807,34.9
39306,Macornay,1027,5490,32365,37855,36.9
41075,Droué,1027,0,5216,5216,5.1
69160,Poule-les-Écharmeaux,1027,0,12139,12139,11.8
7007,Alboussière,1026,0,20045,20045,19.5
17110,Clérac,1026,0,12115,12115,11.8
50111,Cerisy-la-Salle,1026,0,29686,29686,28.9
55398,Pagny-sur-Meuse,1026,0,4141,4141,4
77113,Chevru,1026,0,3996,3996,3.9
81312,Verdalle,1026,0,1142,1142,1.1
90104,Vézelois,1026,0,35795,35795,34.9
8282,Maubert-Fontaine,1025,0,26796,26796,26.1
25413,Mouthe,1025,0,61044,61044,59.6
40061,Campagne,1025,0,12686,12686,12.4
85073,Corpe,1025,0,21663,21663,21.1
1416,Tenay,1024,0,17476,17476,17.1
34164,Montaud,1024,5800,81188,86988,84.9
56182,Priziac,1024,0,32731,32731,32
57047,Bambiderstroff,1024,0,47517,47517,46.4
57658,Soucht,1024,0,23600,23600,23
80415,Hangest-en-Santerre,1024,0,6291,6291,6.1
89337,Saint-Bris-le-Vineux,1024,0,20033,20033,19.6
15037,Champagnac,1023,23120,5235,28355,27.7
35274,Saint-Germain-sur-Ille,1023,0,21975,21975,21.5
38009,Anjou,1023,0,26151,26151,25.6
39405,Parcey,1023,3450,20763,24213,23.7
57645,Semécourt,1023,0,2077,2077,2
61369,Saint-Bômer-les-Forges,1023,9595,34563,44158,43.2
62589,Mont-Saint-Éloi,1023,0,28773,28773,28.1
72215,Neufchâtel-en-Saosnois,1023,0,18970,18970,18.5
77480,Valence-en-Brie,1023,13510,970,14480,14.2
24436,Saint-Laurent-des-Hommes,1022,13945,48938,62883,61.5
31025,Aureville,1022,0,16663,16663,16.3
33296,Mouliets-et-Villemartin,1022,0,7131,7131,7
37219,Saint-Genouph,1022,5834,12092,17926,17.5
40044,Biaudos,1022,0,29028,29028,28.4
40300,Seyresse,1022,0,8749,8749,8.6
56170,Plouray,1022,0,32667,32667,32
59455,Paillencourt,1022,0,13284,13284,13
11322,Roquefort-des-Corbières,1021,0,15789,15789,15.5
22241,Plumieux,1021,0,0,0,0
31578,Vigoulet-Auzil,1021,0,16647,16647,16.3
34294,Saturargues,1021,0,11163,11163,10.9
68250,Orschwihr,1021,0,25195,25195,24.7
77392,Rouvres,1021,0,12662,12662,12.4
80009,Ailly-le-Haut-Clocher,1021,0,25282,25282,24.8
7167,Les Ollières-sur-Eyrieux,1020,9426,3403,12829,12.6
26210,Valherbasse,1020,5036,20676,25712,25.2
38180,Gillonnay,1020,0,11128,11128,10.9
38369,Sainte-Blandine,1020,0,8945,8945,8.8
54584,Villey-Saint-Étienne,1020,0,2128,2128,2.1
66179,Saint-Laurent-de-Cerdans,1020,0,0,0,0
43115,Laussonne,1019,8815,5653,14468,14.2
43212,Saint-Pal-de-Chalencon,1019,35612,92021,127633,125.3
45043,Bou,1019,0,14905,14905,14.6
62087,Bayenghem-lès-Éperlecques,1019,0,90691,90691,89
64161,Came,1019,13833,26480,40313,39.6
89167,Fleury-la-Vallée,1019,23700,24101,47801,46.9
18082,Cuffy,1018,0,322,322,0.3
27350,Illiers-l'Évêque,1018,0,11972,11972,11.8
29008,Beuzec-Cap-Sizun,1018,0,72861,72861,71.6
34181,Neffiès,1018,0,1991,1991,2
51472,Saint-Amand-sur-Fion,1018,0,5973,5973,5.9
63013,Aubiat,1018,0,4161,4161,4.1
85186,La Rabatelière,1018,0,8514,8514,8.4
12168,Nant,1017,0,43548,43548,42.8
35175,Mernel,1017,0,9178,9178,9
72351,Tennie,1017,0,19840,19840,19.5
27089,Thénouville,1016,7600,4162,11762,11.6
27242,Le Fidelaire,1016,0,9039,9039,8.9
33487,Saint-Vincent-de-Paul,1016,0,25974,25974,25.6
49240,La Plaine,1016,15975,42218,58193,57.3
54279,Jezainville,1016,0,11101,11101,10.9
62559,Marquion,1016,0,1264,1264,1.2
63055,Bromont-Lamothe,1016,0,34356,34356,33.8
76560,Saint-Aubin-Épinay,1016,0,29021,29021,28.6
36109,Le Magny,1015,2335,22295,24630,24.3
38037,Bellegarde-Poussieu,1015,0,25947,25947,25.6
40267,Saint-Justin,1015,0,11593,11593,11.4
47097,Feugarolles,1015,0,4921,4921,4.8
18092,Farges-en-Septaine,1014,0,4673,4673,4.6
28075,La Chapelle-du-Noyer,1014,0,55409,55409,54.6
35041,Brie,1014,0,19740,19740,19.5
50110,Cerisy-la-Forêt,1014,0,14997,14997,14.8
60358,Lévignen,1014,0,3970,3970,3.9
67200,Hipsheim,1014,2990,18748,21738,21.4
77188,Fontaine-le-Port,1014,0,961,961,0.9
77211,Grandpuits-Bailly-Carrois,1014,6900,13055,19955,19.7
80582,Namps-Maisnil,1014,0,1400,1400,1.4
80692,Sailly-Flibeaucourt,1014,0,25109,25109,24.8
2003,Acy,1013,0,8475,8475,8.4
4008,Annot,1013,26000,35819,61819,61
11084,Caux-et-Sauzens,1013,0,6571,6571,6.5
17216,Lussant,1013,30235,16682,46917,46.3
24472,Saint-Nexans,1013,2440,22552,24992,24.7
30008,Allègre-les-Fumades,1013,0,41115,41115,40.6
35166,Marpiré,1013,0,15219,15219,15
41249,Souesmes,1013,0,8632,8632,8.5
52104,Chancenay,1013,0,9174,9174,9.1
61389,Sainte-Gauburge-Sainte-Colombe,1013,16460,7323,23783,23.5
10080,Chaource,1012,0,18841,18841,18.6
11085,Cavanac,1012,0,6564,6564,6.5
21332,Labergement-lès-Seurre,1012,0,7588,7588,7.5
25505,Rougemont,1012,0,2334,2334,2.3
53126,Larchamp,1012,0,4599,4599,4.5
89411,Les Vallées de la Vanne,1012,0,1962,1962,1.9
3103,Le Donjon,1011,0,17462,17462,17.3
44123,Pierric,1011,0,14423,14423,14.3
49224,Neuillé,1011,23199,9850,33049,32.7
64157,Buzy,1011,14261,12832,27093,26.8
74009,Andilly,1011,15950,18175,34125,33.8
29143,Mahalon,1010,0,72288,72288,71.6
57235,Freistroff,1010,0,14539,14539,14.4
68364,Westhalten,1010,0,99167,99167,98.2
82072,Golfech,1010,0,108516,108516,107.4
85142,La Merlatière,1010,0,8447,8447,8.4
14347,Dialan sur Chaîne,1009,0,37415,37415,37.1
31233,Grépiac,1009,10560,5307,15867,15.7
38206,Laval-en-Belledonne,1009,0,18748,18748,18.6
51461,Rilly-la-Montagne,1009,0,17932,17932,17.8
60601,Saint-Vaast-lès-Mello,1009,0,10378,10378,10.3
73228,Saint-Cassin,1009,0,12825,12825,12.7
74307,Villy-le-Pelloux,1009,1000,18140,19140,19
76331,Grugny,1009,0,690,690,0.7
81202,Parisot,1009,0,55437,55437,54.9
1264,Montracol,1008,0,19487,19487,19.3
59058,Beaufort,1008,0,35956,35956,35.7
59627,Villers-Sire-Nicole,1008,0,35956,35956,35.7
64270,Igon,1008,0,10780,10780,10.7
67011,Artolsheim,1008,0,21233,21233,21.1
1396,Sault-Brénaz,1007,0,17186,17186,17.1
16359,Salles-d'Angles,1007,10807,37677,48484,48.1
17089,La Chapelle-des-Pots,1007,630,31915,32545,32.3
2A348,Vico,1007,0,4639,4639,4.6
35202,La Noë-Blanche,1007,0,14655,14655,14.6
35272,Saint-Germain-du-Pinel,1007,0,15129,15129,15
36055,Clion,1007,0,25148,25148,25
71023,Baudrières,1007,0,5869,5869,5.8
77006,Arbonne-la-Forêt,1007,0,8384,8384,8.3
86247,Val-de-Comporté,1007,0,22677,22677,22.5
88026,Aydoilles,1007,0,25323,25323,25.1
35003,Andouillé-Neuville,1006,0,21610,21610,21.5
42191,Roisey,1006,0,30871,30871,30.7
50077,Bretteville,1006,0,31643,31643,31.5
51165,Connantre,1006,0,1895,1895,1.9
63225,Messeix,1006,0,34018,34018,33.8
74160,Manigod,1006,702545,51102,753647,749.2
14319,Grentheville,1005,0,22363,22363,22.3
17303,La Ronde,1005,5650,14643,20293,20.2
26377,Vinsobres,1005,0,51642,51642,51.4
29269,Saint-Thurien,1005,0,34528,34528,34.4
38331,Réaumont,1005,0,17073,17073,17
78034,Auteuil,1005,0,434,434,0.4
86254,Saulgé,1005,11699,40648,52347,52.1
87148,Saint-Hilaire-Bonneval,1005,6400,16115,22515,22.4
22250,Pontrieux,1004,0,17978,17978,17.9
25564,Torpes,1004,1950,17690,19640,19.6
29281,Tourch,1004,0,11057,11057,11
38478,Séchilienne,1004,0,38785,38785,38.6
57565,Rédange,1004,0,8657,8657,8.6
68277,Riquewihr,1004,16422,2400,18822,18.7
69125,Marcilly-d'Azergues,1004,0,9048,9048,9
77106,Chauffry,1004,0,3910,3910,3.9
87086,Linards,1004,0,467,467,0.5
1062,Bressolles,1003,0,13657,13657,13.6
1323,Reyssouze,1003,3909,13775,17684,17.6
1397,Sauverny,1003,0,12911,12911,12.9
17045,Beurlay,1003,0,25549,25549,25.5
35307,Saint-Pern,1003,0,19476,19476,19.4
40129,Josse,1003,0,22534,22534,22.5
62331,Feuchy,1003,0,28211,28211,28.1
76663,Sassetot-le-Mauconduit,1003,0,6508,6508,6.5
78193,Dampierre-en-Yvelines,1003,0,1265,1265,1.3
18030,Blancafort,1002,0,0,0,0
28130,Digny,1002,0,17887,17887,17.9
36071,Étrechet,1002,0,37138,37138,37.1
39150,Choisey,1002,7451,20336,27787,27.7
54509,Sommerviller,1002,0,7973,7973,8
56009,Bangor,1002,0,12152,12152,12.1
56039,La Chapelle-Neuve,1002,0,2353,2353,2.3
59190,Élesmes,1002,0,35742,35742,35.7
67214,Hurtigheim,1002,1800,19064,20864,20.8
68088,Feldkirch,1002,0,69801,69801,69.7
85067,Cheffois,1002,0,21894,21894,21.9
89066,Cerisiers,1002,5633,1943,7576,7.6
3046,Buxières-les-Mines,1001,0,15377,15377,15.4
9209,Montjoie-en-Couserans,1001,0,121300,121300,121.2
12258,La Salvetat-Peyralès,1001,0,23223,23223,23.2
21554,Saint-Jean-de-Losne,1001,0,7505,7505,7.5
25074,Bonnétage,1001,4750,16811,21561,21.5
51367,Le Mesnil-sur-Oger,1001,0,19893,19893,19.9
59458,Péronne-en-Mélantois,1001,0,16576,16576,16.6
71238,Iguerande,1001,0,28367,28367,28.3
74198,Nâves-Parmelan,1001,0,7732,7732,7.7
87045,Cieux,1001,7210,17037,24247,24.2
97215,Macouba,1001,15500,9063,24563,24.5
2355,Gricourt,1000,0,9060,9060,9.1
10360,Saint-Pouange,1000,0,14280,14280,14.3
16046,Coteaux-du-Blanzacais,1000,15920,53471,69391,69.4
19178,Sadroc,1000,0,15960,15960,16
28035,Berchères-les-Pierres,1000,0,29139,29139,29.1
28171,Garnay,1000,0,1338,1338,1.3
29074,Guimiliau,1000,121647,7385,129032,129
46007,Arcambal,1000,0,8444,8444,8.4
47019,Bajamont,1000,0,22892,22892,22.9
57511,Norroy-le-Veneur,1000,0,2030,2030,2
60661,Vaumoise,1000,0,3915,3915,3.9
62097,Beaumetz-lès-Loges,1000,0,28126,28126,28.1
73160,Montagnole,1000,17199,12711,29910,29.9
73188,Notre-Dame-des-Millières,1000,0,23589,23589,23.6
76050,Avremesnil,1000,0,8070,8070,8.1
2387,Itancourt,999,0,0,0,0
14626,Saint-Martin-de-Mailloc,999,0,11120,11120,11.1
14764,Pont-d'Ouilly,999,0,15649,15649,15.7
18052,Charenton-du-Cher,999,0,4402,4402,4.4
2B316,Santa-Reparata-di-Balagna,999,12500,14020,26520,26.5
35318,Saint-Thual,999,0,12506,12506,12.5
37099,Druye,999,0,11820,11820,11.8
51613,Verzenay,999,0,17754,17754,17.8
60542,Rochy-Condé,999,0,39174,39174,39.2
28287,Orgères-en-Beauce,998,0,5242,5242,5.3
38109,Chozeau,998,0,5152,5152,5.2
38259,Montseveroux,998,0,25512,25512,25.6
50164,Domjean,998,0,14761,14761,14.8
50297,La Meauffe,998,0,14761,14761,14.8
72067,La Chapelle-Saint-Rémy,998,0,6089,6089,6.1
1407,Seyssel,997,0,24081,24081,24.2
19211,Saint-Hilaire-Peyroux,997,7473,18918,26391,26.5
67247,Kolbsheim,997,0,387314,387314,388.5
71490,Saint-Vincent-Bragny,997,0,3866,3866,3.9
27018,Appeville-Annebault,996,0,22498,22498,22.6
63395,Saint-Sandoux,996,0,17854,17854,17.9
68064,Chalampé,996,0,69384,69384,69.7
72075,Chemiré-le-Gaudin,996,0,5335,5335,5.4
76471,Norville,996,3070,7590,10660,10.7
30046,Boucoiran-et-Nozières,995,0,31101,31101,31.3
47213,Prayssas,995,0,9559,9559,9.6
72139,Fyé,995,0,46835,46835,47.1
28350,Saint-Luperce,994,0,3678,3678,3.7
29038,Commana,994,0,7341,7341,7.4
35165,Marcillé-Robert,994,0,19350,19350,19.5
63179,Job,994,7584,8982,16566,16.7
69254,Valsonne,994,0,11749,11749,11.8
74253,Saint-Sixt,994,0,7245,7245,7.3
86052,Champagné-Saint-Hilaire,994,0,22385,22385,22.5
29240,Rosnoën,993,0,12835,12835,12.9
41146,Monthou-sur-Cher,993,10761,18247,29008,29.2
43199,Saint-Jeures,993,7132,22747,29879,30.1
46229,Puybrun,993,0,32397,32397,32.6
52529,Villegusien-le-Lac,993,0,12298,12298,12.4
58295,Tracy-sur-Loire,993,0,19798,19798,19.9
65452,Trie-sur-Baïse,993,0,32167,32167,32.4
69065,Corcelles-en-Beaujolais,993,0,0,0,0
72110,Crosmières,993,0,7199,7199,7.2
76282,Freneuse,993,0,28364,28364,28.6
79078,Plaine-d'Argenson,993,4400,13383,17783,17.9
7058,Chassiers,992,3787,15629,19416,19.6
22103,Langrolay-sur-Rance,992,0,26427,26427,26.6
34296,Saussines,992,10070,10846,20916,21.1
40183,Mimbaste,992,0,7382,7382,7.4
42195,Sail-sous-Couzan,992,0,8888,8888,9
51571,Val-de-Vesle,992,0,17630,17630,17.8
59463,Pitgam,992,0,19106,19106,19.3
60067,Béthisy-Saint-Martin,992,6469,8935,15404,15.5
77291,Le Mesnil-Amelot,992,0,12302,12302,12.4
2085,Bézu-Saint-Germain,991,0,22906,22906,23.1
40122,Haut-Mauco,991,45062,22896,67958,68.6
77031,Bernay-Vilbert,991,0,5036,5036,5.1
12025,Belmont-sur-Rance,990,0,38738,38738,39.1
17226,Mazeray,990,0,27576,27576,27.9
18026,Belleville-sur-Loire,990,0,17836,17836,18
21016,Arceau,990,0,4312,4312,4.4
21611,Sombernon,990,0,5568,5568,5.6
27294,Val d'Orger,990,0,6514,6514,6.6
63378,Saint-Maurice,990,0,17747,17747,17.9
78516,Raizeux,990,0,1929,1929,1.9
2086,Bichancourt,989,0,17770,17770,18
2217,Coucy-le-Château-Auffrique,989,0,979,979,1
7293,Saint-Romain-de-Lerps,989,0,19322,19322,19.5
12140,Martiel,989,0,2884,2884,2.9
26095,Cléon-d'Andran,989,14425,9529,23954,24.2
62373,Givenchy-lès-la-Bassée,989,0,16321,16321,16.5
77406,Saint-Denis-lès-Rebais,989,0,16286,16286,16.5
85145,Monsireigne,989,0,26879,26879,27.2
8316,Neufmanil,988,0,22696,22696,23
11259,Moussoulens,988,0,6408,6408,6.5
37200,Rivarennes,988,0,15727,15727,15.9
56134,Mohon,988,0,14878,14878,15.1
57464,Metzeresche,988,0,6331,6331,6.4
78557,Saint-Hilarion,988,0,1925,1925,1.9
87070,La Geneytouse,988,0,4066,4066,4.1
90088,Rougegoutte,988,0,29429,29429,29.8
1026,Bâgé-le-Châtel,987,0,13555,13555,13.7
3003,Ainay-le-Château,987,0,15517,15517,15.7
14676,Sommervieu,987,0,38041,38041,38.5
16132,Étagnac,987,8746,20307,29053,29.4
29112,Lanildut,987,7147,1778,8925,9
46095,Espère,987,0,8334,8334,8.4
50483,Saint-Gilles,987,0,14598,14598,14.8
51046,Beine-Nauroy,987,0,17541,17541,17.8
59132,Carnières,987,0,6782,6782,6.9
64289,La Bastide-Clairence,987,50142,25648,75790,76.8
2532,Moÿ-de-l'Aisne,986,0,0,0,0
3022,Bellenaves,986,0,20168,20168,20.5
41010,Azé,986,0,12195,12195,12.4
54338,Malleloy,986,0,9494,9494,9.6
69203,Saint-Genis-l'Argentière,986,2582,49420,52002,52.7
6039,Châteauneuf-Villevieille,985,0,19393,19393,19.7
11293,Pomas,985,0,6389,6389,6.5
17080,Chambon,985,1375,40756,42131,42.8
59541,Saint-Python,985,0,248,248,0.3
62024,Alquines,985,0,2131,2131,2.2
62901,Wittes,985,0,87665,87665,89
76224,Écrainville,985,0,11665,11665,11.8
8028,Aubrives,984,0,6318,6318,6.4
22245,Pluzunet,984,0,19548,19548,19.9
24304,Nantheuil,984,17200,3247,20447,20.8
29287,Tréflez,984,0,1870,1870,1.9
74089,Cordon,984,0,10305,10305,10.5
88302,Le Ménil,984,0,1989,1989,2
8448,Thilay,983,0,15303,15303,15.6
37141,Luzillé,983,0,22119,22119,22.5
50475,Saint-Georges-Montcocq,983,0,14539,14539,14.8
59539,Saint-Pierre-Brouck,983,0,18932,18932,19.3
67377,Plaine,983,1325,71137,72462,73.7
78464,Orcemont,983,0,1915,1915,1.9
10211,Macey,982,0,14023,14023,14.3
14656,Saint-Rémy,982,0,29688,29688,30.2
29102,Landeleau,982,0,8049,8049,8.2
31411,Pechbusque,982,0,16011,16011,16.3
33208,Jau-Dignac-et-Loirac,982,0,949,949,1
40278,Saint-Paul-en-Born,982,0,5373,5373,5.5
41239,Seigy,982,6695,18045,24740,25.2
59318,Houtkerque,982,0,6000,6000,6.1
68332,Tagolsheim,982,6045,26342,32387,33
74061,Chapeiry,982,0,7585,7585,7.7
79069,Chanteloup,982,0,27935,27935,28.4
85267,Sainte-Radégonde-des-Noyers,982,0,20754,20754,21.1
86161,Moncontour,982,0,5016,5016,5.1
1102,Chevroux,981,0,13473,13473,13.7
16409,Villefagnan,981,16662,21473,38135,38.9
22160,Noyal,981,400,11840,12240,12.5
46103,Saint-Paul-Flaugnac,981,0,24113,24113,24.6
60685,Villers-Saint-Sépulcre,981,0,4075,4075,4.2
69184,Sainte-Catherine,981,30192,49170,79362,80.9
80717,Saint-Sauflieu,981,0,62893,62893,64.1
11433,Villeneuve-Minervois,980,19300,6356,25656,26.2
17022,Asnières-la-Giraud,980,0,27297,27297,27.9
47318,Vianne,980,0,4751,4751,4.8
69269,Yzeron,980,0,9445,9445,9.6
85192,Rochetrejoux,980,54468,4989,59457,60.7
7086,Étables,979,60356,43077,103433,105.7
21521,Remilly-sur-Tille,979,0,23,23,0
36056,Cluis,979,37940,2871,40811,41.7
36231,Velles,979,0,7188,7188,7.3
38398,Saint-Jean-d'Avelanne,979,0,8585,8585,8.8
51299,Isles-sur-Suippe,979,0,17399,17399,17.8
54295,Landres,979,0,4313,4313,4.4
57677,Trémery,979,0,1987,1987,2
69173,Sarcey,979,0,7814,7814,8
95541,Saint-Clair-sur-Epte,979,16485,6189,22674,23.2
7050,Chambonas,978,9020,23932,32952,33.7
17070,Brizambourg,978,0,27242,27242,27.9
66041,Cases-de-Pène,978,0,8146,8146,8.3
68013,Attenschwiller,978,16947,19009,35956,36.8
80611,Oresmaux,978,0,1350,1350,1.4
17298,Rioux,977,3920,16276,20196,20.7
24320,Payzac,977,26680,12284,38964,39.9
35314,Saint-Suliac,977,0,23164,23164,23.7
39177,Hauteroche,977,1330,25968,27298,27.9
53110,Grez-en-Bouère,977,0,5870,5870,6
53162,Moulay,977,0,36306,36306,37.2
63233,Montaigut-en-Combraille,977,0,1516,1516,1.6
68238,Niffer,977,0,68060,68060,69.7
73247,Saint-Jean-de-la-Porte,977,0,17472,17472,17.9
2336,Frières-Faillouël,976,0,17536,17536,18
26381,Jaillans,976,19682,19784,39466,40.4
27280,Gauciel,976,0,11479,11479,11.8
27478,Prey,976,0,11479,11479,11.8
31320,Marquefave,976,0,1679,1679,1.7
38156,Les Éparres,976,0,11860,11860,12.2
44208,Treffieux,976,0,15534,15534,15.9
57091,Bliesbruck,976,0,13339,13339,13.7
60083,Bonneuil-en-Valois,976,0,3821,3821,3.9
70228,Faverney,976,0,5796,5796,5.9
74117,Étercy,976,0,13217,13217,13.5
77432,Saint-Rémy-de-la-Vanne,976,0,16072,16072,16.5
79128,François,976,0,5425,5425,5.6
27589,Saint-Pierre-de-Bailleul,975,9750,28914,38664,39.7
30081,Chusclan,975,0,14227,14227,14.6
37230,Saint-Ouen-les-Vignes,975,34000,26465,60465,62
38532,Vénérieu,975,0,5034,5034,5.2
56077,Le Guerno,975,9100,9284,18384,18.9
60433,Mortefontaine-en-Thelle,975,0,4050,4050,4.2
22150,Le Merzer,974,0,19725,19725,20.3
24236,Léguillac-de-l'Auche,974,800,5309,6109,6.3
67464,Sermersheim,974,1200,18008,19208,19.7
82023,Bourret,974,0,13071,13071,13.4
91639,Vayres-sur-Essonne,974,0,1431,1431,1.5
1267,Nurieux-Volognat,973,0,36807,36807,37.8
3110,Espinasse-Vozelle,973,0,26655,26655,27.4
16148,Genac-Bignac,973,8453,67452,75905,78
24297,Moulin-Neuf,973,21600,7395,28995,29.8
29252,Saint-Jean-Trolimon,973,0,36520,36520,37.5
40021,Azur,973,0,21860,21860,22.5
50455,Saint-Clair-sur-l'Elle,973,0,14391,14391,14.8
56114,Locmaria,973,0,11800,11800,12.1
60197,Dieudonné,973,0,4041,4041,4.2
71064,Bruailles,973,0,4006,4006,4.1
74142,Héry-sur-Alby,973,0,7516,7516,7.7
9042,La Bastide-de-Sérou,972,0,117786,117786,121.2
18037,Brinon-sur-Sauldre,972,9950,0,9950,10.2
28387,Thiron-Gardais,972,0,692,692,0.7
34288,Saint-Sériès,972,0,10627,10627,10.9
38296,Le Passage,972,0,8524,8524,8.8
42294,Saint-Vincent-de-Boisset,972,0,28683,28683,29.5
57696,Varsberg,972,0,6028,6028,6.2
66104,Los Masos,972,0,29111,29111,29.9
81054,Cambounet-sur-le-Sor,972,0,1082,1082,1.1
85282,Sigournais,972,41264,4948,46212,47.5
8076,Boulzicourt,971,0,21297,21297,21.9
10191,Lavau,971,0,13866,13866,14.3
34012,Argelliers,971,0,5245,5245,5.4
34041,Brignac,971,0,1106,1106,1.1
53017,Val-du-Maine,971,0,5834,5834,6
55366,Val-d'Ornain,971,0,11707,11707,12.1
57113,Brouderdorff,971,0,6321,6321,6.5
72382,Volnay,971,0,18151,18151,18.7
78609,Tessancourt-sur-Aubette,971,0,9037,9037,9.3
12094,Entraygues-sur-Truyère,970,94183,4804,98987,102
33407,Saint-Genès-de-Fronsac,970,0,14600,14600,15.1
34248,Sainte-Croix-de-Quintillargues,970,15329,18074,33403,34.4
45020,Le Bardon,970,0,3997,3997,4.1
57006,Achen,970,0,22355,22355,23
77534,Yèbles,970,0,920,920,0.9
82073,Goudourville,970,0,104218,104218,107.4
8188,Gespunsart,969,0,22259,22259,23
16304,Saint-Brice,969,0,36256,36256,37.4
18035,Brécy,969,0,7343,7343,7.6
36189,Saint-Denis-de-Jouhet,969,0,2817,2817,2.9
62005,Achiet-le-Grand,969,0,4818,4818,5
64139,Bosdarros,969,8700,28610,37310,38.5
87135,Saint-Auvent,969,8850,426,9276,9.6
4110,Mallemoisson,968,7696,40574,48270,49.9
5079,Le Monêtier-les-Bains,968,0,69054,69054,71.3
11410,Villalier,968,0,6279,6279,6.5
18179,Pigny,968,0,7336,7336,7.6
18255,Le Subdray,968,19249,18541,37790,39
21194,Corgoloin,968,0,4642,4642,4.8
21290,Gemeaux,968,0,13778,13778,14.2
31435,Poucharramet,968,0,33899,33899,35
45026,Bazoches-sur-le-Betz,968,0,2935,2935,3
50407,Poilley,968,0,23817,23817,24.6
65057,Azereix,968,0,9248,9248,9.6
67023,Batzendorf,968,0,11770,11770,12.2
73017,Apremont,968,0,17311,17311,17.9
3060,Charmeil,967,0,26491,26491,27.4
4036,Le Brusquet,967,265,40532,40797,42.2
7280,Saint-Paul-le-Jeune,967,17644,23663,41307,42.7
11289,Pieusse,967,9580,12729,22309,23.1
16233,Mosnac-Saint-Simeux,967,10208,36181,46389,48
19030,Brignac-la-Plaine,967,0,15433,15433,16
33323,Le Pian-sur-Garonne,967,0,9889,9889,10.2
35087,Cornillé,967,0,14528,14528,15
38459,Saint-Sorlin-de-Vienne,967,0,7440,7440,7.7
68257,Pfetterhouse,967,0,13770,13770,14.2
77270,Maisoncelles-en-Brie,967,0,3766,3766,3.9
82176,La Salvetat-Belmontet,967,0,7849,7849,8.1
84073,Ménerbes,967,0,19711,19711,20.4
5004,Ancelle,966,0,64271,64271,66.5
27670,Vandrimare,966,0,6356,6356,6.6
29073,Guimaëc,966,0,57920,57920,60
30103,Domazan,966,0,3797,3797,3.9
33416,Saint-Girons-d'Aiguevives,966,0,9887,9887,10.2
35255,Saint-Benoît-des-Ondes,966,0,22903,22903,23.7
53021,La Bazoge-Montpinçon,966,0,35898,35898,37.2
60187,Cuigy-en-Bray,966,3664,7919,11583,12
60265,Froissy,966,0,21784,21784,22.6
71436,Saint-Laurent-d'Andenay,966,0,15522,15522,16.1
77354,Pamfou,966,0,916,916,0.9
16369,Sigogne,965,4350,36106,40456,41.9
25519,Saint-Hippolyte,965,0,6722,6722,7
57542,Piblange,965,0,5812,5812,6
58207,Parigny-les-Vaux,965,0,51903,51903,53.8
77010,Aubepierre-Ozouer-le-Repos,965,0,12424,12424,12.9
16193,Louzac-Saint-André,964,900,36069,36969,38.3
63128,Crevant-Laveine,964,0,4429,4429,4.6
68290,Rustenhart,964,0,16731,16731,17.4
71249,Laives,964,0,11678,11678,12.1
71291,Melay,964,0,21600,21600,22.4
86186,Oyré,964,0,21940,21940,22.8
10289,Plancy-l'Abbaye,963,0,990,990,1
44170,Saint-Julien-de-Vouvantes,963,0,16151,16151,16.8
51365,Les Mesneux,963,0,17114,17114,17.8
53056,La Chapelle-Anthenaise,963,0,41910,41910,43.5
57186,Ébersviller,963,0,13862,13862,14.4
57615,Saint-Jean-Rohrbach,963,0,13161,13161,13.7
67192,Herbsheim,963,4523,17805,22328,23.2
67554,Wolxheim,963,5183,2481,7664,8
68178,Lautenbachzell,963,11307,23764,35071,36.4
74192,Moye,963,0,13041,13041,13.5
81112,Labastide-de-Lévis,963,0,52910,52910,54.9
89023,Augy,963,2810,18839,21649,22.5
9336,Villeneuve-d'Olmes,962,0,8543,8543,8.9
18194,Rians,962,0,7290,7290,7.6
21196,Corpeau,962,0,4183,4183,4.3
27595,Saint-Pierre-du-Bosguérard,962,0,3941,3941,4.1
34018,Autignac,962,0,1882,1882,2
51007,Ambonnay,962,0,2378,2378,2.5
54596,Xeuilley,962,0,9797,9797,10.2
74296,Vers,962,18256,3770,22026,22.9
76720,Varengeville-sur-Mer,962,0,11691,11691,12.2
6014,Bendejun,961,0,27099,27099,28.2
7301,Saint-Victor,961,6440,42285,48725,50.7
12243,Saint-Rome-de-Cernon,961,0,2013,2013,2.1
2B169,Morosaglia,961,0,3613,3613,3.8
31315,Mane,961,0,51648,51648,53.7
38546,Vignieu,961,0,4961,4961,5.2
42233,Saint-Haon-le-Vieux,961,0,28359,28359,29.5
45069,Chambon-la-Forêt,961,0,7283,7283,7.6
45271,Saint-Brisson-sur-Loire,961,0,12437,12437,12.9
51028,Avenay-Val-d'Or,961,0,2375,2375,2.5
61091,Champsecret,961,5751,32468,38219,39.8
73069,Chamoux-sur-Gelon,961,4000,17186,21186,22
88106,Ban-sur-Meurthe-Clefcy,961,0,9343,9343,9.7
14589,Saint-Germain-le-Vasson,960,0,29023,29023,30.2
38353,Saint-Alban-du-Rhône,960,0,24541,24541,25.6
48013,Badaroux,960,25301,37871,63172,65.8
52251,Jonchery,960,0,105449,105449,109.8
53064,Châtillon-sur-Colmont,960,0,12657,12657,13.2
56060,Les Fougerêts,960,0,13695,13695,14.3
59584,Taisnières-sur-Hon,960,0,2709,2709,2.8
65389,Saint-Laurent-de-Neste,960,0,6282,6282,6.5
74301,Villard,960,7660,15423,23083,24
7260,Saint-Lager-Bressac,959,0,20532,20532,21.4
11404,Ventenac-Cabardès,959,13275,6220,19495,20.3
14102,Le Breuil-en-Auge,959,0,15413,15413,16.1
17273,Pérignac,959,0,11324,11324,11.8
18110,Herry,959,0,3309,3309,3.5
51312,Juvigny,959,0,48744,48744,50.8
52242,Haute-Amance,959,0,18913,18913,19.7
55492,Sommedieue,959,0,6104,6104,6.4
73284,Salins-Fontaine,959,0,74395,74395,77.6
81201,Pampelonne,959,0,21940,21940,22.9
88048,Bellefontaine,959,0,24116,24116,25.1
11037,Berriac,958,0,6214,6214,6.5
26243,Le Poët-Laval,958,7863,33398,41261,43.1
51614,Verzy,958,0,17026,17026,17.8
67132,Eschbach,958,0,23180,23180,24.2
73312,Verrens-Arvey,958,0,22598,22598,23.6
78307,Hermeray,958,0,1866,1866,1.9
26078,Charols,957,14898,9221,24119,25.2
42307,Tartaras,957,0,22423,22423,23.4
91546,Saint-Cyr-sous-Dourdan,957,0,5563,5563,5.8
95101,Bray-et-Lû,957,0,6050,6050,6.3
3235,Saint-Gérand-le-Puy,956,0,16512,16512,17.3
17221,Marsais,956,0,39556,39556,41.4
24584,Villefranche-de-Lonchat,956,12865,3331,16196,16.9
25438,Osselle-Routelle,956,0,16844,16844,17.6
34215,Pouzols,956,6600,5164,11764,12.3
36123,Mézières-en-Brenne,956,0,4740,4740,5
41235,Sargé-sur-Braye,956,0,28555,28555,29.9
74188,Montriond,956,87855,66801,154656,161.8
78588,Saulx-Marchais,956,0,413,413,0.4
78623,Le Tremblay-sur-Mauldre,956,0,413,413,0.4
5029,Chabottes,955,0,63539,63539,66.5
25024,Arçon,955,0,10459,10459,11
33057,Blasimon,955,0,9484,9484,9.9
38005,Allemond,955,0,54319,54319,56.9
46232,Le Vignon-en-Quercy,955,0,31158,31158,32.6
57426,Luttange,955,0,6119,6119,6.4
59393,Maulde,955,0,35928,35928,37.6
60079,Boissy-Fresnoy,955,0,3739,3739,3.9
60189,Cuts,955,0,0,0,0
67364,Osthouse,955,3000,17657,20657,21.6
71356,Pouilloux,955,0,15345,15345,16.1
72291,Saint-Jean-de-la-Motte,955,0,4788,4788,5
78246,Fontenay-Saint-Père,955,0,8888,8888,9.3
86292,Villiers,955,0,49628,49628,52
25039,Avoudrey,954,0,11269,11269,11.8
34092,Cruzy,954,0,5394,5394,5.7
34304,Soubès,954,0,10715,10715,11.2
45018,Auxy,954,0,7230,7230,7.6
60454,La Neuville-en-Hez,954,0,37409,37409,39.2
79204,Périgné,954,0,27552,27552,28.9
79290,Saint-Pompain,954,0,7863,7863,8.2
81062,Fontrieu,954,0,8913,8913,9.3
86184,Ouzilly,954,0,21712,21712,22.8
90037,Éloie,954,6418,33283,39701,41.6
1369,Saint-Just,953,0,18424,18424,19.3
11115,Cuxac-Cabardès,953,0,12310,12310,12.9
12136,Maleville,953,0,2779,2779,2.9
22003,Aucaleuc,953,0,25388,25388,26.6
45281,Saint-Hilaire-les-Andrésis,953,0,2889,2889,3
50597,Tirepied-sur-Sée,953,0,23448,23448,24.6
66023,Bouleternère,953,0,1286,1286,1.3
88439,Sanchey,953,0,23965,23965,25.1
9103,Crampagna,952,0,25588,25588,26.9
29291,Trégourez,952,0,7803,7803,8.2
73019,Argentine,952,1400,36114,37514,39.4
82184,Vaïssac,952,0,7728,7728,8.1
89469,Perceneige,952,3026,175,3201,3.4
1136,Cruzilles-lès-Mépillat,951,0,3852,3852,4.1
1245,Bohas-Meyriat-Rignat,951,0,18385,18385,19.3
14288,Le Fresne-Camilly,951,0,21162,21162,22.3
17183,Grézac,951,0,14977,14977,15.7
19093,Jugeals-Nazareth,951,3765,15178,18943,19.9
41084,La Ferté-Imbault,951,0,8104,8104,8.5
45116,Cravant,951,0,3919,3919,4.1
58146,Lucenay-lès-Aix,951,0,2453,2453,2.6
69119,Longes,951,1100,7317,8417,8.9
15054,Condat,950,16950,14651,31601,33.3
28347,Saint-Lubin-de-la-Haye,950,0,9525,9525,10
29065,Gourlizon,950,4800,30430,35230,37.1
36113,Martizay,950,0,4710,4710,5
59600,Tourmignies,950,0,16214,16214,17.1
68189,Logelheim,950,0,16488,16488,17.4
76355,Héricourt-en-Caux,950,0,2094,2094,2.2
91469,Ormoy-la-Rivière,950,0,2393,2393,2.5
26143,Le Grand-Serre,949,0,15622,15622,16.5
42286,Saint-Romain-les-Atheux,949,0,19416,19416,20.5
44085,Louisfert,949,0,15917,15917,16.8
63083,Chanat-la-Mouteyre,949,2484,7177,9661,10.2
79091,Cirières,949,0,26996,26996,28.4
81003,Alban,949,0,11938,11938,12.6
2748,Trélou-sur-Marne,948,0,21912,21912,23.1
5059,La Freissinouse,948,0,1344,1344,1.4
33470,Saint-Romain-la-Virvée,948,0,14269,14269,15.1
37024,Benais,948,0,8794,8794,9.3
60406,Monceaux,948,0,1385,1385,1.5
62531,Louches,948,0,5802,5802,6.1
64376,Meillon,948,0,27990,27990,29.5
76672,Serqueux,948,0,17909,17909,18.9
11098,Conilhac-Corbières,947,0,12831,12831,13.5
22356,Trégomeur,947,0,19179,19179,20.3
24527,Savignac-les-Églises,947,1890,5289,7179,7.6
25307,Les Hôpitaux-Neufs,947,0,56399,56399,59.6
43124,Loudes,947,3400,39404,42804,45.2
43159,Raucoules,947,0,7584,7584,8
62407,Ham-en-Artois,947,0,15628,15628,16.5
67335,Nordheim,947,16350,51434,67784,71.6
74044,Bossey,947,0,3711,3711,3.9
77196,Fresnes-sur-Marne,947,0,720,720,0.8
78567,Saint-Martin-la-Garenne,947,6055,8814,14869,15.7
84024,Cabrières-d'Aigues,947,0,4249,4249,4.5
89169,Flogny-la-Chapelle,947,5300,2200,7500,7.9
2830,Wassigny,946,0,5215,5215,5.5
12057,Cassagnes-Bégonhès,946,0,28953,28953,30.6
15108,Val d'Arcomie,946,18940,20924,39864,42.1
21462,Norges-la-Ville,946,0,23,23,0
46089,Duravel,946,0,34396,34396,36.4
53216,Saint-Fraimbault-de-Prières,946,0,35154,35154,37.2
59237,Flêtre,946,0,5780,5780,6.1
62377,Gosnay,946,0,15611,15611,16.5
67473,Soultz-les-Bains,946,44088,2437,46525,49.2
77156,Darvault,946,0,484,484,0.5
2477,Mercin-et-Vaux,945,0,7906,7906,8.4
10412,Villechétif,945,0,13495,13495,14.3
19151,Noailles,945,6250,15082,21332,22.6
39576,Val-Sonnette,945,5600,14409,20009,21.2
42264,Saint-Médard-en-Forez,945,5950,17129,23079,24.4
59215,Estreux,945,0,18205,18205,19.3
68296,Saint-Hippolyte,945,9390,2259,11649,12.3
71253,Lans,945,0,25983,25983,27.5
90093,Sermamagny,945,0,32969,32969,34.9
10261,Mussy-sur-Seine,944,0,16479,16479,17.5
24449,Saint-Martial-d'Artenset,944,14050,7175,21225,22.5
24484,Saint-Pierre-de-Chignac,944,1700,5272,6972,7.4
27025,Autheuil-Authouillet,944,0,27995,27995,29.7
30330,Tornac,944,0,29507,29507,31.3
34211,Le Poujol-sur-Orb,944,0,8789,8789,9.3
36229,Val-Fouzon,944,0,955,955,1
38432,Saint-Nicolas-de-Macherin,944,0,16037,16037,17
41049,Chémery,944,0,17347,17347,18.4
41267,Vallières-les-Grandes,944,0,17347,17347,18.4
42070,Cordelle,944,24708,26761,51469,54.5
54145,Crévic,944,0,7512,7512,8
59582,Strazeele,944,0,5767,5767,6.1
63200,Lussat,944,0,7139,7139,7.6
64510,Sault-de-Navailles,944,0,25418,25418,26.9
1084,Chanoz-Châtenay,943,0,3819,3819,4
1286,Parves et Nattages,943,0,10510,10510,11.1
35119,Gennes-sur-Seiche,943,0,14168,14168,15
46175,Lissac-et-Mouret,943,0,27847,27847,29.5
62799,Sorrus,943,0,10032,10032,10.6
69145,Odenas,943,0,0,0,0
76457,Moulineaux,943,0,26935,26935,28.6
80063,Beauchamps,943,0,2712,2712,2.9
27406,Mesnil-sur-l'Estrée,942,0,11079,11079,11.8
2B093,Corbara,942,21350,13220,34570,36.7
33325,Plassac,942,0,9641,9641,10.2
61460,Sap-en-Auge,942,11975,6809,18784,19.9
62325,Fauquembergues,942,0,83838,83838,89
63321,Saint-Babel,942,0,6123,6123,6.5
71566,Verdun-sur-le-Doubs,942,14910,10870,25780,27.4
72115,Dissay-sous-Courcillon,942,0,53121,53121,56.4
87129,Royères,942,0,3877,3877,4.1
3055,La Chapelaude,941,0,3829,3829,4.1
7268,Saint-Martin-d'Ardèche,941,0,75013,75013,79.7
29255,Saint-Méen,941,33666,23711,57377,61
35081,Clayes,941,0,48221,48221,51.2
49082,Chaudefonds-sur-Layon,941,7134,18681,25815,27.4
67327,Niederlauterbach,941,0,107907,107907,114.7
76427,Mesnières-en-Bray,941,0,21982,21982,23.4
11111,Cruscades,940,0,12736,12736,13.5
16388,Trois-Palis,940,0,24438,24438,26
17245,Montroy,940,0,26085,26085,27.8
33252,Loupes,940,0,92809,92809,98.7
54084,Mont-Bonvillers,940,0,4141,4141,4.4
68016,Balgau,940,5921,16315,22236,23.7
78020,Arnouville-lès-Mantes,940,16500,8748,25248,26.9
2668,Sains-Richaumont,939,0,16745,16745,17.8
36194,Saint-Genou,939,0,1488,1488,1.6
57299,Hartzviller,939,0,6113,6113,6.5
60623,Songeons,939,0,4607,4607,4.9
24227,Lanouaille,938,16462,11793,28255,30.1
30149,Lirac,938,0,13688,13688,14.6
34241,Saint-Bauzille-de-la-Sylve,938,0,5067,5067,5.4
49030,Blou,938,0,9139,9139,9.7
57031,Ars-Laquenexy,938,0,46507,46507,49.6
63160,Aulhat-Flat,938,0,6097,6097,6.5
72161,Lhomme,938,0,52895,52895,56.4
79030,Beaussais-Vitré,938,0,27090,27090,28.9
11225,Mas-Saintes-Puelles,937,16040,8233,24273,25.9
25014,Amagney,937,1300,16510,17810,19
31093,Le Burgaud,937,0,7838,7838,8.4
43174,Saint-Christophe-sur-Dolaison,937,4125,38988,43113,46
60064,Berneuil-sur-Aisne,937,4250,6347,10597,11.3
63091,Charbonnier-les-Mines,937,0,6091,6091,6.5
86088,Croutelle,937,0,55826,55826,59.6
33033,Baurech,936,0,6891,6891,7.4
48094,Massegros Causses Gorges,936,23460,33237,56697,60.6
50576,Siouville-Hague,936,62000,29441,91441,97.7
59444,Odomez,936,0,18031,18031,19.3
69215,Saint-Julien,936,9255,19872,29127,31.1
77044,Bombon,936,5950,887,6837,7.3
79217,Prailles-La Couarde,936,0,27032,27032,28.9
83151,Vins-sur-Caramy,936,0,35068,35068,37.5
19098,Lagarde-Marc-la-Tour,935,0,17742,17742,19
21106,Bretenière,935,10510,27133,37643,40.3
29148,Mespaul,935,11006,1777,12783,13.7
38442,Saint-Pierre-de-Chartreuse,935,0,64021,64021,68.5
49112,Le Coudray-Macouard,935,0,9110,9110,9.7
50027,Bacilly,935,0,23005,23005,24.6
74109,Éloise,935,15329,22584,37913,40.5
78474,Orvilliers,935,0,9375,9375,10
7333,Vanosc,934,58120,4812,62932,67.4
8391,Saint-Menges,934,0,21455,21455,23
10018,Auxon,934,0,17388,17388,18.6
28331,Saintigny,934,0,665,665,0.7
36161,Le Pont-Chrétien-Chabenet,934,0,6858,6858,7.3
51629,Villers-Allerand,934,0,16599,16599,17.8
53197,Saint-Aignan-sur-Roë,934,0,6183,6183,6.6
68221,Muespach,934,0,25055,25055,26.8
89332,Saint-Agnan,934,2350,3313,5663,6.1
6109,La Roquette-sur-Var,933,0,18369,18369,19.7
25405,Montperreux,933,0,55565,55565,59.6
26033,La Baume-de-Transit,933,0,14425,14425,15.5
55236,Haudainville,933,0,57830,57830,62
62039,Arleux-en-Gohelle,933,0,1161,1161,1.2
7345,Vion,932,0,41009,41009,44
30324,Souvignargues,932,6440,69331,75771,81.3
37251,Souvigné,932,0,8645,8645,9.3
48042,Chastel-Nouvel,932,23425,10977,34402,36.9
54546,Vandières,932,0,10183,10183,10.9
76421,Mélamare,932,0,7103,7103,7.6
2231,Couvron-et-Aumencourt,931,0,4690,4690,5
7101,Grospierres,931,0,56850,56850,61.1
63163,Gelles,931,0,2914,2914,3.1
68023,Beblenheim,931,0,2226,2226,2.4
82011,Barry-d'Islemade,931,0,4746,4746,5.1
28160,Francourville,930,0,27099,27099,29.1
35143,Landujan,930,0,18059,18059,19.4
78497,Poigny-la-Forêt,930,0,1812,1812,1.9
86285,Verrières,930,12904,37614,50518,54.3
16151,Genté,929,4764,34759,39523,42.5
33151,Donnezac,929,0,5199,5199,5.6
38363,Saint-Barthélemy,929,0,23748,23748,25.6
46170,Leyme,929,48740,27434,76174,82
80126,Bouttencourt,929,0,17,17,0
86036,Bournand,929,0,4746,4746,5.1
91292,Guibeville,929,0,9333,9333,10
27464,Le Plessis-Grohan,928,0,10914,10914,11.8
62656,Pihem,928,0,2008,2008,2.2
68180,Leimbach,928,0,15618,15618,16.8
70280,Gray-la-Ville,928,0,4683,4683,5
25493,La Rivière-Drugeon,927,0,13448,13448,14.5
28360,Saint-Sauveur-Marville,927,0,1240,1240,1.3
31476,Saint-Élix-le-Château,927,0,32463,32463,35
53245,Saint-Pierre-des-Landes,927,0,4213,4213,4.5
54073,Bicqueley,927,0,1934,1934,2.1
57552,Pouilly,927,0,45961,45961,49.6
60213,Ermenonville,927,0,3630,3630,3.9
67189,Heiligenstein,927,0,28668,28668,30.9
76580,Saint-Georges-sur-Fontaine,927,0,634,634,0.7
81092,Fiac,927,0,13865,13865,15
2775,Vendeuil,926,0,0,0,0
26094,Claveyson,926,3700,15244,18944,20.5
28226,Maillebois,926,0,1239,1239,1.3
36016,Bélâbre,926,0,18675,18675,20.2
38134,Cour-et-Buis,926,0,23672,23672,25.6
38328,Quaix-en-Chartreuse,926,0,35772,35772,38.6
42261,Saint-Martin-Lestra,926,27144,16785,43929,47.4
50252,Hudimesnil,926,0,22411,22411,24.2
60609,Savignies,926,0,36311,36311,39.2
64359,Lucq-de-Béarn,926,0,24934,24934,26.9
67511,Walbourg,926,0,22405,22405,24.2
68354,Walbach,926,0,19031,19031,20.6
76409,Mannevillette,926,0,8352,8352,9
1088,Charnoz-sur-Ain,925,0,15786,15786,17.1
17152,Épargnes,925,0,14568,14568,15.7
22196,Pleudaniel,925,0,18376,18376,19.9
40108,Gastes,925,9309,25244,34553,37.4
79094,Clessé,925,0,26313,26313,28.4
7229,Saint-Didier-sous-Aubenas,924,11924,15771,27695,30
12002,Aguessac,924,0,9549,9549,10.3
14303,Glos,924,0,10285,10285,11.1
33343,Pujols-sur-Ciron,924,0,28333,28333,30.7
50230,Hardinvast,924,0,29064,29064,31.5
57275,Guessling-Hémering,924,0,15777,15777,17.1
63432,Thuret,924,0,3776,3776,4.1
67254,Kutzenhausen,924,4040,22357,26397,28.6
68215,Montreux-Vieux,924,0,13157,13157,14.2
77117,Citry,924,0,3598,3598,3.9
78443,Neauphle-le-Vieux,924,0,399,399,0.4
80554,Molliens-Dreuil,924,0,1276,1276,1.4
85265,Saint-Pierre-le-Vieux,924,0,14481,14481,15.7
2769,Vaux-Andigny,923,0,5088,5088,5.5
3030,Biozat,923,0,18879,18879,20.5
27599,Saint-Pierre-la-Garenne,923,0,27372,27372,29.7
35252,Saint-Aubin-des-Landes,923,0,13867,13867,15
59618,Vieux-Reng,923,0,32924,32924,35.7
63012,Artonne,923,0,3772,3772,4.1
63234,Montaigut-le-Blanc,923,0,6000,6000,6.5
67290,Merkwiller-Pechelbronn,923,1699,22333,24032,26
69038,Chambost-Longessaigne,923,0,46263,46263,50.1
86074,Chiré-en-Montreuil,923,0,47965,47965,52
1297,Pizay,922,0,12554,12554,13.6
1381,Saint-Nizier-le-Désert,922,0,192,192,0.2
1385,Saint-Rémy,922,0,17825,17825,19.3
2666,Rozoy-sur-Serre,922,0,10158,10158,11
14711,Trévières,922,0,6382,6382,6.9
30068,Cardet,922,0,1916,1916,2.1
39170,Courlans,922,140,29056,29196,31.7
58002,Alligny-Cosne,922,0,18382,18382,19.9
70058,Beaujeu-Saint-Vallier-Pierrejux-et-Quitteur,922,0,4733,4733,5.1
73079,Châteauneuf,922,0,16488,16488,17.9
84105,Saignon,922,15369,18794,34163,37.1
87183,Saint-Sylvestre,922,0,1494,1494,1.6
60181,Crisolles,921,0,0,0,0
60652,Valdampierre,921,0,2963,2963,3.2
18059,Le Châtelet,920,7298,2466,9764,10.6
29007,Berrien,920,0,47829,47829,52
31402,Odars,920,0,15000,15000,16.3
31427,Pointis-Inard,920,0,19056,19056,20.7
32106,Cologne,920,0,3472,3472,3.8
45249,Paucourt,920,0,12394,12394,13.5
50481,Saint-Germain-sur-Ay,920,0,19223,19223,20.9
64443,Pardies,920,79227,24772,103999,113
72156,Lamnay,920,0,5613,5613,6.1
81251,Saint-Germain-des-Prés,920,0,1024,1024,1.1
5161,La Salle-les-Alpes,919,0,65559,65559,71.3
17408,Saint-Sulpice-d'Arnoult,919,5180,23409,28589,31.1
21545,Sainte-Colombe-sur-Seine,919,0,15332,15332,16.7
21684,Vignoles,919,0,3996,3996,4.3
38210,Leyrieu,919,0,4744,4744,5.2
46064,Catus,919,0,7760,7760,8.4
53073,Congrier,919,0,6084,6084,6.6
1294,Peyrieu,918,0,10231,10231,11.1
7056,Charnas,918,0,4729,4729,5.2
12008,Anglars-Saint-Félix,918,0,1975,1975,2.2
18066,Civray,918,0,2558,2558,2.8
21059,Bellefond,918,0,22,22,0
35345,Trévérien,918,0,11492,11492,12.5
59590,Thiennes,918,0,5609,5609,6.1
60206,Élincourt-Sainte-Marguerite,918,0,8026,8026,8.7
62117,Bertincourt,918,0,4564,4564,5
74304,Ville-en-Sallaz,918,0,4798,4798,5.2
3027,Bézenet,917,0,32760,32760,35.7
21558,Sainte-Marie-la-Blanche,917,0,3988,3988,4.3
42326,Véranne,917,0,28140,28140,30.7
49008,Angrie,917,6390,915,7305,8
54336,Maizières,917,0,9339,9339,10.2
63362,Saint-Ignat,917,0,6935,6935,7.6
72005,Ancinnes,917,0,43164,43164,47.1
76712,La Trinité-du-Mont,917,0,6988,6988,7.6
86167,Monts-sur-Guesnes,917,0,4684,4684,5.1
3174,Molles,916,0,25094,25094,27.4
72267,Saint-Aubin-des-Coudrais,916,0,5588,5588,6.1
10344,Saint-Léger-près-Troyes,915,0,13066,13066,14.3
16320,Saint-Genis-d'Hiersac,915,2540,63432,65972,72.1
59308,Hondeghem,915,0,5590,5590,6.1
59516,Rubrouck,915,0,5590,5590,6.1
30200,Pompignan,914,0,1900,1900,2.1
31020,Aspet,914,0,49122,49122,53.7
47056,Castelnau-sur-Gupie,914,7960,9456,17416,19.1
65295,Luz-Saint-Sauveur,914,0,37427,37427,40.9
67404,Rittershoffen,914,0,25185,25185,27.6
72305,Saint-Ouen-de-Mimbré,914,0,43023,43023,47.1
84010,La Bastidonne,914,0,4101,4101,4.5
91581,Saint-Yon,914,0,6189,6189,6.8
22047,Corlay,913,0,0,0,0
42076,Cremeaux,913,5508,17127,22635,24.8
57373,Lachambre,913,0,15589,15589,17.1
62613,Nielles-lès-Bléquin,913,0,1975,1975,2.2
78410,Moisson,913,9910,4668,14578,16
86086,Coussay-les-Bois,913,0,20779,20779,22.8
88098,Chaumousey,913,0,22960,22960,25.1
22064,Gouarec,912,0,83984,83984,92.1
22082,Le Hinglé,912,0,24296,24296,26.6
29028,Cléden-Cap-Sizun,912,6302,65274,71576,78.5
35201,Muel,912,0,17709,17709,19.4
46268,Saint Géry-Vers,912,0,7701,7701,8.4
50567,Saussemesnil,912,0,28687,28687,31.5
62785,Savy-Berlette,912,9355,7578,16933,18.6
63275,Perrier,912,0,5928,5928,6.5
74286,Vacheresse,912,22740,47251,69991,76.7
77032,Beton-Bazoches,912,0,3288,3288,3.6
79137,Granzay-Gript,912,6734,12292,19026,20.9
81248,Saint-Gauzens,912,0,50108,50108,54.9
86131,Lhommaizé,912,8115,36886,45001,49.3
17248,Mortagne-sur-Gironde,911,17550,14347,31897,35
54109,Ceintrey,911,0,0,0,0
60703,Aux Marais,911,0,35723,35723,39.2
64108,Bellocq,911,0,24530,24530,26.9
66205,Tautavel,911,0,7588,7588,8.3
87003,Arnac-la-Poste,911,9257,15505,24762,27.2
17057,Bouhet,910,620,37653,38273,42.1
17394,Saint-Saturnin-du-Bois,910,4229,37653,41882,46
29107,Landudal,910,0,29212,29212,32.1
54315,Leyr,910,0,5385,5385,5.9
67259,Langensoultzbach,910,4364,22018,26382,29
71015,Auxy,910,0,20360,20360,22.4
72106,Courtillers,910,0,21164,21164,23.3
73084,Chignin,910,0,16274,16274,17.9
78569,Sainte-Mesme,910,4042,1773,5815,6.4
85104,Grues,910,0,19232,19232,21.1
89478,Vincelles,910,150,17802,17952,19.7
11367,Saissac,909,0,11742,11742,12.9
17151,L'Éguille,909,1395,14316,15711,17.3
21525,La Roche-en-Brenil,909,0,2609,2609,2.9
22302,Saint-Jacut-de-la-Mer,909,0,24216,24216,26.6
42198,Saint-Alban-les-Eaux,909,11261,26824,38085,41.9
58302,Varennes-lès-Narcy,909,0,51302,51302,56.4
60309,Hénonville,909,0,2925,2925,3.2
82008,Auvillar,909,0,97664,97664,107.4
10426,Ville-sous-la-Ferté,908,0,0,0,0
30096,Cornillon,908,0,13250,13250,14.6
41050,Cheverny,908,0,34800,34800,38.3
57745,Wiesviller,908,0,12409,12409,13.7
69242,Taponas,908,0,0,0,0
69263,Villechenève,908,19971,45511,65482,72.1
76397,Longueville-sur-Scie,908,0,7327,7327,8.1
3161,Marcillat-en-Combraille,907,0,21350,21350,23.5
3168,Meaulne-Vitray,907,0,14259,14259,15.7
10353,Saint-Mesmin,907,0,932,932,1
17328,Saint-Fort-sur-Gironde,907,0,10710,10710,11.8
21056,Beire-le-Châtel,907,0,3951,3951,4.4
21319,Izeure,907,0,20,20,0
33542,Vérac,907,0,13652,13652,15.1
50535,Le Parc,907,0,22316,22316,24.6
53150,Ménil,907,0,40719,40719,44.9
62230,Colembert,907,0,2619,2619,2.9
69113,Létra,907,0,8174,8174,9
74237,Saint-Gingolph,907,2500,46992,49492,54.6
74287,Vailly,907,12700,63377,76077,83.9
77089,La Chapelle-Rablais,907,0,11677,11677,12.9
89050,Bonnard,907,1440,31699,33139,36.5
89368,Saint-Sauveur-en-Puisaye,907,23790,40954,64744,71.4
7156,Meyras,906,5350,3723,9073,10
24418,Saint-Germain-du-Salembre,906,4745,4939,9684,10.7
51436,Pogny,906,0,1512,1512,1.7
59254,Fressain,906,0,12624,12624,13.9
59433,Nieurlet,906,19926,17449,37375,41.3
60456,La Neuville-Roy,906,700,5020,5720,6.3
62313,Estrée-Blanche,906,0,14951,14951,16.5
68279,Roderen,906,0,15247,15247,16.8
76628,Saint-Ouen-du-Breuil,906,0,7311,7311,8.1
1156,Faramans,905,0,15445,15445,17.1
1321,Revonnas,905,0,17496,17496,19.3
35200,Moutiers,905,0,13597,13597,15
53276,Voutré,905,0,6474,6474,7.2
69090,Frontenas,905,0,8156,8156,9
72129,Fatines,905,0,18514,18514,20.5
73298,Tours-en-Savoie,905,0,21348,21348,23.6
77462,Thieux,905,0,11223,11223,12.4
79136,Alloinay,905,0,26137,26137,28.9
4188,Saint-Maime,904,2210,2382,4592,5.1
21179,Clénay,904,0,22,22,0
22030,Caouënnec-Lanvézéac,904,0,17959,17959,19.9
26379,Granges-les-Beaumont,904,6067,18325,24392,27
28104,Coltainville,904,0,26341,26341,29.1
41206,Saint-Denis-sur-Loire,904,0,34647,34647,38.3
62141,Blessy,904,0,14918,14918,16.5
69188,Saint-Clément-sur-Valsonne,904,0,10685,10685,11.8
77172,Esmans,904,0,639,639,0.7
80008,Aigneville,904,0,6010,6010,6.6
10151,Fontaine-les-Grès,903,0,928,928,1
16368,Sers,903,0,23476,23476,26
21107,Bretigny,903,0,22,22,0
29159,Peumerit,903,4149,28924,33073,36.6
30170,Molières-Cavaillac,903,0,14565,14565,16.1
36057,Coings,903,0,33468,33468,37.1
47217,Puymirol,903,0,20671,20671,22.9
54260,Hériménil,903,0,3990,3990,4.4
59363,Louvignies-Quesnoy,903,0,2548,2548,2.8
85110,L'Hermenault,903,0,5925,5925,6.6
8037,Auvillers-les-Forges,902,0,23581,23581,26.1
26039,Beauregard-Baret,902,0,18284,18284,20.3
42178,Pradines,902,2915,25571,28486,31.6
59211,Esquerchin,902,0,12568,12568,13.9
59315,Houdain-lez-Bavay,902,0,2546,2546,2.8
59364,Louvil,902,0,15394,15394,17.1
68094,Folgensbourg,902,4830,17532,22362,24.8
80260,Drucat,902,0,2752,2752,3.1
24152,Domme,901,15960,1543,17503,19.4
2B286,Sorbo-Ocagnano,901,0,4172,4172,4.6
48146,Gorges du Tarn Causses,901,34313,22099,56412,62.6
53258,La Selle-Craonnaise,901,0,5965,5965,6.6
57562,Ranguevaux,901,0,18516,18516,20.6
73211,Queige,901,0,21254,21254,23.6
78289,Grosrouvre,901,0,389,389,0.4
79166,Marigny,901,4460,12143,16603,18.4
81031,Le Bez,901,0,8418,8418,9.3
86042,Buxeuil,901,0,20506,20506,22.8
95395,Le Mesnil-Aubry,901,0,11174,11174,12.4
39160,Commenailles,900,13358,23921,37279,41.4
59391,Mastaing,900,0,33859,33859,37.6
60603,Salency,900,1700,0,1700,1.9
67328,Niedermodern,900,0,10943,10943,12.2
68159,Jungholtz,900,0,22210,22210,24.7
12244,Saint-Rome-de-Tarn,899,0,16148,16148,18
18055,Chârost,899,0,21226,21226,23.6
31349,Mondavezan,899,0,31482,31482,35
33316,Pellegrue,899,0,6786,6786,7.5
54027,Atton,899,0,9822,9822,10.9
57419,Loupershouse,899,0,12286,12286,13.7
62354,Frencq,899,0,9564,9564,10.6
72380,Vivoin,899,0,42316,42316,47.1
2167,Chassemy,898,0,1771,1771,2
28034,Berchères-Saint-Germain,898,0,26167,26167,29.1
47173,Monclar,898,0,7247,7247,8.1
56084,Le Hézo,898,0,8308,8308,9.3
71404,Saint-Désert,898,0,24690,24690,27.5
72011,Assé-le-Boisne,898,0,42269,42269,47.1
89142,Dixmont,898,3786,5968,9754,10.9
1046,Biziat,897,0,3633,3633,4.1
33038,Bégadan,897,0,7887,7887,8.8
36220,Thenay,897,0,4931,4931,5.5
48075,Ispagnac,897,26500,22001,48501,54.1
67548,Wiwersheim,897,6807,17066,23873,26.6
70414,Plancher-les-Mines,897,0,1520,1520,1.7
78522,Rochefort-en-Yvelines,897,0,1748,1748,1.9
80096,Béthencourt-sur-Mer,897,0,5964,5964,6.6
5122,La Roche-de-Rame,896,0,61804,61804,69
7310,Savas,896,32848,4616,37464,41.8
16337,Saint-Maurice-des-Lions,896,5792,18434,24226,27
22346,Trédaniel,896,10990,10814,21804,24.3
33006,Anglade,896,0,8352,8352,9.3
60505,Pontarmé,896,0,0,0,0
68179,Lauw,896,0,18800,18800,21
71131,Ciel,896,2220,0,2220,2.5
89073,Champignelles,896,8621,40458,49079,54.8
14672,Val de Drôme,895,0,33188,33188,37.1
24020,La Bachellerie,895,10910,15653,26563,29.7
27534,Saint-Didier-des-Bois,895,0,26542,26542,29.7
28324,Saint-Arnoult-des-Bois,895,0,3311,3311,3.7
31151,Corronsac,895,0,14592,14592,16.3
45063,Cerdon,895,0,5242,5242,5.9
49182,Louresse-Rochemenier,895,32071,8720,40791,45.6
59007,Anhiers,895,0,12470,12470,13.9
64023,Angaïs,895,0,9571,9571,10.7
73224,Saint-Avre,895,0,128225,128225,143.3
77436,Saint-Siméon,895,0,14738,14738,16.5
79345,Verruyes,895,0,7377,7377,8.2
85133,Maillezais,895,0,14026,14026,15.7
89096,Chemilly-sur-Yonne,895,9850,5783,15633,17.5
89125,Courson-les-Carrières,895,35913,40413,76326,85.3
97130,Terre-de-Bas,895,0,4036,4036,4.5
17314,Saint-Césaire,894,0,28334,28334,31.7
27542,Saint-Georges-du-Vièvre,894,0,13767,13767,15.4
56113,Locmalo,894,0,28576,28576,32
63146,Égliseneuve-près-Billom,894,1600,8575,10175,11.4
67183,Harskirchen,894,5919,11208,17127,19.2
67330,Niederrœdern,894,1100,102517,103617,115.9
83003,Ampus,894,0,11136,11136,12.5
83076,Mazaugues,894,0,33495,33495,37.5
24412,Saint-Geniès,893,13100,3417,16517,18.5
24419,Saint-Germain-et-Mons,893,2680,19880,22560,25.3
24586,Villetoureix,893,4300,6781,11081,12.4
39579,Viry,893,8950,3288,12238,13.7
76313,Gouy,893,0,25507,25507,28.6
78398,Les Mesnuls,893,0,385,385,0.4
2195,Ciry-Salsogne,892,0,1759,1759,2
8341,Poix-Terron,892,0,19564,19564,21.9
8435,Tagnon,892,0,17059,17059,19.1
43003,Allègre,892,142492,37115,179607,201.4
49058,Les Cerqueux,892,37268,37065,74333,83.3
60470,Noyers-Saint-Martin,892,0,20116,20116,22.6
60523,Rainvillers,892,0,34978,34978,39.2
61081,Chailloué,892,15826,5596,21422,24
64273,Irissarry,892,0,23179,23179,26
79135,Gourgé,892,0,23386,23386,26.2
1216,Lhuis,891,0,15206,15206,17.1
14357,Terres de Druance,891,0,407,407,0.5
15152,Pierrefort,891,22840,19708,42548,47.8
25020,Arbouans,891,0,56404,56404,63.3
27473,Port-Mort,891,0,4682,4682,5.3
39327,Messia-sur-Sorne,891,4562,28079,32641,36.6
49326,Sarrigné,891,2548,14424,16972,19
56106,Larmor-Baden,891,0,8243,8243,9.3
67379,Preuschdorf,891,2500,21558,24058,27
71222,Gourdon,891,0,14317,14317,16.1
83045,Correns,891,0,33382,33382,37.5
27537,Saint-Étienne-du-Vauvray,890,0,26394,26394,29.7
2A349,Viggianello,890,0,0,0,0
37138,Lussault-sur-Loire,890,0,24157,24157,27.1
37169,Neuville-sur-Brenne,890,2450,3906,6356,7.1
46138,Cœur de Causse,890,0,5149,5149,5.8
63250,Neschers,890,0,5785,5785,6.5
64536,Thèze,890,0,13935,13935,15.7
71236,Igé,890,9290,22733,32023,36
84124,Saumane-de-Vaucluse,890,0,7421,7421,8.3
95529,Ronquerolles,890,0,3171,3171,3.6
3292,Tronget,889,0,13656,13656,15.4
16245,Nieuil,889,5450,18290,23740,26.7
17174,Genouillé,889,3840,36784,40624,45.7
25524,Saint-Maurice-Colombier,889,0,56277,56277,63.3
28188,Le Gué-de-Longroi,889,0,5159,5159,5.8
54281,Jolivet,889,0,3928,3928,4.4
63269,Parent,889,0,5779,5779,6.5
65108,Bours,889,0,8493,8493,9.6
72141,Gesnes-le-Gandelin,889,0,41846,41846,47.1
74144,Jonzier-Épagny,889,14205,3484,17689,19.9
77025,Bazoches-lès-Bray,889,10198,12590,22788,25.6
80464,Lanchères,889,0,2712,2712,3.1
89407,Tanlay,889,12080,2065,14145,15.9
21277,Fontaine-Française,888,0,3868,3868,4.4
51018,Athis,888,0,17647,17647,19.9
62851,Vieille-Chapelle,888,7688,14654,22342,25.2
64367,Maslacq,888,0,23910,23910,26.9
68356,Walheim,888,0,23821,23821,26.8
79280,Saint Maurice Étusson,888,0,25261,25261,28.4
1209,Léaz,887,0,11418,11418,12.9
28156,Fontaine-Simon,887,0,632,632,0.7
31512,Saint-Pierre-de-Lages,887,7250,4326,11576,13.1
36003,Ambrault,887,12900,18017,30917,34.9
40308,Sort-en-Chalosse,887,0,13891,13891,15.7
53011,Astillé,887,0,5872,5872,6.6
61203,Héloup,887,4570,26214,30784,34.7
64252,Gurmençon,887,0,19102,19102,21.5
79020,Augé,887,0,4930,4930,5.6
95452,Nointel,887,0,3160,3160,3.6
11136,Fanjeaux,886,22570,2623,25193,28.4
13099,Saint-Paul-lès-Durance,886,0,24902,24902,28.1
30080,Chamborigaud,886,0,27694,27694,31.3
35218,Le Petit-Fougeray,886,3820,12894,16714,18.9
51413,Oiry,886,0,17607,17607,19.9
59144,Château-l'Abbaye,886,0,33332,33332,37.6
72093,Cormes,886,0,5405,5405,6.1
78068,Blaru,886,0,4530,4530,5.1
81307,Valdurenque,886,0,9319,9319,10.5
5139,Dévoluy,885,0,33119,33119,37.4
12194,Quins,885,0,27087,27087,30.6
16056,Bourg-Charente,885,5250,33113,38363,43.3
16269,Pranzac,885,9800,15782,25582,28.9
24366,Saint-André-d'Allas,885,7943,5576,13519,15.3
26162,Lens-Lestang,885,3822,14569,18391,20.8
42102,Grammond,885,4193,44358,48551,54.9
54353,Mars-la-Tour,885,0,5284,5284,6
56205,Saint-Armel,885,0,8187,8187,9.3
90049,Foussemagne,885,1500,30876,32376,36.6
14761,Vimont,884,0,7115,7115,8
49178,Loiré,884,0,882,882,1
62232,La Comté,884,0,14588,14588,16.5
62825,Tortequesne,884,0,1100,1100,1.2
76634,Saint-Pierre-de-Manneville,884,0,25250,25250,28.6
77283,May-en-Multien,884,0,12980,12980,14.7
80700,Saint-Blimont,884,0,2697,2697,3.1
21591,Savigny-le-Sec,883,0,0,0,0
22311,Saint-Lormel,883,0,23523,23523,26.6
25361,Malbuisson,883,0,52587,52587,59.6
26234,Piégros-la-Clastre,883,45990,24001,69991,79.3
27447,Le Val-Doré,883,0,7856,7856,8.9
53154,Montaudin,883,0,11642,11642,13.2
62340,Floringhem,883,0,19076,19076,21.6
68171,Kruth,883,0,9175,9175,10.4
69103,Juliénas,883,11641,0,11641,13.2
71178,Dompierre-les-Ormes,883,9270,11999,21269,24.1
74308,Vinzier,883,6972,45749,52721,59.7
76443,Mont-Cauvaire,883,0,603,603,0.7
77477,Ury,883,0,7352,7352,8.3
81142,Lempaut,883,0,17952,17952,20.3
86223,Saint-Germain,883,17450,35713,53163,60.2
95074,Boisemont,883,0,26327,26327,29.8
95554,Saint-Gervais,883,2300,5582,7882,8.9
27014,Amfreville-sur-Iton,882,0,26156,26156,29.7
31459,Roquesérière,882,0,9893,9893,11.2
33530,Teuillac,882,0,4981,4981,5.6
39331,Mignovillard,882,44446,8930,53376,60.5
43127,Malvalette,882,1000,79649,80649,91.4
74194,Mûres,882,0,6813,6813,7.7
74234,Saint-Ferréol,882,0,7273,7273,8.2
78209,Émancé,882,0,1718,1718,1.9
28382,Terminiers,881,0,4627,4627,5.3
33070,Brach,881,0,552,552,0.6
37188,Pouzay,881,0,23905,23905,27.1
43061,Chaspinhac,881,4000,36658,40658,46.1
56050,La Croix-Helléan,881,0,13267,13267,15.1
63261,Orbeil,881,0,5727,5727,6.5
67299,Mollkirch,881,0,32001,32001,36.3
72271,Saint-Célerin,881,0,16469,16469,18.7
77486,Vaudoy-en-Brie,881,0,4477,4477,5.1
84093,Puget,881,0,8587,8587,9.7
89276,Neuvy-Sautour,881,9773,5693,15466,17.6
11215,Malves-en-Minervois,880,0,5708,5708,6.5
12068,Colombiès,880,0,26933,26933,30.6
25082,Bourguignon,880,0,55707,55707,63.3
27543,Saint-Georges-Motel,880,0,1177,1177,1.3
33237,Léogeats,880,0,8999,8999,10.2
36244,Villentrois-Faverolles-en-Berry,880,0,11048,11048,12.6
55543,Velaines,880,0,10610,10610,12.1
80101,Beuvraignes,880,0,1062,1062,1.2
11086,Caves,879,0,13593,13593,15.5
29180,Ploudiry,879,4165,6813,10978,12.5
29271,Saint-Vougay,879,26704,6492,33196,37.8
31579,Villariès,879,0,9859,9859,11.2
33452,Saint-Michel-de-Rieufret,879,0,26953,26953,30.7
37113,Le Grand-Pressigny,879,25192,15258,40450,46
38147,Doissin,879,0,7708,7708,8.8
38476,Savas-Mépin,879,0,9590,9590,10.9
40234,Pouydesseaux,879,0,10879,10879,12.4
57422,Louvigny,879,0,33661,33661,38.3
59310,Hon-Hergies,879,0,2481,2481,2.8
69126,Marcy,879,0,7922,7922,9
72186,Maresché,879,0,41375,41375,47.1
78470,Orphin,879,0,1713,1713,1.9
87190,Sauviat-sur-Vige,879,0,3618,3618,4.1
25256,Frambouhans,878,0,6116,6116,7
29089,Kergloff,878,0,29692,29692,33.8
38284,Ornacieux-Balbins,878,0,9579,9579,10.9
43096,Fontannes,878,10740,43029,53769,61.2
64484,Saint-Jean-le-Vieux,878,0,22816,22816,26
82150,Reyniès,878,0,7645,7645,8.7
87166,Saint-Martin-le-Vieux,878,4120,409,4529,5.2
16076,Champagne-Mouton,877,14006,18044,32050,36.5
17018,Ardillières,877,0,36288,36288,41.4
27077,Boissey-le-Châtel,877,0,3593,3593,4.1
2B205,Patrimonio,877,0,5302,5302,6
38282,Optevoz,877,0,4528,4528,5.2
51196,Cramant,877,0,17428,17428,19.9
7228,Saint-Désirat,876,0,4513,4513,5.2
17192,Jarnac-Champagne,876,0,10344,10344,11.8
24260,Mauzac-et-Grand-Castang,876,7380,3183,10563,12.1
33332,Porchères,876,0,17087,17087,19.5
57217,Flétrange,876,0,40650,40650,46.4
60321,Ivry-le-Temple,876,0,2818,2818,3.2
64436,Ossès,876,0,22764,22764,26
72220,Nogent-le-Bernard,876,0,16244,16244,18.5
76272,Fontaine-le-Dun,876,0,5673,5673,6.5
80205,Condé-Folie,876,0,2672,2672,3.1
91293,Guigneville-sur-Essonne,876,0,1287,1287,1.5
11437,Villesèquelande,875,0,5675,5675,6.5
16003,Agris,875,2465,15604,18069,20.7
31565,Valentine,875,0,18124,18124,20.7
49336,Somloire,875,13377,36359,49736,56.8
67443,Scheibenhard,875,6000,100338,106338,121.5
70478,Saulx,875,0,3237,3237,3.7
74106,Draillant,875,0,38095,38095,43.5
76670,Senneville-sur-Fécamp,875,0,5678,5678,6.5
89029,Bassou,875,6520,30581,37101,42.4
7254,Saint-Julien-du-Serre,874,3540,14918,18458,21.1
39030,Authume,874,7290,17739,25029,28.6
43016,Auzon,874,29700,9788,39488,45.2
47156,Marcellus,874,0,9043,9043,10.3
60259,Fresnoy-en-Thelle,874,4250,3630,7880,9
61194,Monts-sur-Orne,874,12510,1846,14356,16.4
62662,Polincove,874,0,6633,6633,7.6
87105,Neuvic-Entier,874,0,406,406,0.5
1180,Grilly,873,0,11238,11238,12.9
12137,Manhac,873,0,26719,26719,30.6
24243,Lisle,873,7850,6629,14479,16.6
30282,Saint-Marcel-de-Careiret,873,0,12739,12739,14.6
37224,Saint-Laurent-en-Gâtines,873,2578,3831,6409,7.3
50143,Coudeville-sur-Mer,873,0,21128,21128,24.2
59570,Socx,873,0,16814,16814,19.3
63048,Bourg-Lastic,873,0,29521,29521,33.8
74058,La Chapelle-d'Abondance,873,96059,45231,141290,161.8
83080,Mons,873,0,16843,16843,19.3
87024,Bujaleuf,873,0,12434,12434,14.2
88201,Girancourt,873,0,21954,21954,25.1
21370,Magny-sur-Tille,872,0,25305,25305,29
31246,Labarthe-Inard,872,0,18062,18062,20.7
41233,Sambin,872,0,33420,33420,38.3
42265,Saint-Michel-sur-Rhône,872,0,26759,26759,30.7
62177,Brimeux,872,0,13806,13806,15.8
78444,Neauphlette,872,0,4458,4458,5.1
78681,Villiers-le-Mahieu,872,0,376,376,0.4
89235,Magny,872,4850,1891,6741,7.7
17242,Montils,871,0,27605,27605,31.7
47269,Saint-Pierre-de-Clairac,871,0,19939,19939,22.9
61414,Saint-Langis-lès-Mortagne,871,4115,3058,7173,8.2
63471,Youx,871,0,1352,1352,1.6
64350,Louhossoa,871,18010,22634,40644,46.7
88157,Dounoux,871,0,21903,21903,25.1
15056,Crandelles,870,16280,29477,45757,52.6
22255,La Prénessaye,870,26613,0,26613,30.6
24581,Villamblard,870,5850,41659,47509,54.6
29248,Saint-Frégant,870,0,21922,21922,25.2
42260,Saint-Martin-la-Sauveté,870,9039,7182,16221,18.6
57274,Guerting,870,0,5396,5396,6.2
57533,Pange,870,0,2118,2118,2.4
73159,Les Mollettes,870,0,15558,15558,17.9
88310,Monthureux-sur-Saône,870,0,6763,6763,7.8
95008,Aincourt,870,4600,5500,10100,11.6
40063,Candresse,869,0,7439,7439,8.6
43111,Landos,869,21505,4212,25717,29.6
63387,Saint-Priest-Bramefant,869,3880,3552,7432,8.6
71033,Bey,869,9236,10028,19264,22.2
71495,Salornay-sur-Guye,869,3764,6040,9804,11.3
76719,Valmont,869,0,5639,5639,6.5
7247,Saint-Jean-le-Centenier,868,8956,26925,35881,41.3
22283,Saint-Clet,868,0,15543,15543,17.9
27044,Les Baux-Sainte-Croix,868,0,10208,10208,11.8
32301,Ordan-Larroque,868,0,30584,30584,35.2
35359,Visseiche,868,0,13041,13041,15
40025,Bascons,868,0,4056,4056,4.7
43074,Cohade,868,3650,42538,46188,53.2
62328,Ferfay,868,0,14324,14324,16.5
64467,Rontignon,868,9874,25628,35502,40.9
76147,Bully,868,0,20277,20277,23.4
17247,Mornac-sur-Seudre,867,6107,13654,19761,22.8
19252,Sarroux - Saint Julien,867,0,11886,11886,13.7
26173,Marches,867,600,17575,18175,21
29017,Brélès,867,0,1562,1562,1.8
37117,Hommes,867,0,8043,8043,9.3
53078,Coudray,867,0,38923,38923,44.9
64087,Baigts-de-Béarn,867,0,23345,23345,26.9
65252,Lamarque-Pontacq,867,0,8283,8283,9.6
68219,Le Haut Soultzbach,867,0,18191,18191,21
70575,Voray-sur-l'Ognon,867,0,7262,7262,8.4
95651,Vétheuil,867,33000,5481,38481,44.4
2321,Fontaine-lès-Vervins,866,0,15443,15443,17.8
22114,Lanrelas,866,3547,10452,13999,16.2
38271,Murianette,866,0,33454,33454,38.6
47315,Trentels,866,0,4989,4989,5.8
60033,Avilly-Saint-Léonard,866,0,17356,17356,20
76551,Sainneville,866,0,7811,7811,9
95040,Avernes,866,6800,39789,46589,53.8
21076,Binges,865,0,0,0,0
24130,Condat-sur-Vézère,865,12169,15128,27297,31.6
43024,Beaux,865,0,20276,20276,23.4
63248,Nébouzat,865,0,2708,2708,3.1
68099,Frœningen,865,3260,23204,26464,30.6
27422,Muids,864,0,4540,4540,5.3
31128,Caujac,864,0,4545,4545,5.3
34109,Gabian,864,0,1690,1690,2
38290,Pact,864,0,22087,22087,25.6
38523,Varacieux,864,0,13963,13963,16.2
62044,Attin,864,0,9192,9192,10.6
63016,Augerolles,864,0,20032,20032,23.2
68117,Gunsbach,864,0,34682,34682,40.1
71305,Montbellet,864,0,20107,20107,23.3
88135,Docelles,864,0,1133,1133,1.3
32412,Saramon,863,0,10962,10962,12.7
45036,Boismorand,863,0,11169,11169,12.9
59480,Quérénaing,863,0,16625,16625,19.3
80627,Plachy-Buyon,863,0,1192,1192,1.4
86273,La Trimouille,863,10512,34904,45416,52.6
88498,Vecoux,863,0,2203,2203,2.6
89136,Cuy,863,200,159,359,0.4
9238,Les Pujols,862,0,3881,3881,4.5
24134,Corgnac-sur-l'Isle,862,6130,2844,8974,10.4
41105,Josnes,862,0,2595,2595,3
47239,Saint-Étienne-de-Fougères,862,0,6606,6606,7.7
56020,Bohal,862,0,10487,10487,12.2
63257,Olby,862,0,2698,2698,3.1
67540,Wintershouse,862,0,10481,10481,12.2
77347,Les Ormes-sur-Voulzie,862,30350,12207,42557,49.4
80791,Vers-sur-Selle,862,0,55264,55264,64.1
81239,Saint-Amans-Valtoret,862,0,7442,7442,8.6
88068,La Bourgonce,862,0,8381,8381,9.7
1291,Perrex,861,0,3487,3487,4
42085,Doizieux,861,0,20173,20173,23.4
60002,Abbecourt,861,0,3576,3576,4.2
62691,Saint-Augustin,861,3250,76629,79879,92.8
73301,Trévignin,861,0,4763,4763,5.5
76249,Étaimpuis,861,0,6948,6948,8.1
79337,Le Vanneau-Irleau,861,0,11604,11604,13.5
85187,Réaumur,861,0,23400,23400,27.2
14326,Hermival-les-Vaux,860,0,9573,9573,11.1
19013,Aubazines,860,0,4336,4336,5
28137,Écrosnes,860,3256,4990,8246,9.6
29145,Confort-Meilars,860,0,61552,61552,71.6
48156,Saint-Germain-du-Teil,860,0,30538,30538,35.5
57073,Betting,860,0,27418,27418,31.9
59325,Jolimetz,860,0,2427,2427,2.8
60559,La Rue-Saint-Pierre,860,0,33723,33723,39.2
84116,Saint-Romain-en-Viennois,860,0,1006,1006,1.2
1001,L'Abergement-Clémenciat,859,0,179,179,0.2
7217,Saint-Barthélemy-le-Plain,859,2770,37797,40567,47.2
8040,Les Ayvelles,859,0,19732,19732,23
17133,Cravans,859,3820,14310,18130,21.1
27696,Villiers-en-Désœuvre,859,0,4514,4514,5.3
28062,Broué,859,0,1149,1149,1.3
60432,Mortefontaine,859,0,17215,17215,20
60517,Puiseux-le-Hauberger,859,0,3568,3568,4.2
65138,Cauterets,859,0,35175,35175,40.9
68009,Artzenheim,859,4280,14909,19189,22.3
68123,Hattstatt,859,0,84341,84341,98.2
77418,Saint-Loup-de-Naud,859,0,3097,3097,3.6
9235,Prat-Bonrepaux,858,0,103972,103972,121.2
27547,Saint-Germain-la-Campagne,858,0,13213,13213,15.4
45016,Autry-le-Châtel,858,0,9988,9988,11.6
60324,Jaulzy,858,0,5812,5812,6.8
67005,Alteckendorf,858,3900,28834,32734,38.2
74170,Massingy,858,542,11619,12161,14.2
79319,Souvigné,858,0,4769,4769,5.6
87025,Burgnac,858,0,399,399,0.5
88206,Gironcourt-sur-Vraine,858,0,9585,9585,11.2
89245,Marsangy,858,3088,5702,8790,10.2
2549,Neuville-Saint-Amand,857,0,122484,122484,142.9
17350,Saint-Julien-de-l'Escap,857,0,23871,23871,27.9
24587,Vitrac,857,0,5399,5399,6.3
27349,Illeville-sur-Montfort,857,0,19359,19359,22.6
2B152,Luri,857,13000,31429,44429,51.8
32117,Duran,857,0,30196,30196,35.2
35335,Thourie,857,0,16683,16683,19.5
45204,Mézières-lez-Cléry,857,0,3531,3531,4.1
47095,Fauillet,857,0,8867,8867,10.3
60164,Le Coudray-Saint-Germer,857,20310,7025,27335,31.9
64142,Bougarber,857,10478,25303,35781,41.8
64472,Saint-Castin,857,2500,8946,11446,13.4
77293,Misy-sur-Yonne,857,0,606,606,0.7
85260,Saint-Paul-Mont-Penit,857,0,7318,7318,8.5
8284,Les Mazures,856,0,13326,13326,15.6
27563,Saint-Mards-de-Blacarville,856,7690,19336,27026,31.6
30266,Saint-Jean-de-Maruéjols-et-Avéjan,856,0,34743,34743,40.6
35045,Bruc-sur-Aff,856,0,12212,12212,14.3
57760,Zetting,856,0,11699,11699,13.7
64520,Serres-Morlaàs,856,3200,8935,12135,14.2
79176,Ménigoute,856,0,22443,22443,26.2
7298,Saint-Symphorien-sous-Chomérac,855,0,18306,18306,21.4
14304,Gonneville-sur-Honfleur,855,0,6388,6388,7.5
24499,Saint-Sauveur,855,30769,19034,49803,58.2
28036,Berchères-sur-Vesgre,855,0,1144,1144,1.3
34174,Moulès-et-Baucels,855,0,18314,18314,21.4
40182,Mézos,855,0,4678,4678,5.5
43148,Paulhaguet,855,19085,7786,26871,31.4
47285,Samazan,855,0,8846,8846,10.3
56110,Lignol,855,0,27329,27329,32
59307,Holque,855,0,16467,16467,19.3
59547,Saint-Vaast-en-Cambrésis,855,0,5875,5875,6.9
69132,Meys,855,0,42854,42854,50.1
71574,Verzé,855,0,21839,21839,25.5
27524,Sainte-Colombe-la-Commanderie,854,0,3673,3673,4.3
27624,Surville,854,0,25326,25326,29.7
29155,Ouessant,854,42200,0,42200,49.4
45336,Viglain,854,0,5002,5002,5.9
88037,Basse-sur-le-Rupt,854,0,6670,6670,7.8
91195,Dannemois,854,0,29754,29754,34.8
1368,Saint-Julien-sur-Veyle,853,0,3455,3455,4.1
19125,Marcillac-la-Croisille,853,0,10944,10944,12.8
53088,Cuillé,853,0,5647,5647,6.6
57109,Breistroff-la-Grande,853,0,20767,20767,24.3
61077,Cerisé,853,12244,25209,37453,43.9
77272,Maison-Rouge,853,0,3076,3076,3.6
86153,Mazerolles,853,16181,34500,50681,59.4
89154,Escamps,853,0,16687,16687,19.6
2174,Chavignon,852,0,1680,1680,2
7011,Vallées-d'Antraigues-Asperjoc,852,22600,14542,37142,43.6
13009,La Barben,852,0,23947,23947,28.1
21582,Santenay,852,0,3705,3705,4.3
70435,Raddon-et-Chapendu,852,0,819,819,1
78647,Vert,852,2700,7929,10629,12.5
86236,Saint-Pierre-de-Maillé,852,0,34460,34460,40.4
14246,Escoville,851,0,10810,10810,12.7
18158,Moulins-sur-Yèvre,851,0,6449,6449,7.6
27287,Glisolles,851,0,7571,7571,8.9
40089,Doazit,851,0,13327,13327,15.7
42179,Pralong,851,0,7625,7625,9
51647,Vitry-en-Perthois,851,0,4993,4993,5.9
60115,Bulles,851,0,4715,4715,5.5
60492,Pimprez,851,0,4324,4324,5.1
62168,Bourthes,851,0,50359,50359,59.2
64550,Uzos,851,0,25126,25126,29.5
69109,Lantignié,851,0,0,0,0
71350,Pierreclos,851,0,11564,11564,13.6
78164,Clairefontaine-en-Yvelines,851,0,1658,1658,1.9
79112,Épannes,851,15133,11469,26602,31.3
80379,Glisy,851,0,54559,54559,64.1
81192,Murat-sur-Vèbre,851,0,15055,15055,17.7
1362,Saint-Jean-de-Thurigneux,850,0,13462,13462,15.8
3158,Haut-Bocage,850,0,1188,1188,1.4
8314,Neuflize,850,0,16256,16256,19.1
25468,Pouligney-Lusans,850,0,42369,42369,49.8
42257,Saint-Martin-d'Estréaux,850,7879,25083,32962,38.8
47077,Cuzorn,850,0,4897,4897,5.8
54472,Saint-Clément,850,0,3755,3755,4.4
64148,Bruges-Capbis-Mifaget,850,0,9090,9090,10.7
68323,Steinbrunn-le-Bas,850,0,59213,59213,69.7
77049,Boutigny,850,0,11592,11592,13.6
2215,Corbeny,849,0,6103,6103,7.2
2286,Esquéhéries,849,0,15140,15140,17.8
14520,Le Pré-d'Auge,849,0,9451,9451,11.1
27214,Écouis,849,0,4461,4461,5.3
38494,Soleymieu,849,0,4383,4383,5.2
40135,Labrit,849,14600,6680,21280,25.1
42104,La Gresle,849,0,22027,22027,25.9
43062,Chaspuzac,849,1000,35326,36326,42.8
57576,Rettel,849,0,12221,12221,14.4
62334,Fiennes,849,0,5196,5196,6.1
64377,Mendionde,849,18052,22062,40114,47.2
68209,Mittelwihr,849,0,2030,2030,2.4
73021,Arvillard,849,0,15183,15183,17.9
7291,Saint-Remèze,848,5700,51782,57482,67.8
27254,Fontaine-sous-Jouy,848,0,9973,9973,11.8
37210,Saint-Benoît-la-Forêt,848,0,46546,46546,54.9
62627,Noyelles-sous-Bellonne,848,0,1055,1055,1.2
68090,Ferrette,848,0,22748,22748,26.8
71267,Lugny,848,0,19735,19735,23.3
95678,Villiers-Adam,848,0,5514,5514,6.5
17111,Clion,847,0,10001,10001,11.8
17460,Varzay,847,2700,26844,29544,34.9
25301,Guyans-Vennes,847,0,10005,10005,11.8
30076,Cavillargues,847,0,12360,12360,14.6
31227,Goyrans,847,0,13810,13810,16.3
40051,Bougue,847,0,10483,10483,12.4
50281,La Lucerne-d'Outremer,847,0,20499,20499,24.2
62292,Elnes,847,0,1832,1832,2.2
62899,Wissant,847,0,3370,3370,4
74257,Sallenôves,847,0,3597,3597,4.2
81069,Cordes-sur-Ciel,847,0,21552,21552,25.4
85066,Chavagnes-les-Redoux,847,0,23020,23020,27.2
14701,Tourgéville,846,0,66963,66963,79.2
19243,Saint-Sornin-Lavolps,846,0,8136,8136,9.6
24157,Douzillac,846,5000,4611,9611,11.4
25357,Maisons-du-Bois-Lièvremont,846,0,9265,9265,11
29244,Saint-Derrien,846,77761,6248,84009,99.3
41135,Mennetou-sur-Cher,846,0,17827,17827,21.1
49188,Marcé,846,0,6473,6473,7.7
63305,Rochefort-Montagne,846,0,2648,2648,3.1
64041,Aressy,846,0,24979,24979,29.5
81249,Sainte-Gemme,846,0,19355,19355,22.9
89436,Venizy,846,17536,5467,23003,27.2
1346,Saint-Didier-d'Aussiat,845,0,16336,16336,19.3
2295,Étréaupont,845,0,15068,15068,17.8
5052,Eygliers,845,0,27472,27472,32.5
14720,Ussy,845,0,13237,13237,15.7
16055,Bouëx,845,0,21969,21969,26
22012,La Bouillie,845,5490,10199,15689,18.6
33445,Saint-Martin-du-Bois,845,0,16483,16483,19.5
46273,Saint-Laurent-les-Tours,845,0,27569,27569,32.6
59056,Beaucamps-Ligny,845,0,13993,13993,16.6
61070,Caligny,845,3527,22632,26159,31
62889,Wierre-Effroy,845,0,3362,3362,4
79150,Limalonges,845,0,24404,24404,28.9
81079,Dénat,845,3000,8203,11203,13.3
14177,Coquainvilliers,844,0,9395,9395,11.1
25347,La Longeville,844,0,0,0,0
42240,Saint-Jean-Soleymieux,844,0,7562,7562,9
50369,Négreville,844,0,26548,26548,31.5
60005,Acy-en-Multien,844,0,3305,3305,3.9
77357,Pécy,844,0,4289,4289,5.1
77456,Soisy-Bouy,844,0,3043,3043,3.6
1171,Géovreisset,843,0,31889,31889,37.8
1307,Port,843,0,31889,31889,37.8
16086,Chassenon,843,6640,17344,23984,28.5
33201,Haux,843,0,83232,83232,98.7
33374,Saint-Aubin-de-Blaye,843,0,7858,7858,9.3
38267,Mottier,843,0,9197,9197,10.9
44104,Montrelais,843,0,10299,10299,12.2
59402,Millam,843,0,16236,16236,19.3
79090,Chizé,843,0,24346,24346,28.9
21391,Marsannay-le-Bois,842,0,11985,11985,14.2
2B319,Talasani,842,0,6042,6042,7.2
38365,Saint-Baudille-de-la-Tour,842,0,4347,4347,5.2
45292,Saint-Maurice-sur-Aveyron,842,0,8633,8633,10.3
46173,Limogne-en-Quercy,842,0,4734,4734,5.6
50420,Quibou,842,0,12453,12453,14.8
56092,Kerfourn,842,7639,5862,13501,16
59046,Bambecque,842,0,16217,16217,19.3
62445,Hesdigneul-lès-Béthune,842,0,13895,13895,16.5
67392,Reipertswiller,842,0,22690,22690,26.9
69078,Duerne,842,72596,42203,114799,136.3
82051,Durfort-Lacapelette,842,0,10814,10814,12.8
84095,Puyvert,842,0,8207,8207,9.7
87096,La Meyze,842,2900,25786,28686,34.1
87157,Saint-Laurent-les-Églises,842,0,1364,1364,1.6
89063,La Celle-Saint-Cyr,842,50,6600,6650,7.9
8402,Saulces-Monclin,841,0,18446,18446,21.9
11034,Belvèze-du-Razès,841,0,11070,11070,13.2
18020,Bannay,841,0,15151,15151,18
27691,Villers-sur-le-Roule,841,0,24940,24940,29.7
33392,Sainte-Croix-du-Mont,841,0,25788,25788,30.7
40316,Tilh,841,0,6259,6259,7.4
42137,Margerie-Chantagret,841,0,7535,7535,9
53174,Parigné-sur-Braye,841,0,31252,31252,37.2
67438,Schaeffersheim,841,8100,15549,23649,28.1
2564,Bernoy-le-Château,840,0,7027,7027,8.4
17312,Saint-Bonnet-sur-Gironde,840,0,9918,9918,11.8
27684,Le Vieil-Évreux,840,0,9879,9879,11.8
30216,Robiac-Rochessadoule,840,0,34094,34094,40.6
50575,Sideville,840,0,26422,26422,31.5
51609,Verneuil,840,0,1216,1216,1.4
53074,Contest,840,0,31215,31215,37.2
57325,Hilsprich,840,0,11480,11480,13.7
62461,Huby-Saint-Leu,840,0,0,0,0
64525,Siros,840,17446,24801,42247,50.3
73255,Sainte-Marie-de-Cuines,840,0,120346,120346,143.3
76324,Grèges,840,0,10209,10209,12.2
5100,Pelleautier,839,0,1189,1189,1.4
24252,Marcillac-Saint-Quentin,839,5620,5286,10906,13
29110,Langolen,839,88814,26933,115747,138
33266,Marcenais,839,0,4696,4696,5.6
34260,Saint-Gervais-sur-Mare,839,0,7812,7812,9.3
34265,Saint-Jean-de-Cornies,839,5860,15633,21493,25.6
59437,Noyelles-lès-Seclin,839,0,13894,13894,16.6
59472,Preux-au-Bois,839,0,2368,2368,2.8
60225,Étouy,839,0,4450,4450,5.3
71148,Coublanc,839,0,16284,16284,19.4
76486,Orival,839,0,23965,23965,28.6
76702,Touffreville-la-Corbeline,839,0,1552,1552,1.8
79127,La Foye-Monjault,839,0,11308,11308,13.5
88500,Ventron,839,0,6553,6553,7.8
27485,Quillebeuf-sur-Seine,838,0,18929,18929,22.6
33303,Nérigean,838,0,16346,16346,19.5
53101,Fromentières,838,0,37621,37621,44.9
62763,Saint-Michel-sur-Ternoise,838,0,18103,18103,21.6
88266,Lépanges-sur-Vologne,838,0,1099,1099,1.3
4068,Dauphin,837,0,2206,2206,2.6
47070,Condezaygues,837,0,4822,4822,5.8
54352,Maron,837,17100,8524,25624,30.6
59177,Dompierre-sur-Helpe,837,0,6630,6630,7.9
65388,Saint-Lary-Soulan,837,0,40239,40239,48.1
71468,Saint-Pierre-de-Varennes,837,0,13449,13449,16.1
73245,Saint-Jean-de-Chevelu,837,0,5310,5310,6.3
76253,Étoutteville,837,0,1845,1845,2.2
89005,Ancy-le-Franc,837,10390,1945,12335,14.7
7177,Plats,836,0,36785,36785,44
17097,Le Chay,836,0,13166,13166,15.7
29125,Leuhan,836,0,6852,6852,8.2
33534,Le Tourne,836,0,6154,6154,7.4
38376,Saint-Christophe-sur-Guiers,836,0,57242,57242,68.5
38533,Venon,836,0,32295,32295,38.6
74244,Saint-Laurent,836,0,6093,6093,7.3
26119,Érôme,835,0,36741,36741,44
31426,Pointis-de-Rivière,835,0,7993,7993,9.6
36010,Azay-le-Ferron,835,0,4140,4140,5
45313,Sougy,835,0,1177,1177,1.4
58065,Châtillon-en-Bazois,835,0,43071,43071,51.6
59536,Sainte-Marie-Cappel,835,0,5101,5101,6.1
62446,Hesdigneul-lès-Boulogne,835,0,28227,28227,33.8
67164,Goxwiller,835,30,25823,25853,31
73240,Sainte-Hélène-du-Lac,835,0,14932,14932,17.9
80815,Vron,835,0,20677,20677,24.8
81132,Guitalens-L'Albarède,835,0,12489,12489,15
81196,Noailhac,835,16848,8783,25631,30.7
6153,Valdeblore,834,0,16420,16420,19.7
10280,Pars-lès-Romilly,834,0,8523,8523,10.2
14758,Villons-les-Buissons,834,0,18558,18558,22.3
26258,Puy-Saint-Martin,834,0,8036,8036,9.6
33245,Lignan-de-Bordeaux,834,0,6140,6140,7.4
40186,Misson,834,0,6207,6207,7.4
46088,Douelle,834,0,7042,7042,8.4
65002,Adé,834,0,7968,7968,9.6
71135,Clessé,834,0,19409,19409,23.3
22323,Saint-Pôtan,833,0,22191,22191,26.6
25243,Flangebouche,833,0,9840,9840,11.8
28335,Saint-Éliph,833,0,593,593,0.7
32464,Villecomtal-sur-Arros,833,0,1843,1843,2.2
51079,Bouzy,833,0,2059,2059,2.5
53042,Brecé,833,0,10983,10983,13.2
61029,Bazoches-sur-Hoëne,833,7790,2925,10715,12.9
62148,Bois-Bernard,833,0,13209,13209,15.9
64080,Aussevielle,833,10494,24595,35089,42.1
76637,Saint-Pierre-en-Port,833,0,5405,5405,6.5
77383,Rampillon,833,0,10724,10724,12.9
77428,Saint-Ouen-en-Brie,833,0,10724,10724,12.9
2374,Lehaucourt,832,0,7538,7538,9.1
2503,Mont-d'Origny,832,0,0,0,0
11361,Saint-Papoul,832,0,7311,7311,8.8
15134,Montsalvy,832,18667,7295,25962,31.2
16168,Jauldes,832,0,21631,21631,26
16330,Saint-Laurent-de-Cognac,832,2005,31130,33135,39.8
16353,Saint-Sornin,832,0,14837,14837,17.8
22028,Camlez,832,0,16528,16528,19.9
29139,Lopérec,832,0,43254,43254,52
30308,Sanilhac-Sagriès,832,0,6393,6393,7.7
39001,Abergement-la-Ronce,832,23100,16886,39986,48.1
40222,Pey,832,0,6192,6192,7.4
41288,Villerbon,832,0,31887,31887,38.3
67264,Leutenheim,832,29200,10082,39282,47.2
71482,Saint-Symphorien-de-Marmagne,832,0,13369,13369,16.1
72315,Saint-Rémy-de-Sillé,832,0,16231,16231,19.5
72337,Sougé-le-Ganelon,832,0,39163,39163,47.1
76562,Saint-Aubin-le-Cauf,832,9154,5263,14417,17.3
78125,La Celle-les-Bordes,832,0,1621,1621,1.9
2157,Chambry,831,5800,31736,37536,45.2
19164,Peyrelevade,831,22380,11392,33772,40.6
21191,Corcelles-lès-Cîteaux,831,0,3985,3985,4.8
47028,Birac-sur-Trec,831,0,8598,8598,10.3
52008,Andelot-Blancheville,831,0,12785,12785,15.4
57333,Hommarting,831,0,5410,5410,6.5
67489,Thal-Marmoutier,831,4690,58613,63303,76.2
68075,Durmenach,831,3089,22292,25381,30.5
69095,Grézieu-le-Marché,831,79971,41651,121622,146.4
70312,Luze,831,0,5427,5427,6.5
77071,Chaintreaux,831,0,876,876,1.1
14643,Saint-Paul-du-Vernay,830,0,5746,5746,6.9
35092,Cuguen,830,0,10390,10390,12.5
60334,Lachapelle-Saint-Pierre,830,0,3447,3447,4.2
62271,Dohem,830,0,1796,1796,2.2
65366,Poueyferré,830,0,7929,7929,9.6
87150,Saint-Hilaire-les-Places,830,2510,11250,13760,16.6
8078,Bourg-Fidèle,829,0,12906,12906,15.6
11253,Montolieu,829,0,5377,5377,6.5
44124,Le Pin,829,0,10128,10128,12.2
67020,Barembach,829,0,59993,59993,72.4
76678,Sommery,829,0,19365,19365,23.4
14309,Gouvix,828,0,25032,25032,30.2
25073,Bonnay,828,2300,14589,16889,20.4
33342,Puisseguin,828,0,32169,32169,38.9
43110,Lamothe,828,1110,40578,41688,50.3
46322,Trespoux-Rassiels,828,0,6991,6991,8.4
49170,Juvardeil,828,0,23996,23996,29
61394,Saint-Germain-de-la-Coudre,828,2805,9613,12418,15
80512,Mareuil-Caubert,828,0,2526,2526,3.1
80597,Nibas,828,0,5505,5505,6.6
81306,Valderiès,828,0,18943,18943,22.9
82178,Savenès,828,0,11112,11112,13.4
7302,Saint-Vincent-de-Barrès,827,0,17706,17706,21.4
14352,Landelles-et-Coupigny,827,0,378,378,0.5
19007,Altillac,827,0,4169,4169,5
23045,Chambon-sur-Voueize,827,0,12430,12430,15
29262,Saint-Sauveur,827,3380,6108,9488,11.5
30303,Saint-Victor-de-Malcap,827,0,33566,33566,40.6
30313,Sauzet,827,0,3046,3046,3.7
35316,Saint-Sulpice-des-Landes,827,0,12036,12036,14.6
43239,Siaugues-Sainte-Marie,827,7920,7531,15451,18.7
47094,Fauguerolles,827,0,8556,8556,10.3
54428,Pierrepont,827,0,10499,10499,12.7
61440,Saint-Ouen-sur-Iton,827,10797,8525,19322,23.4
67421,Saales,827,5868,59848,65716,79.5
77202,La Genevraye,827,0,2876,2876,3.5
89286,Parly,827,2558,37342,39900,48.2
1030,Beauregard,826,0,13082,13082,15.8
1079,Champagne-en-Valromey,826,0,9206,9206,11.1
3271,Serbannes,826,0,22628,22628,27.4
33076,Budos,826,0,25328,25328,30.7
41110,Langon-sur-Cher,826,0,17405,17405,21.1
51432,Pleurs,826,0,1556,1556,1.9
67275,Lupstein,826,13807,58260,72067,87.2
73098,Les Déserts,826,0,10499,10499,12.7
80019,Allery,826,0,1140,1140,1.4
87131,Saillat-sur-Vienne,826,52600,18065,70665,85.6
2458,Dhuys et Morin-en-Brie,825,0,19069,19069,23.1
24016,Augignac,825,3220,5528,8748,10.6
29238,Roscanvel,825,37601,10663,48264,58.5
35056,La Chapelle-aux-Filtzméens,825,0,10328,10328,12.5
68111,Gueberschwihr,825,0,81003,81003,98.2
80029,Arrest,825,0,2517,2517,3.1
1252,Mogneneins,824,0,4253,4253,5.2
6151,Utelle,824,0,16223,16223,19.7
8194,Glaire,824,0,18928,18928,23
11192,Lasbordes,824,0,7241,7241,8.8
25224,Étouvans,824,7555,52162,59717,72.5
25466,Pouilley-Français,824,0,14519,14519,17.6
27587,Saint-Philbert-sur-Risle,824,41468,18613,60081,72.9
36021,Les Bordes,824,0,19455,19455,23.6
57137,Cheminot,824,0,31555,31555,38.3
62812,Thiembronne,824,0,73336,73336,89
76473,Notre-Dame-de-Bliquetuit,824,0,6280,6280,7.6
79008,Amailloux,824,10282,21604,31886,38.7
82195,Villemade,824,0,7175,7175,8.7
85231,Saint-Hilaire-la-Forêt,824,0,16543,16543,20.1
3029,Billy,823,0,22546,22546,27.4
11201,Leuc,823,0,5338,5338,6.5
16209,Marillac-le-Franc,823,4950,14676,19626,23.8
17032,Ballon,823,0,34053,34053,41.4
24498,Saint-Saud-Lacoussière,823,8050,5515,13565,16.5
26077,Charmes-sur-l'Herbasse,823,410,36213,36623,44.5
2B242,Poggio-Mezzana,823,0,5906,5906,7.2
38508,Torchefelon,823,0,7217,7217,8.8
46080,Crayssac,823,0,6949,6949,8.4
62750,Saint-Hilaire-Cottes,823,0,13581,13581,16.5
68385,Zimmerbach,823,0,16914,16914,20.6
69030,Brullioles,823,2765,41250,44015,53.5
79335,Vallans,823,0,11092,11092,13.5
85157,Moutiers-sur-le-Lay,823,0,17394,17394,21.1
85305,Vouvant,823,0,5400,5400,6.6
90035,Dorans,823,0,28713,28713,34.9
1095,Nivigne et Suran,822,14804,15891,30695,37.3
2134,Buire,822,0,16136,16136,19.6
6043,Coaraze,822,0,23179,23179,28.2
14085,Bonneville-la-Louvet,822,0,13211,13211,16.1
16422,Vouzan,822,0,21371,21371,26
22345,Trébry,822,2725,9921,12646,15.4
25417,Naisey-les-Granges,822,4464,9710,14174,17.2
27164,Combon,822,0,3544,3544,4.3
72325,Saint-Vincent-du-Lorouër,822,0,46354,46354,56.4
72338,Souillé,822,0,46188,46188,56.2
10123,Dienville,821,0,17332,17332,21.1
15169,Saignes,821,16973,4201,21174,25.8
18190,Quincy,821,0,11140,11140,13.6
26320,Saint-Nazaire-en-Royans,821,3531,51419,54950,66.9
61376,Saint-Clair-de-Halouze,821,16355,21989,38344,46.7
67366,Ottersthal,821,2200,57908,60108,73.2
77002,Amillis,821,0,3197,3197,3.9
77123,Compans,821,243327,10182,253509,308.8
30130,Génolhac,820,3847,25631,29478,35.9
49076,La Chapelle-Saint-Laud,820,0,6274,6274,7.7
59591,Thivencelle,820,0,15797,15797,19.3
62213,Carency,820,0,22091,22091,26.9
67435,Sarrewerden,820,1010,10280,11290,13.8
68254,Petit-Landau,820,10178,57123,67301,82.1
69265,Ville-sur-Jarnioux,820,8530,17409,25939,31.6
73281,Saint-Sulpice,820,0,10423,10423,12.7
78506,Prunay-en-Yvelines,820,0,1598,1598,1.9
85148,Montreuil,820,0,5380,5380,6.6
1332,Saint-André-de-Bâgé,819,0,11248,11248,13.7
14299,Genneville,819,0,6119,6119,7.5
19118,Le Lonzac,819,0,15541,15541,19
24274,Monbazillac,819,4170,18233,22403,27.4
25201,Dommartin,819,0,23410,23410,28.6
38396,Saint-Honoré,819,8050,8575,16625,20.3
57074,Bettviller,819,0,18875,18875,23
60063,Berneuil-en-Bray,819,0,32115,32115,39.2
68251,Osenbach,819,0,80414,80414,98.2
69037,Chambost-Allières,819,0,9681,9681,11.8
71177,Dommartin-lès-Cuiseaux,819,0,3372,3372,4.1
71194,Farges-lès-Chalon,819,0,22518,22518,27.5
10245,Montaulin,818,0,11681,11681,14.3
24214,Javerlhac-et-la-Chapelle-Saint-Robert,818,5500,5482,10982,13.4
27099,Le Boulay-Morin,818,0,9620,9620,11.8
28146,Faverolles,818,0,4747,4747,5.8
28321,Rouvres,818,0,1094,1094,1.3
38146,Dizimieu,818,0,4223,4223,5.2
45161,Griselles,818,0,8023,8023,9.8
50200,Ger,818,0,20126,20126,24.6
57693,Vantoux,818,0,40557,40557,49.6
64409,Moumour,818,0,17616,17616,21.5
7143,Limony,817,0,4209,4209,5.2
17280,Plassay,817,2802,20811,23613,28.9
27132,Caugé,817,0,9609,9609,11.8
36180,Saint-Août,817,37876,17946,55822,68.3
41259,Thoré-la-Rochette,817,0,10105,10105,12.4
47191,Montpouillan,817,0,8453,8453,10.3
50498,Saint-Joseph,817,0,25698,25698,31.5
57146,Coin-lès-Cuvry,817,0,40507,40507,49.6
60024,Arsy,817,0,765,765,0.9
68223,Muhlbach-sur-Munster,817,0,32796,32796,40.1
72158,Lavaré,817,0,11045,11045,13.5
4006,Allos,816,89200,28854,118054,144.7
14090,Boulon,816,0,24669,24669,30.2
16016,Ansac-sur-Vienne,816,3650,16789,20439,25
30235,Saint-Bonnet-du-Gard,816,0,3208,3208,3.9
33504,Sauternes,816,0,8345,8345,10.2
36162,Poulaines,816,46040,825,46865,57.4
39530,Thoirette-Coisia,816,3940,23748,27688,33.9
41131,Mazangé,816,8364,10093,18457,22.6
42268,Vézelin-sur-Loire,816,5410,6736,12146,14.9
64054,Arros-de-Nay,816,2000,8726,10726,13.1
71010,Antully,816,0,18257,18257,22.4
72059,Chantenay-Villedieu,816,0,7415,7415,9.1
73018,Arbin,816,0,14593,14593,17.9
81274,Saliès,816,48400,7921,56321,69
86246,Saint-Savin,816,24416,33004,57420,70.4
1113,Condeissiat,815,0,170,170,0.2
8354,Raucourt-et-Flaba,815,0,28854,28854,35.4
18157,Morthomiers,815,0,15611,15611,19.2
21087,Bligny-sur-Ouche,815,0,12387,12387,15.2
29099,Lampaul-Ploudalmézeau,815,7563,1468,9031,11.1
31403,Ondes,815,0,6818,6818,8.4
37161,Mosnes,815,0,22122,22122,27.1
47061,Caumont-sur-Garonne,815,0,8432,8432,10.3
55500,Spincourt,815,0,14895,14895,18.3
59438,Noyelles-sur-Escaut,815,0,10594,10594,13
68017,Ballersdorf,815,0,11605,11605,14.2
76714,Les Trois-Pierres,815,0,7351,7351,9
80634,Pont-Noyelles,815,0,108,108,0.1
15045,Chaudes-Aigues,814,16000,18005,34005,41.8
21405,Merceuil,814,0,3540,3540,4.3
24210,Hautefort,814,18098,14236,32334,39.7
42157,Noailly,814,0,24021,24021,29.5
47127,Lafitte-sur-Lot,814,0,8422,8422,10.3
62751,Saint-Inglevert,814,0,3238,3238,4
77082,Champeaux,814,0,772,772,0.9
79140,Valdelaume,814,0,23509,23509,28.9
79273,Saint-Martin-de-Bernegoue,814,0,10971,10971,13.5
88258,Lamarche,814,0,6328,6328,7.8
2058,Beaurieux,813,0,5844,5844,7.2
2500,Montbrehain,813,0,7366,7366,9.1
8381,Saint-Germainmont,813,0,15548,15548,19.1
12016,Auzits,813,0,1749,1749,2.2
22377,Tréveneuc,813,0,12894,12894,15.9
27339,Hondouville,813,16540,3496,20036,24.6
37030,Le Boulay,813,0,3568,3568,4.4
37051,Champigny-sur-Veude,813,0,22059,22059,27.1
43119,Lavoûte-sur-Loire,813,5125,33828,38953,47.9
57256,Gravelotte,813,0,40309,40309,49.6
59192,Émerchicourt,813,0,30586,30586,37.6
65320,Montgaillard,813,0,6102,6102,7.5
77173,Étrépilly,813,0,11937,11937,14.7
1058,Brégnier-Cordon,812,0,9050,9050,11.1
16216,Mérignac,812,5900,30381,36281,44.7
59436,Noordpeene,812,0,4961,4961,6.1
71550,Uchizy,812,0,18897,18897,23.3
74186,Montagny-les-Lanches,812,0,6272,6272,7.7
77403,Saint-Brice,812,0,2928,2928,3.6
91294,Guillerval,812,0,2045,2045,2.5
2580,Oulchy-le-Château,811,0,2709,2709,3.3
28033,Belhomert-Guéhouville,811,0,577,577,0.7
44031,La Chapelle-Glain,811,0,13602,13602,16.8
49061,Challain-la-Potherie,811,6432,809,7241,8.9
60169,Courcelles-lès-Gisors,811,0,17809,17809,22
68051,Breitenbach-Haut-Rhin,811,0,32555,32555,40.1
71001,L'Abergement-de-Cuisery,811,0,4727,4727,5.8
77516,Ville-Saint-Jacques,811,0,2821,2821,3.5
84113,Saint-Martin-de-la-Brasque,811,0,3639,3639,4.5
3045,Busset,810,0,22190,22190,27.4
47066,Clermont-Dessous,810,0,7782,7782,9.6
57408,Lixing-lès-Rouhling,810,0,11070,11070,13.7
59065,Bellignies,810,0,2286,2286,2.8
67140,Forstfeld,810,0,9815,9815,12.1
71380,Saillenard,810,0,1515,1515,1.9
73142,Landry,810,0,40745,40745,50.3
2106,Bourg-et-Comin,809,0,5816,5816,7.2
22145,Mégrit,809,0,21552,21552,26.6
24316,Parcoul-Chenaud,809,11725,2829,14554,18
27332,Heudebouville,809,0,23991,23991,29.7
37055,Channay-sur-Lathan,809,0,7504,7504,9.3
38319,Pont-en-Royans,809,0,13074,13074,16.2
55369,Naives-Rosières,809,0,9754,9754,12.1
56104,Lanvaudan,809,13828,18298,32126,39.7
62229,Cléty,809,0,1750,1750,2.2
67363,Osthoffen,809,0,314280,314280,388.5
71003,Allerey-sur-Saône,809,7180,22243,29423,36.4
80779,Vauchelles-les-Quesnoy,809,0,2468,2468,3.1
2420,Lesdins,808,0,115481,115481,142.9
25040,Badevel,808,4299,51149,55448,68.6
25586,Vandoncourt,808,19130,51149,70279,87
27158,Cierrey,808,0,9503,9503,11.8
2A090,Coggia,808,0,3722,3722,4.6
31192,Fourquevaux,808,0,13174,13174,16.3
35309,Saint-Rémy-du-Plain,808,0,24769,24769,30.7
39510,Septmoncel les Molunes,808,11376,2975,14351,17.8
53083,Courcité,808,0,7186,7186,8.9
53181,Pontmain,808,0,10653,10653,13.2
53226,Saint-Hilaire-du-Maine,808,0,3672,3672,4.5
59604,Troisvilles,808,0,5552,5552,6.9
60373,Machemont,808,0,4106,4106,5.1
62356,Fresnicourt-le-Dolmen,808,0,13334,13334,16.5
62820,Tincques,808,91318,6714,98032,121.3
67557,Zellwiller,808,0,24988,24988,30.9
72248,Pruillé-l'Éguillé,808,0,45564,45564,56.4
72256,Rouez,808,0,15763,15763,19.5
73218,Ruffieux,808,10436,4470,14906,18.4
74279,Thollon-les-Mémises,808,35200,41863,77063,95.4
77388,Reuil-en-Brie,808,0,3147,3147,3.9
83154,Saint-Antonin-du-Var,808,0,10065,10065,12.5
35075,Chauvigné,807,0,24738,24738,30.7
42254,Saint-Marcel-de-Félines,807,0,14628,14628,18.1
56112,Lizio,807,0,9818,9818,12.2
60337,Lachelle,807,12220,7268,19488,24.1
67358,Offwiller,807,9377,29554,38931,48.2
68234,Niederentzen,807,1715,6369,8084,10
78329,Lainville-en-Vexin,807,0,7511,7511,9.3
82028,Canals,807,0,10830,10830,13.4
7237,Saint-Fortunat-sur-Eyrieux,806,4598,2689,7287,9
14504,Le Pin,806,0,8972,8972,11.1
22369,Trémeur,806,9540,9728,19268,23.9
29134,Locronan,806,11332,25873,37205,46.2
35183,Mondevert,806,0,12109,12109,15
51389,Mourmelon-le-Petit,806,0,40967,40967,50.8
54253,Hatrize,806,0,7484,7484,9.3
56211,Saint-Congard,806,0,9806,9806,12.2
59381,Maresches,806,0,2275,2275,2.8
68101,Galfingue,806,0,56148,56148,69.7
71410,Saint-Étienne-en-Bresse,806,0,3318,3318,4.1
87071,Glandon,806,3940,24684,28624,35.5
1140,Curtafond,805,0,15563,15563,19.3
24087,Castels et Bézenac,805,3975,39405,43380,53.9
25575,Vaire,805,4389,14184,18573,23.1
27456,Pinterville,805,0,23873,23873,29.7
46105,Flaujac-Poujols,805,0,4526,4526,5.6
56044,Cournon,805,0,9793,9793,12.2
63207,Marat,805,7475,7274,14749,18.3
66020,Bolquère,805,0,0,0,0
72249,La Quinte,805,0,15704,15704,19.5
76555,Saint-André-sur-Cailly,805,0,550,550,0.7
80765,Tours-en-Vimeu,805,0,5352,5352,6.6
9105,Daumazan-sur-Arize,804,0,14300,14300,17.8
16406,Moulins-sur-Tardoire,804,4979,14338,19317,24
25296,Les Gras,804,0,9570,9570,11.9
29071,Guilligomarc'h,804,0,27622,27622,34.4
33002,Aillas,804,0,6546,6546,8.1
35350,Vergéal,804,0,12079,12079,15
43227,Saint-Victor-Malescours,804,58910,12514,71424,88.8
50222,Grosville,804,7024,25289,32313,40.2
56071,Guéhenno,804,0,3240,3240,4
57740,Waldwisse,804,0,11574,11574,14.4
60173,Cramoisy,804,0,8269,8269,10.3
64331,Lembeye,804,0,8393,8393,10.4
73320,Villargondran,804,0,21591,21591,26.9
76278,Foucarmont,804,19029,15,19044,23.7
86029,Blanzay,804,0,18106,18106,22.5
87181,Saint-Sulpice-Laurière,804,0,1303,1303,1.6
14290,Fresney-le-Puceux,803,0,24276,24276,30.2
19273,Turenne,803,0,12816,12816,16
23015,Azerables,803,0,15198,15198,18.9
24321,Pazayac,803,3633,14044,17677,22
51352,Marolles,803,0,12666,12666,15.8
61140,Crulai,803,10160,8278,18438,23
67121,Elsenheim,803,0,16915,16915,21.1
74099,Demi-Quartier,803,0,8409,8409,10.5
76198,Criquetot-sur-Ouville,803,0,1770,1770,2.2
77161,Dormelles,803,0,2793,2793,3.5
77214,Gressy,803,0,9958,9958,12.4
86211,Romagne,803,7390,18083,25473,31.7
5010,Aspres-sur-Buëch,802,0,30013,30013,37.4
14038,Banville,802,0,9833,9833,12.3
14735,Vendeuvre,802,0,12563,12563,15.7
32268,Monferran-Savès,802,0,57053,57053,71.1
33062,Bonzac,802,0,15644,15644,19.5
35151,Lieuron,802,0,11441,11441,14.3
38512,Tramolé,802,0,8750,8750,10.9
51585,Troissy,802,0,1161,1161,1.4
62255,Crémarest,802,0,2316,2316,2.9
74179,Mésigny,802,0,3406,3406,4.2
76435,Le Mesnil-Réaume,802,0,2306,2306,2.9
77370,Poligny,802,0,845,845,1.1
85244,Saint-Martin-de-Fraigneau,802,0,5262,5262,6.6
87079,La Jonchère-Saint-Maurice,802,0,1299,1299,1.6
16110,Courcôme,801,6360,17533,23893,29.8
24451,Saint-Martial-de-Valette,801,4200,5368,9568,11.9
24461,Saint-Méard-de-Gurçon,801,5600,2791,8391,10.5
29123,Lennon,801,0,12624,12624,15.8
39153,Cize,801,760,8110,8870,11.1
41002,Angé,801,0,14719,14719,18.4
64135,Bonnut,801,0,21568,21568,26.9
68265,Rantzwiller,801,0,15569,15569,19.4
76507,Ponts-et-Marais,801,0,2304,2304,2.9
76644,Saint-Rémy-Boscrocourt,801,0,2304,2304,2.9
76660,Sandouville,801,0,7225,7225,9
85167,L'Orbrie,801,0,5255,5255,6.6
86075,Chouppes,801,2168,41625,43793,54.7
88292,Mattaincourt,801,0,11511,11511,14.4
15261,Le Vigean,800,8900,15131,24031,30
28254,Mittainvilliers-Vérigny,800,0,23311,23311,29.1
2A215,Pianottoli-Caldarello,800,0,11733,11733,14.7
49221,Mouliherne,800,4100,7794,11894,14.9
50216,Graignes-Mesnil-Angot,800,0,11832,11832,14.8
67450,Schirrhoffen,800,0,9727,9727,12.2
80127,Bouvaincourt-sur-Bresle,800,0,2301,2301,2.9
89467,Villethierry,800,2420,2838,5258,6.6
17275,Pessines,799,0,25323,25323,31.7
22227,Plounérin,799,0,15873,15873,19.9
31338,Menville,799,0,6684,6684,8.4
31457,Roquefort-sur-Garonne,799,0,42941,42941,53.7
36233,La Vernelle,799,0,10031,10031,12.6
40077,Cauneille,799,0,5946,5946,7.4
40094,Escource,799,0,6287,6287,7.9
62008,Acquin-Westbécourt,799,0,1729,1729,2.2
66207,Terrats,799,0,10710,10710,13.4
67308,Munchhausen,799,8170,91623,99793,124.9
74155,Lullin,799,0,55830,55830,69.9
7140,Lemps,798,3516,35113,38629,48.4
17203,Landrais,798,1500,33019,34519,43.3
29090,Kerlaz,798,0,25314,25314,31.7
2B311,Santa-Maria-Poggio,798,0,5727,5727,7.2
31285,Lavalette,798,0,8951,8951,11.2
31466,Saiguède,798,10725,991,11716,14.7
33093,Capian,798,0,78789,78789,98.7
35321,Saulnières,798,0,11614,11614,14.6
37174,Nouâtre,798,0,21652,21652,27.1
39573,Villette-lès-Dole,798,500,16196,16696,20.9
50342,Montfarville,798,8415,25101,33516,42
57267,Le Val-de-Guéblange,798,0,10906,10906,13.7
59634,Wallon-Cappel,798,0,4875,4875,6.1
70121,Champey,798,0,5212,5212,6.5
73114,Flumet,798,0,18824,18824,23.6
73146,Lescheraines,798,0,10143,10143,12.7
76592,Saint-Jean-de-Folleville,798,0,6082,6082,7.6
79230,Rom,798,0,23047,23047,28.9
3109,Escurolles,797,0,16302,16302,20.5
21371,Les Maillys,797,0,0,0,0
24179,La Feuillade,797,0,13939,13939,17.5
30245,Saint-Côme-et-Maruéjols,797,0,2935,2935,3.7
31120,Le Castéra,797,0,6667,6667,8.4
40237,Préchacq-les-Bains,797,0,12482,12482,15.7
41040,La Chapelle-Vendômoise,797,380,30546,30926,38.8
45347,Vrigny,797,0,991,991,1.2
71394,Saint-Bonnet-de-Joux,797,0,3090,3090,3.9
80092,Bertangles,797,0,51097,51097,64.1
86116,Jazeneuil,797,0,47484,47484,59.6
2153,Cessières-Suzy,796,0,30399,30399,38.2
4033,Ubaye-Serre-Ponçon,796,0,237722,237722,298.6
9214,Moulis,796,0,96459,96459,121.2
14015,Anisy,796,0,5359,5359,6.7
16312,Saint-Cybardeaux,796,9690,55182,64872,81.5
37085,Courçay,796,0,17911,17911,22.5
46145,Lachapelle-Auzac,796,14725,25970,40695,51.1
51195,Couvrot,796,0,12556,12556,15.8
63380,Saint-Nectaire,796,0,5811,5811,7.3
64523,Sévignacq,796,0,12463,12463,15.7
68345,Urschenheim,796,0,13815,13815,17.4
16339,Val-d'Auge,795,7675,55113,62788,79
17255,Nancras,795,460,20251,20711,26.1
26317,Saint-Maurice-sur-Eygues,795,0,40851,40851,51.4
41243,Selommes,795,0,9833,9833,12.4
50480,Saint-Germain-le-Gaillard,795,3250,25006,28256,35.5
60479,Ormoy-Villers,795,0,3113,3113,3.9
64339,Lestelle-Bétharram,795,0,8502,8502,10.7
64538,Uhart-Cize,795,0,20659,20659,26
67056,Bootzheim,795,0,16746,16746,21.1
68110,Grussenheim,795,4148,16746,20894,26.3
89144,Domats,795,15725,2820,18545,23.3
21028,Athée,794,0,0,0,0
30286,Saint-Maximin,794,0,6101,6101,7.7
36155,Pellevoisin,794,0,9968,9968,12.6
51504,Saint-Martin-sur-le-Pré,794,0,40357,40357,50.8
57396,Lessy,794,0,39367,39367,49.6
62161,Bouquehault,794,0,4860,4860,6.1
69062,Coise,794,0,39797,39797,50.1
74294,Verchaix,794,16015,152550,168565,212.3
86050,Chalandray,794,250,41262,41512,52.3
16350,Saint-Séverin,793,10750,37289,48039,60.6
24055,Bourdeilles,793,6620,11172,17792,22.4
34322,Valflaunès,793,2400,14776,17176,21.7
41145,Monthou-sur-Bièvre,793,1752,30392,32144,40.5
57129,Charly-Oradour,793,0,1610,1610,2
76697,Torcy-le-Grand,793,0,6399,6399,8.1
88289,Martigny-les-Bains,793,0,6164,6164,7.8
1308,Pougny,792,0,10195,10195,12.9
5050,Espinasses,792,0,7065,7065,8.9
8122,Chooz,792,0,5085,5085,6.4
9079,Carla-Bayle,792,0,14086,14086,17.8
29132,Locquénolé,792,0,47488,47488,60
30256,Saint-Gervais,792,0,11557,11557,14.6
31231,Grazac,792,0,4166,4166,5.3
49217,Montreuil-sur-Maine,792,0,22953,22953,29
62488,Landrethun-lès-Ardres,792,0,4848,4848,6.1
67280,Maisonsgoutte,792,11305,125623,136928,172.9
73196,Pallud,792,0,18682,18682,23.6
85058,Chasnais,792,0,16738,16738,21.1
2041,Autreville,791,0,14212,14212,18
4076,Entrevaux,791,0,27970,27970,35.4
15094,Laroquebrou,791,45316,6936,52252,66.1
30188,Ners,791,0,24725,24725,31.3
33126,Civrac-de-Blaye,791,0,4427,4427,5.6
38062,La Buissière,791,1680,14698,16378,20.7
48018,Barjac,791,6384,31204,37588,47.5
57629,Sarraltroff,791,0,5150,5150,6.5
60392,Mélicocq,791,1180,4019,5199,6.6
63165,Giat,791,14503,26748,41251,52.2
72255,Rouessé-Vassé,791,0,15431,15431,19.5
84096,Rasteau,791,0,925,925,1.2
87039,Château-Chervix,791,14755,12684,27439,34.7
11401,Tuchan,790,0,1216,1216,1.5
29187,Plougar,790,0,5834,5834,7.4
30070,Carsan,790,0,11528,11528,14.6
33144,Cudos,790,3891,263,4154,5.3
41078,Épuisay,790,0,9771,9771,12.4
57348,Ippling,790,0,10797,10797,13.7
62007,Acq,790,0,22220,22220,28.1
74069,Chênex,790,22978,3096,26074,33
77266,Machault,790,1600,749,2349,3
78364,Marcq,790,0,341,341,0.4
80579,Muille-Villette,790,0,15057,15057,19.1
9060,Bonnac,789,0,3552,3552,4.5
18265,Torteron,789,0,250,250,0.3
29264,Saint-Servais,789,0,5827,5827,7.4
36149,Palluau-sur-Indre,789,0,19704,19704,25
38505,Thodure,789,0,8608,8608,10.9
40211,Orist,789,0,5872,5872,7.4
50167,Dragey-Ronthon,789,0,19413,19413,24.6
51009,Anglure,789,0,10295,10295,13
56236,Saint-Servant,789,0,11881,11881,15.1
62654,Peuplingues,789,0,23714,23714,30.1
69172,Salles-Arbuissonnas-en-Beaujolais,789,9562,16751,26313,33.3
18273,Venesmes,788,0,14264,14264,18.1
21320,Izier,788,0,18,18,0
22131,Loguivy-Plougras,788,0,15654,15654,19.9
27414,Montreuil-l'Argillé,788,0,3397,3397,4.3
35180,Miniac-sous-Bécherel,788,0,40380,40380,51.2
38445,Saint-Pierre-de-Mésage,788,0,30441,30441,38.6
54276,Jeandelaincourt,788,0,4663,4663,5.9
87033,Chamboret,788,0,1277,1277,1.6
8008,Amagne,787,0,15051,15051,19.1
11027,Barbaira,787,0,5105,5105,6.5
15184,Saint-Étienne-de-Maurs,787,7980,6901,14881,18.9
16383,Tourriers,787,4320,9894,14214,18.1
28198,Jallans,787,0,43004,43004,54.6
2B303,San-Giuliano,787,0,5648,5648,7.2
40043,Bias,787,0,4306,4306,5.5
63420,Seychalles,787,13050,3616,16666,21.2
67081,Dahlenheim,787,1513,42744,44257,56.2
74101,Dingy-en-Vuache,787,15827,3084,18911,24
89118,Coulanges-la-Vineuse,787,23025,15396,38421,48.8
14310,Grainville-Langannerie,786,0,23762,23762,30.2
41181,Pouillé,786,0,14443,14443,18.4
51476,Saint-Étienne-au-Temple,786,0,39951,39951,50.8
57701,Vaux,786,0,38970,38970,49.6
58044,La Celle-sur-Loire,786,0,15671,15671,19.9
59280,Hamel,786,0,10952,10952,13.9
62714,Roclincourt,786,0,22107,22107,28.1
76548,Ry,786,0,537,537,0.7
3257,Saint-Prix,785,0,1579,1579,2
4047,Champtercier,785,12818,32903,45721,58.2
17036,Beaugeay,785,1199,12927,14126,18
28292,Ouerre,785,0,1050,1050,1.3
33175,Frontenac,785,0,7796,7796,9.9
38141,Culin,785,0,8564,8564,10.9
50081,Bréville-sur-Mer,785,0,18999,18999,24.2
50453,Sainte-Cécile,785,0,13264,13264,16.9
62369,Gavrelle,785,0,22079,22079,28.1
67228,Neugartheim-Ittlenheim,785,7100,14935,22035,28.1
68283,Rombach-le-Franc,785,0,138850,138850,176.9
71413,Saint-Firmin,785,0,12614,12614,16.1
74178,Menthonnex-sous-Clermont,785,2400,18961,21361,27.2
1375,Saint-Martin-le-Châtel,784,0,15157,15157,19.3
5103,Le Poët,784,0,23373,23373,29.8
9104,Dalou,784,0,21072,21072,26.9
24325,Pechs-de-l'Espérance,784,4190,3000,7190,9.2
25328,Larnod,784,1700,13814,15514,19.8
39582,Voiteur,784,7047,20838,27885,35.6
76547,La Rue-Saint-Pierre,784,0,536,536,0.7
5092,Neffes,783,0,1110,1110,1.4
6158,Villars-sur-Var,783,0,17646,17646,22.5
12257,Causse-et-Diège,783,0,23123,23123,29.5
15001,Allanche,783,24742,176,24918,31.8
17171,Geay,783,2900,19945,22845,29.2
24096,Champagnac-de-Belair,783,0,11031,11031,14.1
30167,Meyrannes,783,0,31780,31780,40.6
42136,Marcoux,783,0,7015,7015,9
57607,Sainte-Barbe,783,0,1907,1907,2.4
59137,Catillon-sur-Sambre,783,0,5380,5380,6.9
69198,Saint-Étienne-la-Varenne,783,0,0,0,0
76239,Épretot,783,0,7063,7063,9
83128,Sillans-la-Cascade,783,0,9754,9754,12.5
89127,Courtois-sur-Yonne,783,2105,5203,7308,9.3
89268,Mont-Saint-Sulpice,783,21650,5060,26710,34.1
1175,Gorrevod,782,0,10740,10740,13.7
17436,Taillebourg,782,0,21782,21782,27.9
21373,Mâlain,782,0,4398,4398,5.6
24308,Négrondes,782,2100,2580,4680,6
38244,Monsteroux-Milieu,782,0,19991,19991,25.6
39485,Val Suran,782,11180,22759,33939,43.4
57546,Plesnois,782,0,1587,1587,2
59366,Lynde,782,0,4778,4778,6.1
60147,Chevincourt,782,0,3974,3974,5.1
63120,Corent,782,0,14018,14018,17.9
85304,Vouillé-les-Marais,782,0,16527,16527,21.1
14077,Blangy-le-Château,781,0,12552,12552,16.1
29275,Scrignac,781,0,40603,40603,52
33279,Mazères,781,0,7987,7987,10.2
38195,Izeron,781,0,12621,12621,16.2
62367,Gauchin-Verloingt,781,0,16872,16872,21.6
68362,Wentzwiller,781,58459,15180,73639,94.3
72045,Brains-sur-Gée,781,0,7097,7097,9.1
2643,Ressons-le-Long,780,7183,751,7934,10.2
11122,Douzens,780,0,5059,5059,6.5
27045,Bazincourt-sur-Epte,780,0,636,636,0.8
27423,Muzy,780,0,9173,9173,11.8
30172,Monoblet,780,0,1621,1621,2.1
54067,Beuveille,780,0,9902,9902,12.7
60082,Bonneuil-les-Eaux,780,0,17590,17590,22.6
63448,Le Vernet-Chaméane,780,3810,5070,8880,11.4
66055,Corbère,780,0,1052,1052,1.3
66107,Maury,780,0,19072,19072,24.5
68313,Soppe-le-Bas,780,3950,16366,20316,26
77231,Isles-les-Meldeuses,780,0,11453,11453,14.7
80652,Le Quesnel,780,0,4792,4792,6.1
89242,Maligny,780,2450,107,2557,3.3
7031,Berrias-et-Casteljau,779,1950,19063,21013,27
16100,Chirac,779,4990,16027,21017,27
50356,Moon-sur-Elle,779,0,11522,11522,14.8
57355,Kalhausen,779,0,10646,10646,13.7
59465,Pommereuil,779,0,5353,5353,6.9
72062,La Chapelle-du-Bois,779,0,4753,4753,6.1
89076,Champlost,779,15453,5034,20487,26.3
95445,Nerville-la-Forêt,779,0,5065,5065,6.5
3320,Ygrande,778,0,11951,11951,15.4
27413,Montfort-sur-Risle,778,0,17574,17574,22.6
32210,Lias,778,0,55345,55345,71.1
35225,Plesder,778,0,9739,9739,12.5
38440,Saint-Pierre-de-Bressieux,778,0,8488,8488,10.9
40059,Cagnotte,778,0,5790,5790,7.4
45306,La Selle-en-Hermoy,778,0,2359,2359,3
48096,Meyrueis,778,70380,19082,89462,115
59069,Bermerain,778,0,196,196,0.3
68262,Ranspach,778,4490,8084,12574,16.2
68377,Wittersdorf,778,0,20870,20870,26.8
72367,Vallon-sur-Gée,778,0,7070,7070,9.1
89054,Brannay,778,2135,2760,4895,6.3
7159,Mirabel,777,0,24102,24102,31
18083,Culan,777,18325,2083,20408,26.3
30002,Aigremont,777,0,1615,1615,2.1
41217,Saint-Julien-de-Chédon,777,1670,14278,15948,20.5
59593,Thun-l'Évêque,777,0,10100,10100,13
62650,Pelves,777,0,967,967,1.2
78317,Jambville,777,0,7231,7231,9.3
80020,Allonville,777,0,49815,49815,64.1
2422,Lesquielles-Saint-Germain,776,0,4278,4278,5.5
26157,La Laupie,776,0,7477,7477,9.6
27091,Bosgouet,776,6290,3179,9469,12.2
27347,Huest,776,0,9126,9126,11.8
28403,Ver-lès-Chartres,776,0,22612,22612,29.1
41223,Saint-Lubin-en-Vergonnois,776,1643,29741,31384,40.4
50437,Roncey,776,0,22453,22453,28.9
60401,Le Mesnil-Théribus,776,5500,17040,22540,29
60408,Monchy-Humières,776,0,6784,6784,8.7
67250,Kriegsheim,776,0,9436,9436,12.2
67430,Saint-Pierre-Bois,776,2830,123085,125915,162.3
69229,Saint-Nizier-d'Azergues,776,0,9172,9172,11.8
71428,Saint-Igny-de-Roche,776,0,15062,15062,19.4
77030,Bellot,776,0,12778,12778,16.5
77369,Poincy,776,0,10583,10583,13.6
88320,Nayemont-les-Fosses,776,0,7545,7545,9.7
95660,Villaines-sous-Bois,776,0,4487,4487,5.8
8111,Le Châtelet-sur-Retourne,775,0,14821,14821,19.1
9121,Ferrières-sur-Ariège,775,0,20831,20831,26.9
13116,Verquières,775,0,4038,4038,5.2
17278,Pisany,775,0,24562,24562,31.7
18115,Ivoy-le-Pré,775,0,0,0,0
34149,Margon,775,0,1516,1516,2
36208,Sainte-Sévère-sur-Indre,775,0,17023,17023,22
45316,Sury-aux-Bois,775,0,1507,1507,1.9
49036,Bouillé-Ménard,775,0,773,773,1
62769,Saint-Tricat,775,0,23293,23293,30.1
76398,Louvetot,775,0,5906,5906,7.6
1152,Échallon,774,0,29279,29279,37.8
12205,La Rouquette,774,0,2257,2257,2.9
38498,Succieu,774,0,9405,9405,12.2
54100,Brin-sur-Seille,774,0,4580,4580,5.9
57213,Filstroff,774,0,11142,11142,14.4
57732,Volmunster,774,0,17838,17838,23
59640,Wargnies-le-Petit,774,0,2184,2184,2.8
68193,Luttenbach-près-Munster,774,0,31070,31070,40.1
81143,Lescout,774,0,862,862,1.1
89307,Pontigny,774,0,106,106,0.1
17295,Réaux sur Trèfle,773,0,9127,9127,11.8
19261,Sornac,773,0,10597,10597,13.7
28129,Denonville,773,0,22524,22524,29.1
2B034,Belgodère,773,23000,10848,33848,43.8
33477,Saint-Seurin-de-Cursac,773,0,7205,7205,9.3
55120,Combles-en-Barrois,773,0,9320,9320,12.1
55125,Contrisson,773,0,17157,17157,22.2
59039,Awoingt,773,0,10048,10048,13
59145,Chemy,773,0,13193,13193,17.1
70155,Citers,773,0,2860,2860,3.7
84126,Séguret,773,0,904,904,1.2
9293,Serres-sur-Arget,772,7800,20750,28550,37
17439,Taugon,772,0,11248,11248,14.6
21423,Montagny-lès-Beaune,772,0,3357,3357,4.3
26074,La Chapelle-en-Vercors,772,16500,48350,64850,84
28369,Saulnières,772,0,1033,1033,1.3
31406,Palaminy,772,0,27035,27035,35
50603,Tourville-sur-Sienne,772,0,22337,22337,28.9
61222,Landisacq,772,2720,20677,23397,30.3
69004,Alix,772,5492,6957,12449,16.1
79284,Sainte-Ouenne,772,0,6363,6363,8.2
82144,Puycornet,772,0,3936,3936,5.1
2770,Vauxbuin,771,0,6450,6450,8.4
17462,Vénérand,771,0,24435,24435,31.7
42308,La Terrasse-sur-Dorlay,771,0,18065,18065,23.4
46220,Pinsac,771,0,25154,25154,32.6
50643,Virandeville,771,0,24251,24251,31.5
62245,Coulomby,771,0,1668,1668,2.2
67277,Mackenheim,771,0,16241,16241,21.1
77060,Buthiers,771,0,394,394,0.5
12012,Asprières,770,0,22739,22739,29.5
22390,Yvias,770,0,13788,13788,17.9
25160,Les Combes,770,0,9166,9166,11.9
26092,Chavannes,770,0,33881,33881,44
39378,Les Trois-Châteaux,770,1230,11741,12971,16.8
44065,Grand-Auverné,770,0,12914,12914,16.8
51044,Beaumont-sur-Vesle,770,0,13684,13684,17.8
53218,Sainte-Gemmes-le-Robert,770,0,5508,5508,7.2
53265,Torcé-Viviers-en-Charnie,770,0,5508,5508,7.2
54038,Azerailles,770,0,3402,3402,4.4
59159,Craywick,770,0,94021,94021,122.1
76738,Vieux-Manoir,770,0,526,526,0.7
84145,Villars,770,12093,15695,27788,36.1
1038,Bény,769,0,14867,14867,19.3
19182,Saint-Aulaire,769,0,12273,12273,16
30023,Aujargues,769,2200,57205,59405,77.2
44080,Lavau-sur-Loire,769,0,17094,17094,22.2
60411,Monneville,769,0,16887,16887,22
68381,Wuenheim,769,0,18977,18977,24.7
77034,Blandy,769,8300,729,9029,11.7
3159,Malicorne,768,12977,27437,40414,52.6
7017,Les Assions,768,9689,18794,28483,37.1
18159,Nançay,768,0,0,0,0
45296,Saint-Péravy-la-Colombe,768,0,1083,1083,1.4
50102,Carolles,768,0,18587,18587,24.2
65048,Aurensan,768,0,7337,7337,9.6
67534,Wilwisheim,768,10641,25810,36451,47.5
72219,Bernay-Neuvy-en-Champagne,768,0,14983,14983,19.5
76234,Émanville,768,0,2565,2565,3.3
76456,Motteville,768,0,1693,1693,2.2
77398,Sablonnières,768,0,12647,12647,16.5
80678,Rollot,768,0,927,927,1.2
91662,Villeconin,768,0,5201,5201,6.8
7071,Coucouron,767,7912,5997,13909,18.1
14318,Graye-sur-Mer,767,0,9403,9403,12.3
14625,Saint-Martin-de-la-Lieue,767,0,8538,8538,11.1
17403,Saint-Simon-de-Bordes,767,0,9057,9057,11.8
23021,Bénévent-l'Abbaye,767,0,4248,4248,5.5
59534,Saint-Hilaire-sur-Helpe,767,0,6076,6076,7.9
60302,Haudivillers,767,11350,30076,41426,54
63296,Ravel,767,0,3524,3524,4.6
69178,Souzy,767,0,38443,38443,50.1
77248,Lesches,767,0,1896,1896,2.5
82189,Vazerac,767,0,3910,3910,5.1
2498,Montaigu,766,0,2061,2061,2.7
16210,Marsac,766,0,19915,19915,26
21239,Échenon,766,0,5743,5743,7.5
22216,Plougonver,766,0,13716,13716,17.9
25213,Les Écorces,766,0,5336,5336,7
59106,Bouvines,766,0,12685,12685,16.6
67016,Avolsheim,766,7340,1974,9314,12.2
68119,Hagenbach,766,0,10907,10907,14.2
70197,Dampierre-sur-Linotte,766,0,2452,2452,3.2
70477,Saulnot,766,0,5003,5003,6.5
76183,Colleville,766,0,4970,4970,6.5
77506,Villemer,766,0,2664,2664,3.5
79016,Assais-les-Jumeaux,766,0,19590,19590,25.6
8199,La Grandville,765,0,17573,17573,23
12011,Arvieu,765,0,5424,5424,7.1
19085,Gimel-les-Cascades,765,3520,14516,18036,23.6
31439,Préserville,765,0,3731,3731,4.9
40236,Poyartin,765,0,11981,11981,15.7
56043,Concoret,765,0,11520,11520,15.1
57667,Téterchen,765,0,4607,4607,6
65129,Castelnau-Magnoac,765,0,24781,24781,32.4
71402,Saint-Cyr,765,0,9267,9267,12.1
79304,Sansais,765,0,10310,10310,13.5
80628,Le Plessier-Rozainvillers,765,0,4700,4700,6.1
86039,Brux,765,0,17228,17228,22.5
90081,Réchésy,765,0,4550,4550,5.9
1008,Ambutrix,764,0,13039,13039,17.1
1364,Saint-Jean-sur-Reyssouze,764,0,14770,14770,19.3
12255,Salmiech,764,0,13771,13771,18
17017,Archingeay,764,0,21281,21281,27.9
42118,Lay,764,6600,21659,28259,37
51141,La Chaussée-sur-Marne,764,0,12051,12051,15.8
59109,Brillon,764,0,28742,28742,37.6
70489,Servance-Miellin,764,0,8788,8788,11.5
72266,Saint-Aubin-de-Locquenay,764,0,35962,35962,47.1
76433,Mesnil-Panneville,764,0,1413,1413,1.8
78104,Breuil-Bois-Robert,764,0,7110,7110,9.3
79064,Fontivillié,764,0,22065,22065,28.9
80031,Arvillers,764,0,4693,4693,6.1
83095,Pontevès,764,0,7836,7836,10.3
1449,Villette-sur-Ain,763,0,159,159,0.2
22344,Trébrivan,763,0,70263,70263,92.1
28124,Dampierre-sur-Avre,763,0,1021,1021,1.3
28177,Gellainville,763,0,22233,22233,29.1
31229,Gratens,763,0,26720,26720,35
37166,Neuillé-le-Lierre,763,2200,20710,22910,30
40110,Geaune,763,0,17628,17628,23.1
40315,Téthieu,763,0,6532,6532,8.6
50531,Saint-Ovin,763,0,18773,18773,24.6
62649,Pas-en-Artois,763,0,6340,6340,8.3
71319,Montret,763,0,3141,3141,4.1
76318,Grand-Camp,763,0,5815,5815,7.6
1041,Bettant,762,0,13004,13004,17.1
8357,Remilly-Aillicourt,762,0,26978,26978,35.4
14714,Le Tronquay,762,0,5275,5275,6.9
17016,Archiac,762,0,8997,8997,11.8
18065,Chezal-Benoît,762,0,17992,17992,23.6
30088,Combas,762,0,56684,56684,74.4
30126,Garrigues-Sainte-Eulalie,762,0,5855,5855,7.7
71583,Vinzelles,762,0,19464,19464,25.5
73109,Épierre,762,0,28906,28906,37.9
76532,Rocquemont,762,0,17800,17800,23.4
79120,La Ferrière-en-Parthenay,762,0,19978,19978,26.2
80416,Hangest-sur-Somme,762,0,1311,1311,1.7
80644,Proyart,762,0,13791,13791,18.1
90034,Denney,762,0,26585,26585,34.9
91273,Gironville-sur-Essonne,762,0,26549,26549,34.8
12121,Lanuéjouls,761,0,13071,13071,17.2
14719,Urville,761,0,23007,23007,30.2
17043,Bernay-Saint-Martin,761,0,21197,21197,27.9
17211,Loulay,761,0,21197,21197,27.9
30285,Saint-Maurice-de-Cazevieille,761,0,23787,23787,31.3
32227,Manciet,761,13220,507,13727,18
36158,Badecon-le-Pin,761,0,5587,5587,7.3
38077,La Chapelle-de-Surieu,761,0,19454,19454,25.6
39130,Nanchez,761,14709,5419,20128,26.4
45060,La Bussière,761,0,8858,8858,11.6
62784,Saulty,761,0,6324,6324,8.3
73283,Saint-Vital,761,0,17951,17951,23.6
1318,Rancé,760,0,12037,12037,15.8
14281,Formigny La Bataille,760,0,5261,5261,6.9
14572,Saint-Denis-de-Méré,760,0,347,347,0.5
14630,Saint-Martin-des-Entrées,760,0,29292,29292,38.5
17167,Le Fouilloux,760,0,8974,8974,11.8
22386,Le Vieux-Bourg,760,0,12054,12054,15.9
27277,La Baronnie,760,0,8938,8938,11.8
34290,Saint-Vincent-de-Barbeyrargues,760,7100,14161,21261,28
37212,Sainte-Catherine-de-Fierbois,760,0,12098,12098,15.9
50328,Millières,760,0,15880,15880,20.9
50612,Vains,760,0,18699,18699,24.6
56136,Monteneuf,760,0,9246,9246,12.2
73036,Bellecombe-en-Bauges,760,0,9660,9660,12.7
73265,Saint-Ours,760,0,4205,4205,5.5
77376,Précy-sur-Marne,760,0,578,578,0.8
79032,Béceleuf,760,0,6264,6264,8.2
14487,Ouilly-le-Vicomte,759,0,8449,8449,11.1
50401,Pierreville,759,1131,23874,25005,32.9
57232,Francaltroff,759,0,2512,2512,3.3
71439,Saint-Léger-lès-Paray,759,0,2943,2943,3.9
74100,Desingy,759,0,18333,18333,24.2
78227,Évecquemont,759,2408,7064,9472,12.5
89018,Armeau,759,5518,5044,10562,13.9
1379,Saint-Maurice-de-Rémens,758,0,12936,12936,17.1
3145,Lignerolles,758,0,17842,17842,23.5
14039,Barbery,758,0,22916,22916,30.2
23168,Sardent,758,0,23767,23767,31.4
24137,Coulaures,758,7236,9530,16766,22.1
24197,Ginestet,758,0,16875,16875,22.3
28005,Alluyes,758,0,1395,1395,1.8
31211,Gargas,758,0,1523,1523,2
55435,Robert-Espagne,758,0,9139,9139,12.1
69017,Bagnols,758,0,6831,6831,9
73110,Esserts-Blay,758,0,17880,17880,23.6
77076,Chalmaison,758,0,10735,10735,14.2
11351,Saint-Laurent-de-la-Cabrerisse,757,0,10257,10257,13.5
18201,Saint-Caprais,757,3390,2110,5500,7.3
22201,Plévenon,757,0,20167,20167,26.6
27518,Saint-Aubin-sur-Quillebeuf,757,0,3101,3101,4.1
30106,Durfort-et-Saint-Martin-de-Sossenac,757,0,1573,1573,2.1
34318,Vacquières,757,0,14105,14105,18.6
36107,Lye,757,0,9503,9503,12.6
38222,Massieu,757,0,12860,12860,17
38358,Sainte-Anne-sur-Gervonde,757,0,8259,8259,10.9
41297,Yvoy-le-Marron,757,0,6317,6317,8.3
53163,Neau,757,0,5415,5415,7.2
65451,Trébons,757,0,5682,5682,7.5
80431,Hérissart,757,0,846,846,1.1
85132,Maillé,757,0,11863,11863,15.7
89075,Champlay,757,1560,5934,7494,9.9
7161,Montpezat-sous-Bauzon,756,5413,3107,8520,11.3
29144,La Martyre,756,12805,5859,18664,24.7
29256,Saint-Nic,756,8438,11915,20353,26.9
33521,Talais,756,0,730,730,1
41209,Saint-Firmin-des-Prés,756,3386,9351,12737,16.8
41218,Saint-Julien-sur-Cher,756,0,15930,15930,21.1
43126,Malrevers,756,1773,31457,33230,44
53122,Jublains,756,0,28094,28094,37.2
64413,Narcastet,756,0,8085,8085,10.7
67476,Stattmatten,756,6700,9161,15861,21
85285,Le Tablier,756,0,35734,35734,47.3
1068,Cerdon,755,0,10818,10818,14.3
2596,Pavant,755,0,411,411,0.5
12263,Savignac,755,0,2202,2202,2.9
14614,Sainte-Marguerite-d'Elle,755,0,5226,5226,6.9
22333,Saint-Vran,755,0,0,0,0
26065,Chabrillan,755,12150,9145,21295,28.2
33161,Eyrans,755,0,7037,7037,9.3
34110,Galargues,755,5962,8254,14216,18.8
36064,Diors,755,0,27983,27983,37.1
40200,Moustey,755,0,5941,5941,7.9
52244,Humbécourt,755,0,6838,6838,9.1
61429,Charencey,755,5650,3216,8866,11.7
67083,Dambach,755,0,27649,27649,36.6
67382,Quatzenheim,755,5400,14365,19765,26.2
80234,Daours,755,0,100,100,0.1
82019,Boudou,755,0,9696,9696,12.8
1184,Hautecourt-Romanèche,754,0,14577,14577,19.3
22202,Plévin,754,0,25498,25498,33.8
27665,Trouville-la-Haule,754,0,3089,3089,4.1
33388,Saint-Ciers-de-Canesse,754,0,7717,7717,10.2
60610,Sempigny,754,0,0,0,0
61275,Le Merlerault,754,11000,5450,16450,21.8
71063,Broye,754,0,16870,16870,22.4
80279,Ercheu,754,0,910,910,1.2
3217,Saint-Angel,753,0,26901,26901,35.7
27419,Mouettes,753,0,8856,8856,11.8
28102,Clévilliers,753,0,21941,21941,29.1
29087,Le Juch,753,0,23886,23886,31.7
42073,Cottance,753,350,13649,13999,18.6
52177,Doulaincourt-Saucourt,753,0,11585,11585,15.4
57316,Henriville,753,0,24007,24007,31.9
60160,Conchy-les-Pots,753,0,6583,6583,8.7
65101,Bordes,753,0,4781,4781,6.3
68044,Le Bonhomme,753,0,38452,38452,51.1
69102,Joux,753,0,8900,8900,11.8
76652,Saint-Vaast-d'Équiqueville,753,10153,4763,14916,19.8
79056,Brion-près-Thouet,753,0,11716,11716,15.6
85276,Saint-Vincent-Sterlanges,753,12057,3834,15891,21.1
9339,Villeneuve-du-Paréage,752,0,3386,3386,4.5
11371,Salles-sur-l'Hers,752,0,6608,6608,8.8
12281,Toulonjac,752,0,2193,2193,2.9
22338,Squiffiec,752,0,13466,13466,17.9
41176,Pierrefitte-sur-Sauldre,752,7314,6408,13722,18.2
54059,Belleau,752,0,4450,4450,5.9
62183,Buire-le-Sec,752,0,11906,11906,15.8
63102,Châteldon,752,0,17436,17436,23.2
71330,Neuvy-Grandchamp,752,0,3866,3866,5.1
73141,Laissaud,752,0,13448,13448,17.9
89160,Étigny,752,1600,4997,6597,8.8
25025,Arc-sous-Cicon,751,0,8225,8225,11
28048,La Bourdinière-Saint-Loup,751,0,21883,21883,29.1
34302,Siran,751,13550,2843,16393,21.8
39471,Ruffey-sur-Seille,751,770,19961,20731,27.6
42064,Chuyer,751,0,23046,23046,30.7
51434,Plivot,751,0,14924,14924,19.9
52064,Bourmont-entre-Meuse-et-Mouzon,751,0,11554,11554,15.4
57549,Pontpierre,751,0,34849,34849,46.4
59379,Marcq-en-Ostrevent,751,0,10464,10464,13.9
60560,Rully,751,0,0,0,0
64259,Hélette,751,33531,19515,53046,70.6
70257,Fretigney-et-Velloreille,751,6720,3396,10116,13.5
76656,Saint-Victor-l'Abbaye,751,0,6060,6060,8.1
80163,Cambron,751,0,2291,2291,3.1
80204,Combles,751,0,5381,5381,7.2
80826,Woignarue,751,0,2160,2160,2.9
88082,Celles-sur-Plaine,751,0,7302,7302,9.7
11024,Bages,750,0,11598,11598,15.5
28195,Houx,750,0,21854,21854,29.1
30104,Domessargues,750,0,2762,2762,3.7
30207,Pouzilhac,750,0,2948,2948,3.9
37158,Montreuil-en-Touraine,750,200,20357,20557,27.4
43181,Saint-Étienne-Lardeyrol,750,800,31207,32007,42.7
53144,Marcillé-la-Ville,750,0,27871,27871,37.2
72278,Saint-Denis-d'Orques,750,0,6815,6815,9.1
73269,Saint-Paul-sur-Yenne,750,0,4758,4758,6.3
79147,Largeasse,750,0,21335,21335,28.4
81235,Saint-Affrique-les-Montagnes,750,0,835,835,1.1
22097,La Landec,749,0,19954,19954,26.6
27329,Hennezis,749,0,3936,3936,5.3
27511,Saint-Aubin-d'Écrosville,749,0,3221,3221,4.3
31073,Bondigoux,749,0,0,0,0
38115,Saint-Martin-de-la-Cluze,749,0,20983,20983,28
41007,Authon,749,4395,9264,13659,18.2
50468,Saint-Fromond,749,0,11078,11078,14.8
51161,Condé-sur-Marne,749,0,38070,38070,50.8
56180,Porcaro,749,0,9112,9112,12.2
60632,Thiescourt,749,0,6548,6548,8.7
68325,Steinsoultz,749,3050,20092,23142,30.9
80820,Warloy-Baillon,749,0,99,99,0.1
24212,Issigeac,748,13322,1402,14724,19.7
25494,Rochejean,748,0,44547,44547,59.6
28364,Sancheville,748,0,1376,1376,1.8
33157,Espiet,748,0,14591,14591,19.5
38080,Charancieu,748,0,12707,12707,17
58124,Germigny-sur-Loire,748,0,40232,40232,53.8
64559,Viodos-Abense-de-Bas,748,9450,19437,28887,38.6
78077,La Boissière-École,748,0,1457,1457,1.9
79058,Brûlain,748,0,10081,10081,13.5
86210,Roiffé,748,0,3821,3821,5.1
90057,Lachapelle-sous-Chaux,748,0,22280,22280,29.8
19049,Chasteaux,747,9800,11922,21722,29.1
30122,Gajan,747,0,2751,2751,3.7
68191,Luemschwiller,747,1260,20038,21298,28.5
69245,Ternand,747,0,6732,6732,9
80446,Huppy,747,0,2279,2279,3.1
82127,Montesquieu,747,0,9594,9594,12.8
1094,Chavannes-sur-Reyssouze,746,0,10245,10245,13.7
2049,Barisis-aux-Bois,746,4280,738,5018,6.7
3026,Besson,746,0,10042,10042,13.5
9130,Ganac,746,0,20051,20051,26.9
33170,Fontet,746,0,6074,6074,8.1
37222,Saint-Jean-Saint-Germain,746,23242,12949,36191,48.5
54465,Roville-devant-Bayon,746,0,0,0,0
60676,Ville,746,0,0,0,0
72113,Degré,746,0,14553,14553,19.5
76072,Belleville-en-Caux,746,0,6020,6020,8.1
76682,Sotteville-sous-le-Val,746,0,21308,21308,28.6
77425,Saint-Martin-en-Bière,746,0,6211,6211,8.3
17474,Villeneuve-la-Comtesse,745,0,20751,20751,27.9
29085,Île-Tudy,745,0,27962,27962,37.5
42088,Épercieux-Saint-Paul,745,0,13504,13504,18.1
55158,Dommary-Baroncourt,745,0,13616,13616,18.3
56218,Saint-Gravé,745,0,5279,5279,7.1
59505,Rombies-et-Marchipont,745,0,14352,14352,19.3
68121,Hagenthal-le-Haut,745,0,14480,14480,19.4
68302,Schweighouse-Thann,745,0,12538,12538,16.8
74265,Serraval,745,55390,37844,93234,125.1
88163,Essegney,745,0,18735,18735,25.1
1421,Torcieu,744,0,12697,12697,17.1
8330,Novy-Chevrières,744,0,14228,14228,19.1
17112,La Clisse,744,0,23580,23580,31.7
18231,Saint-Pierre-les-Étieux,744,0,3278,3278,4.4
21639,Tillenay,744,0,0,0,0
27072,Bois-Jérôme-Saint-Ouen,744,0,3909,3909,5.3
38091,Châteauvilain,744,0,9041,9041,12.2
47186,Montesquieu,744,0,3607,3607,4.8
51390,Moussy,744,0,14785,14785,19.9
58055,Champvert,744,0,1919,1919,2.6
63278,Pessat-Villeneuve,744,0,5627,5627,7.6
67459,Schwenheim,744,0,52477,52477,70.5
71297,Mesvres,744,0,16646,16646,22.4
5039,Aubessagne,743,0,49434,49434,66.5
6143,Touët-sur-Var,743,0,16744,16744,22.5
9285,Seix,743,0,90036,90036,121.2
11233,Mirepeisset,743,13285,11490,24775,33.3
27243,Fiquefleur-Équainville,743,0,5552,5552,7.5
31344,Miramont-de-Comminges,743,0,15390,15390,20.7
45230,Noyers,743,0,7618,7618,10.3
48090,Le Malzieu-Ville,743,50485,7632,58117,78.2
60125,Canly,743,0,695,695,0.9
60582,Saint-Léger-aux-Bois,743,0,3775,3775,5.1
62896,Wirwignes,743,0,2145,2145,2.9
69217,Saint-Just-d'Avray,743,0,8782,8782,11.8
85306,Xanton-Chassenon,743,0,11644,11644,15.7
2520,Mont-Notre-Dame,742,0,1463,1463,2
17207,Loix,742,0,45816,45816,61.7
17431,Soulignonne,742,0,18900,18900,25.5
21534,Ruffey-lès-Beaune,742,0,3227,3227,4.3
22122,Laurenan,742,0,0,0,0
22153,Moncontour,742,11312,8956,20268,27.3
40084,Clermont,742,0,11620,11620,15.7
41125,Marcilly-en-Gault,742,0,6191,6191,8.3
47312,Tournon-d'Agenais,742,0,4275,4275,5.8
48070,Grandrieu,742,20450,8739,29189,39.3
56048,Le Croisty,742,0,23717,23717,32
57046,Baerenthal,742,0,17101,17101,23
67135,Ettendorf,742,2350,24936,27286,36.8
71296,Messey-sur-Grosne,742,6899,11381,18280,24.6
2083,Beuvardes,741,0,17128,17128,23.1
4217,Thoard,741,75990,31059,107049,144.5
6162,La Brigue,741,0,4159,4159,5.6
9182,Massat,741,0,89794,89794,121.2
10035,Bayel,741,0,0,0,0
19033,Bugeat,741,14280,12902,27182,36.7
28164,Fresnay-l'Évêque,741,0,3892,3892,5.3
47174,Moncrabeau,741,0,3593,3593,4.8
57212,Féy,741,0,36739,36739,49.6
57554,Pournoy-la-Grasse,741,0,28377,28377,38.3
57748,Wittring,741,0,10127,10127,13.7
72296,Saint-Maixent,741,0,4521,4521,6.1
72357,Thorée-les-Pins,741,0,5372,5372,7.2
73132,Hauteluce,741,0,17479,17479,23.6
1204,Le Poizat-Lalleyriat,740,0,27993,27993,37.8
30164,Méjannes-le-Clap,740,0,30035,30035,40.6
42038,Chalain-le-Comtal,740,0,6630,6630,9
52414,Rachecourt-sur-Marne,740,0,6702,6702,9.1
54586,Viterne,740,0,7536,7536,10.2
59517,Les Rues-des-Vignes,740,0,9619,9619,13
60047,Baron,740,0,2897,2897,3.9
62477,Izel-lès-Hameau,740,0,6149,6149,8.3
64478,Saint-Faust,740,9286,21849,31135,42.1
72303,Saint-Michel-de-Chavaignes,740,0,13833,13833,18.7
76303,Gommerville,740,0,6675,6675,9
3221,Saint-Bonnet-Tronçais,739,0,11618,11618,15.7
5168,Sigoyer,739,0,1048,1048,1.4
11048,Boutenac,739,0,10013,10013,13.5
26140,Geyssans,739,5150,14980,20130,27.2
30159,Le Martinet,739,0,23099,23099,31.3
38098,Chélieu,739,0,6480,6480,8.8
52535,Villiers-le-Sec,739,0,81174,81174,109.8
65083,Bernac-Debat,739,0,7060,7060,9.6
69097,Les Haies,739,0,5686,5686,7.7
73024,Les Avanchers-Valmorel,739,0,159871,159871,216.3
89378,Sauvigny-le-Bois,739,3675,1603,5278,7.1
2610,Pommiers,738,0,6174,6174,8.4
17480,Virson,738,750,30536,31286,42.4
24331,Pomport,738,0,16430,16430,22.3
25288,Fournets-Luisans,738,0,8718,8718,11.8
33320,Petit-Palais-et-Cornemps,738,0,28672,28672,38.9
58109,Entrains-sur-Nohain,738,0,15441,15441,20.9
59087,Boëseghem,738,0,4509,4509,6.1
71564,Vendenesse-lès-Charolles,738,0,2861,2861,3.9
86264,Sommières-du-Clain,738,0,16620,16620,22.5
2180,Chéry-lès-Pouilly,737,0,3713,3713,5
14403,Marolles,737,0,8204,8204,11.1
22236,Pludual,737,0,14926,14926,20.3
23067,La Courtine,737,0,10104,10104,13.7
26341,Serves-sur-Rhône,737,4410,32429,36839,50
28052,Bouglainval,737,0,21475,21475,29.1
33035,Bayon-sur-Gironde,737,0,7543,7543,10.2
33182,Gauriac,737,0,7543,7543,10.2
35164,Marcillé-Raoul,737,0,22592,22592,30.7
38099,Chevrières,737,0,11910,11910,16.2
42185,Rivas,737,5865,13359,19224,26.1
62874,Wanquetin,737,0,6124,6124,8.3
74086,Contamine-Sarzin,737,1950,17801,19751,26.8
77410,Saint-Germain-Laxis,737,13145,10269,23414,31.8
88346,La Petite-Raon,737,0,7165,7165,9.7
95489,Piscop,737,2200,1285,3485,4.7
12167,Najac,736,0,2147,2147,2.9
12217,Sainte-Croix,736,0,2147,2147,2.9
15074,Giou-de-Mamou,736,8748,24937,33685,45.8
23061,Chénérailles,736,0,9662,9662,13.1
36112,Mâron,736,0,27279,27279,37.1
63258,Olliergues,736,8180,6651,14831,20.2
68018,Balschwiller,736,6505,10480,16985,23.1
72130,Fay,736,0,15057,15057,20.5
74156,Lully,736,1550,32043,33593,45.6
76152,Cailly,736,0,503,503,0.7
76706,Tourville-les-Ifs,736,0,4776,4776,6.5
77054,La Brosse-Montceaux,736,0,520,520,0.7
79077,Beugnon-Thireuil,736,0,6066,6066,8.2
25011,Allenjoie,735,0,46528,46528,63.3
29250,Saint-Hernin,735,0,24856,24856,33.8
37279,Villiers-au-Bouin,735,0,6818,6818,9.3
40268,Saint-Laurent-de-Gosse,735,0,20876,20876,28.4
46228,Prudhomat,735,0,23980,23980,32.6
60221,Esquennoy,735,0,16575,16575,22.6
62046,Aubin-Saint-Vaast,735,0,11637,11637,15.8
62456,Houchin,735,0,12129,12129,16.5
63301,Ris,735,0,17041,17041,23.2
72196,Mézières-sur-Ponthouin,735,0,13629,13629,18.5
74202,Nonglard,735,0,3121,3121,4.2
77081,Champdeuil,735,0,697,697,0.9
81093,Florentin,735,0,40383,40383,54.9
2B283,Solaro,734,0,0,0,0
54302,Lantéfontaine,734,0,6815,6815,9.3
78320,Notre-Dame-de-la-Mer,734,0,3752,3752,5.1
79059,Le Busseau,734,0,6050,6050,8.2
17154,Les Essards,733,2280,18671,20951,28.6
28071,Champrond-en-Gâtine,733,0,522,522,0.7
33124,Chamadelle,733,0,14298,14298,19.5
33141,Croignon,733,0,15829,15829,21.6
68132,Helfrantzkirch,733,0,14247,14247,19.4
87095,Meuzac,733,9718,11754,21472,29.3
4172,Roumoules,732,24092,8509,32601,44.5
12209,Saint-Amans-des-Cots,732,0,24804,24804,33.9
16196,Luxé,732,5360,9202,14562,19.9
39252,Gevry,732,1350,14857,16207,22.1
40256,Saint-Étienne-d'Orthe,732,0,5447,5447,7.4
46021,Béduer,732,0,21616,21616,29.5
47102,Francescas,732,0,3549,3549,4.8
50629,Vesly,732,0,15295,15295,20.9
54112,Chambley-Bussières,732,0,4370,4370,6
54250,Haraucourt,732,0,4332,4332,5.9
63149,Entraigues,732,0,5536,5536,7.6
63215,Martres-sur-Morge,732,0,5536,5536,7.6
65031,Arreau,732,35440,35192,70632,96.5
86271,Thurageau,732,2445,38040,40485,55.3
7304,Salavas,731,9054,44637,53691,73.4
10419,Villemoyenne,731,0,12761,12761,17.5
11251,Val-de-Dagne,731,19100,4741,23841,32.6
25015,Amancey,731,0,5327,5327,7.3
2A098,Coti-Chiavari,731,0,547,547,0.7
38311,Pommier-de-Beaurepaire,731,0,18687,18687,25.6
47142,Lauzun,731,0,13613,13613,18.6
50429,Regnéville-sur-Mer,731,0,21151,21151,28.9
65313,Momères,731,0,6984,6984,9.6
70410,Pin,731,0,494,494,0.7
77485,Le Vaudoué,731,0,6086,6086,8.3
78597,Soindres,731,0,6803,6803,9.3
85078,Damvix,731,0,11456,11456,15.7
86198,Pouillé,731,0,43552,43552,59.6
88170,Ferdrupt,731,0,1478,1478,2
19004,Albussac,730,0,2166,2166,3
21071,Bèze,730,0,3180,3180,4.4
27377,Lyons-la-Forêt,730,14640,4803,19443,26.6
28172,Gas,730,0,4236,4236,5.8
29249,Saint-Goazec,730,0,5984,5984,8.2
30271,Saint-Julien-de-Cassagnas,730,0,22818,22818,31.3
38120,La Combe-de-Lancey,730,0,13564,13564,18.6
50332,Les Moitiers-d'Allonne,730,11073,22962,34035,46.6
50364,Muneville-le-Bingard,730,0,21122,21122,28.9
54122,Chaudeney-sur-Moselle,730,0,1523,1523,2.1
57531,Oudrenne,730,0,4677,4677,6.4
57596,Rosbruck,730,0,13345,13345,18.3
61150,Échauffour,730,15120,5277,20397,27.9
61228,L'Orée-d'Écouves,730,5720,21574,27294,37.4
63239,Montmorin,730,0,7002,7002,9.6
76412,Martainville-Épreville,730,0,499,499,0.7
77045,Bougligny,730,0,769,769,1.1
86058,La Chapelle-Moulière,730,1300,43493,44793,61.4
11023,Badens,729,0,4728,4728,6.5
16109,Courbillac,729,1200,50537,51737,71
21297,Gilly-lès-Cîteaux,729,0,3496,3496,4.8
37028,Bossay-sur-Claise,729,4335,12654,16989,23.3
45015,Autruy-sur-Juine,729,0,906,906,1.2
63196,Limons,729,0,2980,2980,4.1
72319,Sainte-Sabine-sur-Longève,729,0,14222,14222,19.5
73176,Montvalezan,729,45750,15488,61238,84
74051,Cercier,729,3800,13106,16906,23.2
77244,Larchant,729,0,373,373,0.5
6021,Bonson,728,0,14333,14333,19.7
22368,Tréméreuc,728,0,24288,24288,33.4
24455,Saint-Martin-de-Ribérac,728,650,5528,6178,8.5
27463,Plasnes,728,0,3139,3139,4.3
28383,Theuville,728,0,21213,21213,29.1
37038,Bréhémont,728,0,11589,11589,15.9
39508,Sellières,728,4500,19350,23850,32.8
40277,Saint-Pandelon,728,0,6232,6232,8.6
53135,Livré-la-Touche,728,0,4819,4819,6.6
57547,Pommérieux,728,0,27879,27879,38.3
67546,Wittersheim,728,0,8852,8852,12.2
68116,Gundolsheim,728,0,71479,71479,98.2
74273,Sixt-Fer-à-Cheval,728,65630,139869,205499,282.3
76597,Saint-Laurent-en-Caux,728,0,1605,1605,2.2
77059,Bussy-Saint-Martin,728,6760,1800,8560,11.8
86237,Saint-Pierre-d'Exideuil,728,0,16394,16394,22.5
1441,Vieu-d'Izenave,727,0,27501,27501,37.8
16152,Gimeux,727,2100,27201,29301,40.3
25188,Dambenois,727,0,46022,46022,63.3
35111,Le Ferré,727,0,8902,8902,12.2
38295,Parmilieu,727,0,3753,3753,5.2
40056,Brocas,727,0,5720,5720,7.9
41109,Landes-le-Gaulois,727,5994,27863,33857,46.6
42328,Verrières-en-Forez,727,0,6514,6514,9
45210,Montbouy,727,0,7454,7454,10.3
50305,Le Mesnil-au-Val,727,0,22867,22867,31.5
50604,Tréauville,727,3020,22867,25887,35.6
68316,Soultzbach-les-Bains,727,0,29183,29183,40.1
87015,Beynac,727,0,338,338,0.5
89321,Ravières,727,11820,1689,13509,18.6
8096,Chalandry-Elaire,726,0,16677,16677,23
16329,Saint-Laurent-de-Céris,726,6190,14937,21127,29.1
19134,Merlines,726,0,9953,9953,13.7
35028,Boistrudan,726,0,14133,14133,19.5
62191,Caffiers,726,0,4444,4444,6.1
62568,Mercatel,726,0,20420,20420,28.1
63388,Saint-Priest-des-Champs,726,0,1127,1127,1.6
71052,Boyer,726,0,8795,8795,12.1
71209,Frontenaud,726,0,2989,2989,4.1
79251,Marcillé,726,0,20967,20967,28.9
81117,Labessière-Candeil,726,0,39888,39888,54.9
1429,Vandeins,725,0,14016,14016,19.3
14753,Villers-Canivet,725,0,11357,11357,15.7
16224,Montmérac,725,4640,38767,43407,59.9
25350,Lougres,725,0,45895,45895,63.3
27104,Bourg-Beaudouin,725,0,4770,4770,6.6
27179,Courbépine,725,0,3126,3126,4.3
27700,Vraiville,725,0,21500,21500,29.7
38338,La Rivière,725,0,11716,11716,16.2
52099,Chamouilley,725,0,6566,6566,9.1
58085,Corvol-l'Orgueilleux,725,0,15169,15169,20.9
59264,Gognies-Chaussée,725,0,25861,25861,35.7
60032,Autrêches,725,0,4911,4911,6.8
60060,Belle-Église,725,1250,3011,4261,5.9
61133,Courtomer,725,13776,256,14032,19.4
63413,La Sauvetat,725,0,12996,12996,17.9
67030,Bergbieten,725,5700,39376,45076,62.2
73082,La Chavanne,725,0,12965,12965,17.9
80082,Belloy-sur-Somme,725,0,1248,1248,1.7
85102,Grand'Landes,725,0,6191,6191,8.5
15006,Anglards-de-Salers,724,20620,11987,32607,45
15027,Puycapel,724,19210,6348,25558,35.3
16382,Torsac,724,0,18823,18823,26
17266,Les Nouillers,724,0,20167,20167,27.9
21247,Époisses,724,0,15374,15374,21.2
23089,Genouillac,724,0,1947,1947,2.7
38010,Annoisin-Chatelans,724,0,3738,3738,5.2
39022,Asnans-Beauvoisin,724,5230,4288,9518,13.1
54505,Sexey-aux-Forges,724,0,7373,7373,10.2
56065,Gourhel,724,0,10902,10902,15.1
60682,Villers-Saint-Frambourg-Ognon,724,0,0,0,0
62642,Ourton,724,0,11948,11948,16.5
63045,Bort-l'Étang,724,0,3326,3326,4.6
64021,Andoins,724,5250,7557,12807,17.7
66045,Catllar,724,0,21684,21684,30
71027,Beaurepaire-en-Bresse,724,0,1354,1354,1.9
77308,Montgé-en-Goële,724,0,550,550,0.8
80137,Breilly,724,0,1246,1246,1.7
88216,Grandvillers,724,0,950,950,1.3
91412,Mondeville,724,0,25225,25225,34.8
17293,Puyravault,723,2173,29916,32089,44.4
27333,Heudicourt,723,6050,589,6639,9.2
35061,La Chapelle-Erbrée,723,0,10862,10862,15
41144,Monteaux,723,0,27710,27710,38.3
52469,Semoutiers-Montsaon,723,0,79416,79416,109.8
69252,Trèves,723,0,5563,5563,7.7
77501,Villecerf,723,0,2515,2515,3.5
80686,Rubempré,723,0,2818,2818,3.9
81311,Vénès,723,0,10813,10813,15
2264,Dizy-le-Gros,722,0,7955,7955,11
9015,Arignac,722,0,2787,2787,3.9
18211,Saint-Georges-sur-Moulon,722,0,5472,5472,7.6
22026,Calorguen,722,0,19234,19234,26.6
27655,Tourville-sur-Pont-Audemer,722,0,16309,16309,22.6
2B077,Castellare-di-Casinca,722,0,3343,3343,4.6
32001,Aignan,722,0,7227,7227,10
41140,Millançay,722,0,6025,6025,8.3
46100,Faycelles,722,0,21321,21321,29.5
57150,Condé-Northen,722,0,4348,4348,6
59312,Honnecourt-sur-Escaut,722,0,9385,9385,13
62678,Quesques,722,0,2085,2085,2.9
67558,Zinswiller,722,450,26441,26891,37.2
71200,Fleury-la-Montagne,722,0,20461,20461,28.3
77201,Gastins,722,0,9295,9295,12.9
81230,Rosières,722,0,16518,16518,22.9
1284,Ozan,721,0,9902,9902,13.7
23235,Saint-Priest-la-Feuille,721,0,13646,13646,18.9
28047,Boisville-la-Saint-Père,721,0,21009,21009,29.1
38240,Moissieu-sur-Dolon,721,0,18431,18431,25.6
41128,Marolles,721,0,27633,27633,38.3
52083,Champsevraine,721,0,14220,14220,19.7
53116,Le Horps,721,0,26793,26793,37.2
59219,Estrun,721,0,9372,9372,13
63138,Dorat,721,0,16717,16717,23.2
81098,Fréjeville,721,0,10784,10784,15
84134,Travaillan,721,0,0,0,0
86284,Vernon,721,4800,16473,21273,29.5
90045,Fêche-l'Église,721,0,4288,4288,5.9
95365,Mareil-en-France,721,0,4169,4169,5.8
1212,Lescheroux,720,0,13919,13919,19.3
2073,Berry-au-Bac,720,0,1937,1937,2.7
9244,Rieucros,720,0,14914,14914,20.7
23112,Lourdoueix-Saint-Pierre,720,0,1937,1937,2.7
26360,Valaurie,720,0,19384,19384,26.9
29183,Plouégat-Moysan,720,0,43171,43171,60
46176,Livernon,720,0,21262,21262,29.5
56195,La Roche-Bernard,720,0,6856,6856,9.5
57561,Rahling,720,0,16594,16594,23
60668,Verderel-lès-Sauqueuse,720,0,28233,28233,39.2
68366,Wickerschwihr,720,2809,14797,17606,24.5
76266,Flocques,720,0,2071,2071,2.9
79295,Saint-Romans-lès-Melle,720,0,20794,20794,28.9
83041,Claviers,720,0,8969,8969,12.5
91204,Écharcon,720,0,1058,1058,1.5
2B162,Moltifao,719,0,2703,2703,3.8
30287,Saint-Michel-d'Euzet,719,0,10492,10492,14.6
34047,Campagnan,719,0,3884,3884,5.4
38492,Sinard,719,0,20142,20142,28
49131,Épieds,719,1821,7005,8826,12.3
61287,Montilly-sur-Noireau,719,2400,19257,21657,30.1
68153,Illhaeusern,719,0,1719,1719,2.4
68360,Weckolsheim,719,300,12479,12779,17.8
81043,Busque,719,0,39504,39504,54.9
88118,Coussey,719,0,8032,8032,11.2
89264,Montacher-Villegardin,719,16689,2551,19240,26.8
95459,Nucourt,719,9750,33035,42785,59.5
16408,Villebois-Lavalette,718,8560,33762,42322,58.9
53037,Bouessay,718,0,16698,16698,23.3
57512,Nouilly,718,0,35599,35599,49.6
60680,Villeneuve-sur-Verberie,718,0,1049,1049,1.5
86190,Persac,718,0,29040,29040,40.4
1029,Beaupont,717,0,13861,13861,19.3
16143,Fouquebrune,717,3200,33715,36915,51.5
17128,Courcoury,717,0,22724,22724,31.7
19248,Saint-Ybard,717,0,0,0,0
21265,Fixin,717,0,3438,3438,4.8
24515,Salagnac,717,5275,9015,14290,19.9
25198,Désandans,717,0,1654,1654,2.3
59161,Crèvecœur-sur-l'Escaut,717,0,9320,9320,13
59354,Loffre,717,0,8622,8622,12
61297,Moulins-la-Marche,717,18751,7391,26142,36.5
62647,Le Parcq,717,0,11352,11352,15.8
66165,Rodès,717,0,967,967,1.3
69020,Belmont-d'Azergues,717,0,6462,6462,9
74074,Chevrier,717,16961,2810,19771,27.6
85033,Bourneau,717,5516,4704,10220,14.3
5136,Saint-Crépin,716,0,23278,23278,32.5
21505,Précy-sous-Thil,716,0,15204,15204,21.2
22174,Pléboulle,716,0,19075,19075,26.6
25482,Recologne,716,0,484,484,0.7
35198,Moulins,716,0,10757,10757,15
42301,Soleymieux,716,0,6415,6415,9
46149,Lamagdelaine,716,0,6046,6046,8.4
51202,Cumières,716,0,14229,14229,19.9
68167,Kirchberg,716,0,15023,15023,21
81305,Vabre,716,0,6689,6689,9.3
1259,Montcet,715,0,13823,13823,19.3
1453,Arvière-en-Valromey,715,0,7969,7969,11.1
10156,Fontvannes,715,0,10210,10210,14.3
11261,Moux,715,0,9687,9687,13.5
15168,Ruynes-en-Margeride,715,12066,15815,27881,39
16276,Reignac,715,3830,38232,42062,58.8
17015,Arces,715,1020,11260,12280,17.2
17269,Orignolles,715,0,8443,8443,11.8
23154,Pionnat,715,0,10747,10747,15
24042,Biras,715,500,10073,10573,14.8
24143,Couze-et-Saint-Front,715,3392,2598,5990,8.4
24526,Savignac-Lédrier,715,10565,8990,19555,27.3
56199,Roudouallec,715,0,22854,22854,32
59577,Staple,715,0,4368,4368,6.1
60317,Hondainville,715,0,2970,2970,4.2
62269,Diéval,715,0,11799,11799,16.5
63285,Pontgibaud,715,0,24178,24178,33.8
76361,Heuqueville,715,0,6449,6449,9
80124,Bourseville,715,0,4754,4754,6.6
80463,Lamotte-Warfusée,715,0,94,94,0.1
2710,Seraucourt-le-Grand,714,0,102047,102047,142.9
3220,Saint-Bonnet-de-Rochefort,714,0,14604,14604,20.5
16220,Les Métairies,714,3720,26715,30435,42.6
23257,Vallière,714,0,27003,27003,37.8
25442,Oye-et-Pallet,714,0,42523,42523,59.6
32279,Montaut-les-Créneaux,714,0,25158,25158,35.2
34229,Riols,714,9197,2703,11900,16.7
47081,Dolmayrac,714,0,5472,5472,7.7
47228,Saint-Antoine-de-Ficalba,714,0,5472,5472,7.7
57201,Etting,714,0,16455,16455,23
63469,Vollore-Ville,714,12954,16554,29508,41.3
66067,Err,714,0,0,0,0
70184,Couthenans,714,0,4663,4663,6.5
70581,Vy-lès-Lure,714,0,31386,31386,44
76199,Criquiers,714,0,13,13,0
80247,Dompierre-Becquincourt,714,0,12922,12922,18.1
86148,Marnay,714,0,16313,16313,22.8
89155,Escolives-Sainte-Camille,714,4961,13968,18929,26.5
10223,Marcilly-le-Hayer,713,0,0,0,0
11344,Saint-Hilaire,713,0,9385,9385,13.2
15202,Saint-Martin-Valmeroux,713,5800,11805,17605,24.7
17052,Boisredon,713,0,8419,8419,11.8
23035,Budelière,713,0,10717,10717,15
23149,Parsac-Rimondeix,713,0,10717,10717,15
27432,La Neuville-du-Bosc,713,0,3074,3074,4.3
30053,Brignon,713,0,22287,22287,31.3
37134,Louans,713,3260,12377,15637,21.9
40006,Arengosse,713,0,10188,10188,14.3
47214,Puch-d'Agenais,713,0,6850,6850,9.6
54214,Frolois,713,15950,7261,23211,32.6
55079,Brillon-en-Barrois,713,0,13936,13936,19.5
56093,Kergrist,713,10479,4964,15443,21.7
76203,Croix-Mare,713,0,1319,1319,1.8
80284,Esmery-Hallon,713,0,13590,13590,19.1
17318,Saint-Clément-des-Baleines,712,0,43964,43964,61.7
19015,Ayen,712,0,11363,11363,16
49070,Chanteloup-les-Bois,712,17352,29586,46938,65.9
63049,Bouzel,712,0,6829,6829,9.6
70224,Étuz,712,0,5963,5963,8.4
76472,Notre-Dame-d'Aliermont,712,0,4503,4503,6.3
77104,Châtres,712,0,3618,3618,5.1
89197,Guillon-Terre-Plaine,712,3720,3437,7157,10.1
2303,Fayet,711,0,101618,101618,142.9
8276,Margut,711,0,25172,25172,35.4
10141,Essoyes,711,0,12411,12411,17.5
12262,Sauveterre-de-Rouergue,711,0,21761,21761,30.6
22071,Guitté,711,0,18941,18941,26.6
30129,Générargues,711,0,22224,22224,31.3
31366,Montbrun-Lauragais,711,0,11592,11592,16.3
37177,Orbigny,711,9852,12342,22194,31.2
45137,Escrennes,711,0,884,884,1.2
57654,Silly-sur-Nied,711,0,1731,1731,2.4
57762,Zimming,711,0,32993,32993,46.4
59115,Brunémont,711,0,9907,9907,13.9
62680,Quiéry-la-Motte,711,0,885,885,1.2
67455,Schœnenbourg,711,0,19591,19591,27.6
68241,Oberentzen,711,0,5611,5611,7.9
70219,Esprels,711,0,225,225,0.3
89152,Épineau-les-Voves,711,0,24849,24849,34.9
2014,Amigny-Rouy,710,0,12757,12757,18
2111,Brancourt-en-Laonnois,710,0,703,703,1
9329,Vernajoul,710,0,19083,19083,26.9
14747,Vieux,710,0,1256,1256,1.8
18150,Méry-sur-Cher,710,7500,10258,17758,25
18247,Savigny-en-Septaine,710,0,3272,3272,4.6
24268,Meyrals,710,4580,34755,39335,55.4
24330,Plazac,710,6830,9856,16686,23.5
27233,Fatouville-Grestain,710,0,5305,5305,7.5
36042,Chasseneuil,710,0,5213,5213,7.3
42320,Valfleury,710,0,16635,16635,23.4
53133,Lignières-Orgères,710,0,6314,6314,8.9
64306,Lahourcade,710,0,19118,19118,26.9
76131,La Bouille,710,0,20280,20280,28.6
1081,Champfromier,709,0,8538,8538,12
14760,Villy-Bocage,709,0,26291,26291,37.1
18067,Clémont,709,6277,0,6277,8.9
29267,Saint-Thois,709,0,5811,5811,8.2
2A276,Serra-di-Ferro,709,0,531,531,0.7
42091,Estivareilles,709,0,6352,6352,9
62036,Anvin,709,0,15317,15317,21.6
62623,Nouvelle-Église,709,0,5381,5381,7.6
68207,Michelbach-le-Bas,709,0,13781,13781,19.4
72268,Saint-Biez-en-Belin,709,0,1481,1481,2.1
76087,Berville-en-Caux,709,2250,1563,3813,5.4
81076,Cuq-Toulza,709,0,789,789,1.1
5128,Saint-André-d'Embrun,708,0,56577,56577,79.9
10399,Vaudes,708,0,12359,12359,17.5
17113,La Clotte,708,0,8360,8360,11.8
22075,Hémonstoir,708,0,0,0,0
40111,Geloux,708,2845,8762,11607,16.4
59403,Millonfosse,708,0,26635,26635,37.6
60364,Lieuvillers,708,14565,3923,18488,26.1
63219,Mazaye,708,0,2216,2216,3.1
63319,Saint-Anthème,708,7770,6398,14168,20
67498,Uhrwiller,708,0,8609,8609,12.2
70085,Boult,708,0,5930,5930,8.4
71032,Berzé-la-Ville,708,6877,18084,24961,35.3
74054,Chainaz-les-Frasses,708,0,5469,5469,7.7
87199,Vayres,708,2608,15484,18092,25.6
2309,Festieux,707,0,27000,27000,38.2
3080,Cognat-Lyonne,707,0,19368,19368,27.4
8353,Rancennes,707,0,4539,4539,6.4
18280,Vignoux-sous-les-Aix,707,0,5358,5358,7.6
19068,Dampniat,707,0,11284,11284,16
21586,Saulon-la-Rue,707,0,3390,3390,4.8
27023,Aulnay-sur-Iton,707,0,6290,6290,8.9
30279,Saint-Laurent-la-Vernède,707,0,5433,5433,7.7
37068,Chemillé-sur-Dême,707,0,7847,7847,11.1
37108,Ferrière-sur-Beaulieu,707,14750,12272,27022,38.2
38372,Saint-Bueil,707,0,12011,12011,17
39574,Villevieux,707,1750,18791,20541,29.1
46009,Assier,707,0,20878,20878,29.5
47216,Puymiclan,707,0,7315,7315,10.3
50231,Hauteville-sur-Mer,707,0,20456,20456,28.9
72232,Notre-Dame-du-Pé,707,0,16443,16443,23.3
73063,Cevins,707,0,16677,16677,23.6
76342,Hattenville,707,0,5388,5388,7.6
90102,Vescemont,707,0,21059,21059,29.8
7185,Préaux,706,4590,1996,6586,9.3
8211,Haraucourt,706,0,24995,24995,35.4
11220,Marseillette,706,0,4579,4579,6.5
24030,Beauregard-de-Terrasson,706,8360,12347,20707,29.3
36060,Crevant,706,0,2052,2052,2.9
40128,Horsarrieu,706,0,16311,16311,23.1
46263,Barguelonne-en-Quercy,706,0,17354,17354,24.6
61078,Cerisy-Belle-Étoile,706,2100,18909,21009,29.8
61165,La Ferrière-Bochard,706,3200,20865,24065,34.1
64343,Limendous,706,110,7370,7480,10.6
76227,Ectot-l'Auber,706,0,1556,1556,2.2
95287,Grisy-les-Plâtres,706,13470,32438,45908,65
10089,Châtres,705,0,725,725,1
17143,Le Douhet,705,0,22344,22344,31.7
19180,Saint-Angel,705,0,9665,9665,13.7
36146,Orsennes,705,0,2049,2049,2.9
42079,Cuinzier,705,0,18291,18291,25.9
42201,Saint-Appolinard,705,0,21634,21634,30.7
44148,Ruffigné,705,0,11824,11824,16.8
54572,Ville-Houdlémont,705,0,8950,8950,12.7
57315,Henridorff,705,0,1415,1415,2
59337,Lederzeele,705,0,13578,13578,19.3
72316,Saint-Rémy-des-Monts,705,0,13073,13073,18.5
1124,Cormoz,704,0,13610,13610,19.3
7241,Saint-Germain,704,3076,21837,24913,35.4
10164,Gélannes,704,0,7195,7195,10.2
16186,Lignières-Ambleville,704,8500,26341,34841,49.5
27127,Canappeville,704,0,3028,3028,4.3
31535,Sauveterre-de-Comminges,704,0,6739,6739,9.6
71009,Anost,704,0,15751,15751,22.4
74079,Les Clefs,704,0,35761,35761,50.8
80166,Canaples,704,0,1211,1211,1.7
30100,Cruviers-Lascours,703,0,21974,21974,31.3
47234,Saint-Caprais-de-Lerm,703,0,16093,16093,22.9
52490,Thonnance-lès-Joinville,703,0,2604,2604,3.7
64502,Sames,703,11610,18268,29878,42.5
67293,Minversheim,703,12714,23625,36339,51.7
69039,Chamelet,703,0,6335,6335,9
72167,Louailles,703,0,16349,16349,23.3
27340,Honguemare-Guenouville,702,0,2876,2876,4.1
27565,Le Lesme,702,0,19743,19743,28.1
45238,Ousson-sur-Loire,702,0,8172,8172,11.6
50345,Monthuchon,702,0,20312,20312,28.9
54128,Choloy-Ménillot,702,0,1464,1464,2.1
54350,Marainviller,702,0,3102,3102,4.4
55123,Les Hauts-de-Chée,702,0,9503,9503,13.5
57344,Imling,702,0,4570,4570,6.5
79231,Romans,702,0,3902,3902,5.6
87078,Javerdat,702,6839,15353,22192,31.6
21559,Sainte-Marie-sur-Ouche,701,0,3942,3942,5.6
26225,Parnans,701,600,14210,14810,21.1
33476,Saint-Seurin-de-Cadourne,701,0,6163,6163,8.8
73117,Fourneaux,701,0,12386,12386,17.7
74073,Chevenoz,701,12938,36319,49257,70.3
74165,Marigny-Saint-Marcel,701,0,9493,9493,13.5
76754,Yport,701,0,4549,4549,6.5
80578,Moyenneville,701,0,4661,4661,6.6
86001,Adriers,701,13397,28352,41749,59.6
89094,Chaumot,701,5340,2487,7827,11.2
11273,Paraza,700,0,9484,9484,13.5
22341,Tramain,700,9392,8449,17841,25.5
32286,Montestruc-sur-Gers,700,0,397,397,0.6
35155,Lohéac,700,0,6317,6317,9
37098,Draché,700,13127,12151,25278,36.1
37201,Rivière,700,0,38422,38422,54.9
45153,Germigny-des-Prés,700,0,4100,4100,5.9
60658,Vauciennes,700,0,2741,2741,3.9
62138,Blangy-sur-Ternoise,700,0,11083,11083,15.8
63426,Tauves,700,0,2191,2191,3.1
66027,La Cabanasse,700,0,0,0,0
66162,Rigarda,700,0,20965,20965,30
73206,Pralognan-la-Vanoise,700,715601,4190,719791,1028.3
78499,Ponthévrard,700,0,1364,1364,1.9
16226,Montignac-Charente,699,4910,0,4910,7
17025,Aumagne,699,0,19470,19470,27.9
17235,Migron,699,4853,22154,27007,38.6
27069,Bois-Arnault,699,0,19659,19659,28.1
28275,Néron,699,0,4056,4056,5.8
37025,Berthenay,699,16700,8270,24970,35.7
57445,Marieulles,699,0,34657,34657,49.6
60332,Labruyère,699,0,293,293,0.4
64042,Argagnon,699,0,18821,18821,26.9
69111,Légny,699,1230,6299,7529,10.8
70149,Chenebier,699,0,4565,4565,6.5
76717,Val-de-la-Haye,699,0,19966,19966,28.6
80162,Caix,699,0,12651,12651,18.1
80619,Pernois,699,0,1203,1203,1.7
89324,Rogny-les-Sept-Écluses,699,4632,31562,36194,51.8
14582,Saint-Germain-de-Livet,698,0,7770,7770,11.1
17348,Saint-Jean-d'Angle,698,443,11494,11937,17.1
45039,Bonnée,698,0,4088,4088,5.9
57165,Dalem,698,0,4204,4204,6
59370,Mairieux,698,0,24898,24898,35.7
63364,Saint-Jean-d'Heurs,698,0,3207,3207,4.6
65183,Galan,698,0,2085,2085,3
76587,Sainte-Hélène-Bondeville,698,0,4529,4529,6.5
82148,Puylaroque,698,0,20638,20638,29.6
3189,Montvicq,697,0,24900,24900,35.7
9280,Saurat,697,0,2691,2691,3.9
10114,Crancey,697,0,7123,7123,10.2
14346,Juaye-Mondaye,697,0,26864,26864,38.5
14591,Aure sur Mer,697,0,4825,4825,6.9
33251,Louchats,697,0,7128,7128,10.2
40095,Estibeaux,697,0,5187,5187,7.4
40235,Poyanne,697,0,10916,10916,15.7
52294,Louvemont,697,0,6312,6312,9.1
57199,Escherange,697,0,16969,16969,24.3
57750,Wœlfling-lès-Sarreguemines,697,0,9526,9526,13.7
59075,Béthencourt,697,0,4789,4789,6.9
59396,Mecquignies,697,0,1967,1967,2.8
67240,Kirchheim,697,1170,37856,39026,56
72212,Moulins-le-Carbonnel,697,0,32808,32808,47.1
76163,Catenay,697,0,476,476,0.7
77329,Nanteau-sur-Lunain,697,0,2424,2424,3.5
78050,Bazoches-sur-Guyonne,697,0,301,301,0.4
1188,Illiat,696,0,3593,3593,5.2
3163,Mariol,696,0,19067,19067,27.4
10442,Voué,696,0,592,592,0.9
19289,Yssandon,696,0,11108,11108,16
27477,Pressagny-l'Orgueilleux,696,0,3657,3657,5.3
31144,Cierp-Gaud,696,0,6662,6662,9.6
51101,Caurel,696,0,12369,12369,17.8
55253,Les Islettes,696,0,7277,7277,10.5
62728,Rumaucourt,696,0,866,866,1.2
65032,Arrens-Marsous,696,0,28500,28500,40.9
87176,Saint-Priest-Ligoure,696,7200,9434,16634,23.9
89059,Bussy-en-Othe,696,720,5455,6175,8.9
90094,Sevenans,696,2550,24282,26832,38.6
2701,Saulchery,695,0,378,378,0.5
4135,Moustiers-Sainte-Marie,695,160000,29131,189131,272.1
17486,La Brée-les-Bains,695,0,75285,75285,108.3
32433,Simorre,695,0,8828,8828,12.7
34268,Saint-Jean-de-la-Blaquière,695,0,7806,7806,11.2
52292,Longeau-Percey,695,0,8608,8608,12.4
54537,Ugny,695,0,6489,6489,9.3
59108,Briastre,695,0,4775,4775,6.9
59446,Oisy,695,0,26146,26146,37.6
59597,Tilloy-lez-Cambrai,695,0,9034,9034,13
64010,Aïcirits-Camou-Suhast,695,0,18060,18060,26
67188,Heiligenberg,695,4165,1791,5956,8.6
67257,Lampertsloch,695,0,16816,16816,24.2
70256,Fresse,695,0,7994,7994,11.5
71248,Lacrost,695,0,16174,16174,23.3
72157,Lavardin,695,0,13559,13559,19.5
76658,Saint-Vincent-Cramesnil,695,4860,6269,11129,16
76708,Toussaint,695,0,4510,4510,6.5
81026,Bellegarde-Marsal,695,0,8743,8743,12.6
82057,Fabas,695,0,9327,9327,13.4
84112,Saint-Martin-de-Castillon,695,0,14167,14167,20.4
9199,Montaut,694,0,3125,3125,4.5
14700,Tour-en-Bessin,694,0,4804,4804,6.9
17099,Chepniers,694,0,8195,8195,11.8
18270,Vallenay,694,0,12563,12563,18.1
38324,Primarette,694,0,17741,17741,25.6
43194,Saint-Hostien,694,3170,28877,32047,46.2
46003,Alvignac,694,0,22642,22642,32.6
50509,Sainte-Marie-du-Mont,694,0,3761,3761,5.4
50556,Sainte-Suzanne-sur-Vire,694,0,10264,10264,14.8
63071,Ceyssat,694,0,2172,2172,3.1
63372,Saint-Laure,694,0,5248,5248,7.6
68268,Retzwiller,694,0,9882,9882,14.2
74190,Morillon,694,71145,133337,204482,294.6
1228,Maillat,693,0,26215,26215,37.8
9331,Le Vernet,693,0,3120,3120,4.5
41039,La Chapelle-Saint-Martin-en-Plaine,693,0,2087,2087,3
50092,Cambernon,693,0,20051,20051,28.9
50588,Tamerville,693,0,21798,21798,31.5
55467,Sampigny,693,0,10212,10212,14.7
57466,Metzing,693,0,12669,12669,18.3
57623,Saint-Quirin,693,0,4512,4512,6.5
73097,Curienne,693,0,8809,8809,12.7
76007,Anceaumeville,693,0,474,474,0.7
80187,La Chaussée-Tirancourt,693,0,1193,1193,1.7
89390,Serbonnes,693,4840,128,4968,7.2
91081,Boissy-le-Sec,693,0,1745,1745,2.5
3252,Saint-Pont,692,0,18957,18957,27.4
24224,Lamonzie-Montastruc,692,220,15405,15625,22.6
24564,Vanxains,692,6600,5255,11855,17.1
26145,Les Granges-Gontardes,692,0,10699,10699,15.5
34314,Le Triadou,692,4800,12894,17694,25.6
39462,Rochefort-sur-Nenon,692,25542,14045,39587,57.2
47041,Bruch,692,0,3355,3355,4.8
47140,Laugnac,692,0,6648,6648,9.6
70260,Frotey-lès-Lure,692,0,30419,30419,44
71557,Varenne-Saint-Germain,692,0,2683,2683,3.9
72020,Avezé,692,0,4222,4222,6.1
73258,Saint-Martin-de-la-Porte,692,0,19143,19143,27.7
77401,Sainte-Aulde,692,0,2695,2695,3.9
77474,Trilbardou,692,3000,9437,12437,18
77515,Villeroy,692,0,526,526,0.8
80364,Friaucourt,692,0,1990,1990,2.9
2339,Gandelu,691,0,15972,15972,23.1
22304,Saint-Jean-Kerdaniel,691,0,13994,13994,20.3
24220,Lacropte,691,1235,3859,5094,7.4
27457,Piseux,691,0,19434,19434,28.1
35030,La Bosse-de-Bretagne,691,0,10057,10057,14.6
37057,La Chapelle-Blanche-Saint-Martin,691,4980,11995,16975,24.6
40250,Saint-Avit,691,0,8552,8552,12.4
45321,Thimory,691,0,7085,7085,10.3
49341,Souzay-Champigny,691,14480,6732,21212,30.7
51333,Ludes,691,0,12280,12280,17.8
53049,Châlons-du-Maine,691,0,30072,30072,43.5
59242,Fontaine-au-Bois,691,0,1950,1950,2.8
76348,Hautot-Saint-Sulpice,691,0,1278,1278,1.8
78261,Gaillon-sur-Montcient,691,0,6431,6431,9.3
26177,Marsaz,690,2086,30361,32447,47
41060,Cormenon,690,8397,20609,29006,42
59453,Oudezeele,690,0,4216,4216,6.1
71382,Saint-Agnan,690,0,2675,2675,3.9
73232,Sainte-Foy-Tarentaise,690,108580,14660,123240,178.6
80177,Cartigny,690,0,4944,4944,7.2
81195,Navès,690,0,7258,7258,10.5
87018,Blond,690,6270,11744,18014,26.1
87051,La Croisille-sur-Briance,690,6660,321,6981,10.1
2524,Mont-Saint-Père,689,0,15926,15926,23.1
4046,Le Chaffaut-Saint-Jurson,689,6952,28879,35831,52
16018,Ars,689,3400,25779,29179,42.3
17038,Bedenac,689,0,8136,8136,11.8
29290,Tréglonou,689,9115,5395,14510,21.1
31377,Montgaillard-Lauragais,689,0,3361,3361,4.9
50023,Auvers,689,0,3734,3734,5.4
51530,Sept-Saulx,689,0,12245,12245,17.8
57341,Hunting,689,0,9918,9918,14.4
63108,Le Cheix,689,0,5211,5211,7.6
67085,Dangolsheim,689,5496,37421,42917,62.3
71239,Issy-l'Évêque,689,0,3542,3542,5.1
76286,Fresnoy-Folny,689,0,5085,5085,7.4
1015,Arboys en Bugey,688,0,7668,7668,11.1
2756,Urvillers,688,7300,0,7300,10.6
6042,Clans,688,0,13545,13545,19.7
19117,Lissac-sur-Couze,688,10513,10980,21493,31.2
21656,Varanges,688,0,16,16,0
22083,Illifaut,688,0,0,0,0
24135,Cornille,688,2175,3842,6017,8.7
30114,Fontanès,688,1920,51180,53100,77.2
33194,Grézillac,688,0,4801,4801,7
34313,Tressan,688,0,3716,3716,5.4
45066,Chailly-en-Gâtinais,688,0,7054,7054,10.3
52017,Arc-en-Barrois,688,0,3772,3772,5.5
74050,Burdignin,688,0,11053,11053,16.1
76036,Auppegard,688,0,5552,5552,8.1
78564,Saint-Martin-de-Bréthencourt,688,0,1340,1340,1.9
87036,Champsac,688,3980,303,4283,6.2
1367,Saint-Julien-sur-Reyssouze,687,0,13281,13281,19.3
17084,Champagnolles,687,0,8112,8112,11.8
22181,Plélauff,687,0,63264,63264,92.1
23032,Boussac-Bourg,687,0,10326,10326,15
26115,Divajeu,687,2000,8322,10322,15
31416,Peyssies,687,0,1181,1181,1.7
43042,Cayres,687,8550,3330,11880,17.3
44218,Villepot,687,0,11522,11522,16.8
58246,Saint-Honoré-les-Bains,687,0,35436,35436,51.6
59138,Cattenières,687,0,4721,4721,6.9
76330,Gruchet-Saint-Siméon,687,0,5544,5544,8.1
2618,Prémont,686,0,6215,6215,9.1
7097,Glun,686,0,30185,30185,44
8248,Launois-sur-Vence,686,0,15046,15046,21.9
15118,Marmanhac,686,5015,23243,28258,41.2
15156,Prunet,686,8150,6015,14165,20.6
17244,Montpellier-de-Médillan,686,1890,11428,13318,19.4
25473,Pugey,686,660,12087,12747,18.6
27043,Les Baux-de-Breteuil,686,0,19293,19293,28.1
42012,Bard,686,0,6146,6146,9
42096,Fontanès,686,0,16073,16073,23.4
47131,Lagupie,686,0,7097,7097,10.3
62289,Écuires,686,0,7298,7298,10.6
62788,Seninghem,686,0,1484,1484,2.2
67109,Durningen,686,3420,13052,16472,24
71261,Loisy,686,0,3998,3998,5.8
80621,Hypercourt,686,0,12415,12415,18.1
82093,Larrazet,686,0,16081,16081,23.4
1167,Garnerans,685,0,3536,3536,5.2
12164,Mur-de-Barrez,685,0,23212,23212,33.9
18258,Sury-en-Vaux,685,0,12341,12341,18
21067,Bessey-lès-Cîteaux,685,0,15,15,0
26213,Moras-en-Valloire,685,7420,11276,18696,27.3
27338,Les Hogues,685,0,4507,4507,6.6
27372,Longchamps,685,0,558,558,0.8
35022,Bécherel,685,0,35102,35102,51.2
39182,Crissey,685,110,13903,14013,20.5
56062,Gâvres,685,0,15493,15493,22.6
73219,Saint-Alban-de-Montbel,685,0,35092,35092,51.2
79253,Saint-Georges-de-Noisné,685,0,5646,5646,8.2
1255,Montagnieu,684,0,11673,11673,17.1
2514,Montigny-Lengrain,684,0,658,658,1
7115,Labeaume,684,15991,41767,57758,84.4
14193,Courtonne-la-Meurdrac,684,0,7614,7614,11.1
17404,Saint-Simon-de-Pellouaille,684,1750,11395,13145,19.2
19080,Eygurande,684,0,9377,9377,13.7
28187,Guainville,684,0,915,915,1.3
29054,La Feuillée,684,0,35560,35560,52
29122,Laz,684,0,5607,5607,8.2
30237,Saint-Brès,684,0,27762,27762,40.6
42216,Saint-Denis-sur-Coise,684,0,34283,34283,50.1
50289,Marchésieux,684,0,14292,14292,20.9
50411,Ponts,684,0,16829,16829,24.6
68248,Oltingue,684,4200,18348,22548,33
77520,Villiers-sous-Grez,684,0,350,350,0.5
85174,Petosse,684,5650,4488,10138,14.8
2598,Pernant,683,0,657,657,1
2746,Travecy,683,0,12272,12272,18
17322,Saint-Cyr-du-Doret,683,0,9951,9951,14.6
17455,La Vallée,683,2670,17398,20068,29.4
28213,Lormaye,683,0,3963,3963,5.8
29251,Saint-Jean-du-Doigt,683,0,40952,40952,60
39078,Brevans,683,1530,13862,15392,22.5
42205,Saint-Bonnet-le-Courreau,683,0,6119,6119,9
42288,Saint-Sixte,683,0,6119,6119,9
46118,Gignac,683,0,22283,22283,32.6
47241,Saint-Eutrope-de-Born,683,0,17440,17440,25.5
62598,Muncq-Nieurlet,683,0,5184,5184,7.6
67266,Limersheim,683,2670,12628,15298,22.4
71277,Marcilly-lès-Buxy,683,0,10476,10476,15.3
73317,Villard-sur-Doron,683,0,16111,16111,23.6
76099,Blacqueville,683,0,2281,2281,3.3
77185,Fleury-en-Bière,683,0,5687,5687,8.3
77290,Méry-sur-Marne,683,0,2660,2660,3.9
2212,Condren,682,0,12254,12254,18
8449,Thin-le-Moutier,682,0,14958,14958,21.9
22375,Tressignaux,682,0,13812,13812,20.3
26056,Bourdeaux,682,0,23776,23776,34.9
29214,Plovan,682,7035,21845,28880,42.3
31250,Labastide-Clermont,682,0,23883,23883,35
35141,Landavran,682,0,10246,10246,15
38294,Panossas,682,0,3521,3521,5.2
40091,Duhort-Bachen,682,0,21350,21350,31.3
54181,Errouville,682,0,3005,3005,4.4
59623,Villers-Guislain,682,0,8865,8865,13
68109,Griesbach-au-Val,682,0,27377,27377,40.1
73023,Aussois,682,0,12050,12050,17.7
84103,Rustrel,682,0,13902,13902,20.4
10367,La Saulsotte,681,0,4208,4208,6.2
21249,Esbarres,681,0,5106,5106,7.5
22380,Trévron,681,0,18142,18142,26.6
25633,Vuillafans,681,0,4963,4963,7.3
30055,Brouzet-lès-Alès,681,0,21286,21286,31.3
30233,Saint-Bauzély,681,0,2508,2508,3.7
36237,Vicq-sur-Nahon,681,0,8549,8549,12.6
38520,Valencogne,681,0,5972,5972,8.8
52205,Foulain,681,0,74803,74803,109.8
57271,Guenviller,681,0,21711,21711,31.9
60260,Fresnoy-la-Rivière,681,0,2666,2666,3.9
61092,Chandai,681,3950,7020,10970,16.1
61407,Sainte-Honorine-la-Chardonne,681,0,18239,18239,26.8
62199,Camblain-l'Abbé,681,0,5659,5659,8.3
76046,Auzouville-sur-Ry,681,0,465,465,0.7
80444,Huchenneville,681,0,4528,4528,6.6
85141,Menomblet,681,0,14880,14880,21.9
14721,Vacognes-Neuilly,680,3218,1203,4421,6.5
26061,Bren,680,0,29921,29921,44
27064,Berville-sur-Mer,680,0,5081,5081,7.5
37089,Cravant-les-Côteaux,680,0,37325,37325,54.9
40131,Labastide-d'Armagnac,680,0,7766,7766,11.4
40311,Taller,680,0,5534,5534,8.1
41008,Avaray,680,4418,2047,6465,9.5
41130,Maves,680,0,2047,2047,3
42049,Changy,680,16254,20066,36320,53.4
42133,Marcenod,680,0,15933,15933,23.4
42319,Valeille,680,2080,12326,14406,21.2
45309,Sennely,680,0,5866,5866,8.6
57437,Malling,680,0,4357,4357,6.4
62053,Audincthun,680,0,60520,60520,89
67303,Morsbronn-les-Bains,680,0,16453,16453,24.2
71102,La Charmée,680,0,18697,18697,27.5
71169,Davayé,680,0,17369,17369,25.5
78437,Mousseaux-sur-Seine,680,4775,6329,11104,16.3
86096,Doussay,680,0,15476,15476,22.8
89384,Senan,680,11858,16083,27941,41.1
2571,Omissy,679,0,97044,97044,142.9
4200,Salignac,679,13901,14955,28856,42.5
19250,Salon-la-Tour,679,0,0,0,0
29152,Motreff,679,0,22962,22962,33.8
30052,Bréau-Mars,679,0,10952,10952,16.1
32036,Beaumarchés,679,8474,12517,20991,30.9
33186,Gensac,679,0,4738,4738,7
35042,Brielles,679,0,10201,10201,15
41123,Marchenoir,679,0,2044,2044,3
42138,Maringes,679,0,34033,34033,50.1
56253,Tréal,679,0,8260,8260,12.2
57122,Cappel,679,0,21648,21648,31.9
58267,Saint-Saulge,679,0,3403,3403,5
60592,Saint-Pierre-es-Champs,679,3225,5566,8791,12.9
61412,Saint-Julien-sur-Sarthe,679,3510,239,3749,5.5
72197,Mézières-sous-Lavardin,679,0,13246,13246,19.5
79156,Louin,679,0,17365,17365,25.6
12299,Villefranche-de-Panat,678,0,4808,4808,7.1
19191,Saint-Cernin-de-Larche,678,0,10821,10821,16
21568,Saint-Rémy,678,0,13207,13207,19.5
23206,Saint-Laurent,678,0,11072,11072,16.3
26172,Manthes,678,8100,11161,19261,28.4
47147,Lévignac-de-Guyenne,678,0,33399,33399,49.3
48051,Le Collet-de-Dèze,678,9215,36927,46142,68.1
50505,Saint-Loup,678,0,16682,16682,24.6
57416,Lorry-Mardigny,678,0,33616,33616,49.6
74297,Versonnex,678,0,9182,9182,13.5
85175,Les Pineaux,678,0,14329,14329,21.1
7069,Colombier-le-Vieux,677,6690,29789,36479,53.9
30177,Monteils,677,0,21161,21161,31.3
35084,Comblessac,677,0,6110,6110,9
41009,Averdon,677,0,25947,25947,38.3
43140,Le Monteil,677,1118,28169,29287,43.3
60235,Flavacourt,677,0,5550,5550,8.2
67018,Balbronn,677,12060,36769,48829,72.1
67370,Petersbach,677,5233,18243,23476,34.7
71054,Bragny-sur-Saône,677,0,7812,7812,11.5
82063,Garganvillar,677,0,8695,8695,12.8
1114,Confort,676,0,8141,8141,12
9043,La Bastide-sur-l'Hers,676,0,14002,14002,20.7
9273,Saint-Pierre-de-Rivière,676,0,18170,18170,26.9
22053,Éréac,676,0,8159,8159,12.1
25267,Gennes,676,1336,11911,13247,19.6
31147,Clarac,676,0,14002,14002,20.7
32016,Auradé,676,0,48089,48089,71.1
51231,L'Épine,676,0,34360,34360,50.8
57707,Vernéville,676,0,33516,33516,49.6
60318,Houdancourt,676,13600,633,14233,21.1
60412,Montagny-en-Vexin,676,8299,14845,23144,34.2
64137,Bordères,676,0,7229,7229,10.7
64227,Gabaston,676,5150,7056,12206,18.1
76068,Bec-de-Mortagne,676,0,8005,8005,11.8
76136,Brachy,676,0,5455,5455,8.1
79029,Beaulieu-sous-Parthenay,676,0,5572,5572,8.2
87141,Saint-Cyr,676,0,297,297,0.4
88391,Rochesson,676,0,5280,5280,7.8
1169,Genouilleux,675,0,3484,3484,5.2
2807,Villequier-Aumont,675,0,12128,12128,18
14679,Subles,675,0,26016,26016,38.5
24207,Groléjac,675,7800,1156,8956,13.3
25103,Busy,675,0,11893,11893,17.6
35017,La Baussaine,675,0,8450,8450,12.5
39547,Vaux-lès-Saint-Claude,675,8650,19645,28295,41.9
42202,Saint-Barthélemy-Lestra,675,8847,12235,21082,31.2
51198,Crugny,675,0,11996,11996,17.8
60510,Porcheux,675,0,14823,14823,22
62202,Campagne-lès-Boulonnais,675,0,39944,39944,59.2
64119,Beuste,675,0,7219,7219,10.7
64124,Bidarray,675,0,17540,17540,26
64183,Caubios-Loos,675,0,10569,10569,15.7
67063,Breitenbach,675,0,107065,107065,158.6
89427,Vallan,675,4977,13205,18182,26.9
22163,Paule,674,0,62067,62067,92.1
28176,Le Gault-Saint-Denis,674,0,1240,1240,1.8
2A142,Levie,674,0,15718,15718,23.3
50219,Gratot,674,0,19502,19502,28.9
53045,La Brûlatte,674,0,29333,29333,43.5
54504,Serrouville,674,0,2969,2969,4.4
57614,Saint-Jean-Kourtzerode,674,0,1353,1353,2
59199,Erchin,674,0,9391,9391,13.9
67497,Uhlwiller,674,0,8195,8195,12.2
69008,Ancy,674,0,7967,7967,11.8
76017,Anglesqueville-l'Esneval,674,0,6079,6079,9
1261,Monthieux,673,0,140,140,0.2
3018,Bayet,673,0,13766,13766,20.5
31167,Encausse-les-Thermes,673,0,36170,36170,53.7
32029,Barran,673,0,7943,7943,11.8
34152,Mas-de-Londres,673,0,12540,12540,18.6
36032,Ceaulmont,673,0,4941,4941,7.3
56045,Le Cours,673,0,4769,4769,7.1
59209,Esnes,673,0,8748,8748,13
61314,Occagnes,673,1225,1422,2647,3.9
67090,Diebolsheim,673,0,12443,12443,18.5
77490,Vendrest,673,0,9882,9882,14.7
2539,Nauroy,672,0,6088,6088,9.1
3120,Garnat-sur-Engièvre,672,0,9046,9046,13.5
17354,Saint-Léger,672,0,7935,7935,11.8
27668,Le Val-David,672,0,7903,7903,11.8
34144,Lunas,672,0,6257,6257,9.3
38426,Saint-Maximin,672,0,12486,12486,18.6
42313,Trelins,672,0,6021,6021,9
45160,Greneville-en-Beauce,672,0,2444,2444,3.6
53009,Arquenay,672,0,4038,4038,6
57191,Elzange,672,0,4306,4306,6.4
57409,Lixing-lès-Saint-Avold,672,0,11474,11474,17.1
59548,Saint-Waast,672,0,1896,1896,2.8
71205,Frangy-en-Bresse,672,2480,1257,3737,5.6
76571,Sainte-Croix-sur-Buchy,672,2710,459,3169,4.7
76685,Thérouldeville,672,0,4360,4360,6.5
77147,La Croix-en-Brie,672,0,8652,8652,12.9
77321,Mousseaux-lès-Bray,672,4675,9517,14192,21.1
86141,Magné,672,4594,15133,19727,29.4
86164,Monthoiron,672,0,15294,15294,22.8
88088,La Chapelle-aux-Bois,672,0,16899,16899,25.1
1334,Saint-André-d'Huiriat,671,0,2718,2718,4.1
24509,Saint-Vincent-de-Connezac,671,5300,5095,10395,15.5
24585,Villefranche-du-Périgord,671,6120,1149,7269,10.8
27095,Bosrobert,671,0,2893,2893,4.3
33228,Lansac,671,0,3789,3789,5.6
34160,Mons,671,7058,2540,9598,14.3
38057,Bresson,671,17700,25921,43621,65
41073,Danzé,671,3240,8299,11539,17.2
57168,Danne-et-Quatre-Vents,671,0,1347,1347,2
60506,Pont-l'Évêque,671,0,0,0,0
62699,Recques-sur-Hem,671,0,5093,5093,7.6
64275,Ispoure,671,0,17436,17436,26
72225,Oisseau-le-Petit,671,0,31584,31584,47.1
73070,Champagneux,671,0,993,993,1.5
89456,Villemanoche,671,0,124,124,0.2
91538,Saint-Aubin,671,97574,6970,104544,155.8
8331,Noyers-Pont-Maugis,670,0,15391,15391,23
9277,Saint-Ybars,670,0,11916,11916,17.8
19129,Masseret,670,0,0,0,0
30086,Collorgues,670,0,5149,5149,7.7
31038,Azas,670,0,2188,2188,3.3
33050,Bieujac,670,0,6852,6852,10.2
33369,Saint-André-et-Appelles,670,0,5058,5058,7.5
40178,Mazerolles,670,0,8292,8292,12.4
44092,Massérac,670,0,9558,9558,14.3
59620,Villers-au-Tertre,670,0,9335,9335,13.9
60372,Luchy,670,0,26273,26273,39.2
60638,Thury-sous-Clermont,670,0,2783,2783,4.2
63247,Murol,670,0,4891,4891,7.3
65372,Pujo,670,0,15134,15134,22.6
68324,Steinbrunn-le-Haut,670,2600,13023,15623,23.3
72101,Courcemont,670,0,12424,12424,18.5
89304,Poilly-sur-Tholon,670,2800,15846,18646,27.8
1044,Billiat,669,0,8056,8056,12
2389,Jaulgonne,669,0,15463,15463,23.1
21336,Laignes,669,0,11162,11162,16.7
24177,Faux,669,0,1254,1254,1.9
25375,Les Monts-Ronds,669,0,4875,4875,7.3
25634,Vuillecin,669,0,19122,19122,28.6
27227,Étréville,669,0,2741,2741,4.1
29211,Plouyé,669,0,34780,34780,52
30162,Massillargues-Attuech,669,0,20911,20911,31.3
37173,Nouans-les-Fontaines,669,10908,11613,22521,33.7
51482,Saint-Germain-la-Ville,669,0,1117,1117,1.7
55073,Bras-sur-Meuse,669,2900,41466,44366,66.3
67292,Mietesheim,669,0,24500,24500,36.6
69187,Saint-Clément-les-Places,669,22093,33532,55625,83.1
70132,Chargey-lès-Gray,669,0,3376,3376,5
72245,Préval,669,0,4081,4081,6.1
78031,Auffreville-Brasseuil,669,0,6226,6226,9.3
78484,Perdreauville,669,2000,6226,8226,12.3
87060,Dournazac,669,1000,9068,10068,15
14593,Saint-Hymer,668,0,10736,10736,16.1
24205,Grignols,668,7177,3641,10818,16.2
42037,Chalain-d'Uzore,668,0,5985,5985,9
55198,Fresnes-en-Woëvre,668,0,8647,8647,12.9
61404,Saint-Hilaire-le-Châtel,668,5600,2345,7945,11.9
70012,Amance,668,0,3967,3967,5.9
72052,Chahaignes,668,0,37669,37669,56.4
89080,La Chapelle-sur-Oreuse,668,18967,123,19090,28.6
10061,Brévonnes,667,4320,2481,6801,10.2
17257,Néré,667,0,18579,18579,27.9
18170,Oizon,667,0,0,0,0
22031,Carnoët,667,0,11944,11944,17.9
22296,Saint-Glen,667,2400,8050,10450,15.7
23141,Naillat,667,0,19913,19913,29.9
25612,Vieilley,667,731,11752,12483,18.7
27561,Saint-Maclou,667,0,4984,4984,7.5
28183,Gommerville,667,0,3503,3503,5.3
45164,Guilly,667,0,3906,3906,5.9
56257,La Trinité-Porhoët,667,0,10044,10044,15.1
59142,Cerfontaine,667,0,23792,23792,35.7
62154,Bonnières,667,0,14409,14409,21.6
62734,Sailly-en-Ostrevent,667,0,830,830,1.2
68098,Friesen,667,0,9498,9498,14.2
73053,Bourgneuf,667,0,11928,11928,17.9
78113,Brueil-en-Vexin,667,0,6208,6208,9.3
80310,Fienvillers,667,0,2600,2600,3.9
4157,Puimoisson,666,9811,7742,17553,26.4
17279,Plassac,666,0,7864,7864,11.8
18100,Genouilly,666,15729,9622,25351,38.1
18263,Thénioux,666,3000,9622,12622,19
31089,Bretx,666,0,5571,5571,8.4
33145,Cursan,666,0,65756,65756,98.7
45348,Yèvre-la-Ville,666,2300,828,3128,4.7
46215,Payrac,666,0,21729,21729,32.6
52140,Colombey les Deux Églises,666,0,73155,73155,109.8
60441,Moyvillers,666,0,623,623,0.9
62672,Puisieux,666,0,3311,3311,5
68122,Hartmannswiller,666,0,16435,16435,24.7
71345,Péronne,666,0,17012,17012,25.5
76693,Le Tilleul,666,0,6007,6007,9
80752,Thézy-Glimont,666,0,42698,42698,64.1
12231,Saint-Jean-du-Bruel,665,0,28475,28475,42.8
15021,Boisset,665,5150,5831,10981,16.5
28084,Chartainvilliers,665,0,19377,19377,29.1
38232,Meyssiez,665,0,5116,5116,7.7
62130,Bienvillers-au-Bois,665,0,5526,5526,8.3
64014,Ainhoa,665,6660,17281,23941,36
68284,Roppentzwiller,665,2800,17839,20639,31
77234,Jablines,665,800,1644,2444,3.7
1408,Simandre-sur-Suran,664,0,12837,12837,19.3
1430,Varambon,664,0,9514,9514,14.3
11105,Cournanel,664,17625,8740,26365,39.7
12127,Lédergues,664,0,36234,36234,54.6
14332,La Hoguette,664,0,10402,10402,15.7
16234,Moulidars,664,0,24844,24844,37.4
21080,Blaisy-Bas,664,0,3734,3734,5.6
30224,La Rouvière,664,0,2446,2446,3.7
32127,Estang,664,0,0,0,0
36120,Mers-sur-Indre,664,0,1947,1947,2.9
47155,Madaillan,664,0,6379,6379,9.6
50259,Juilley,664,0,16337,16337,24.6
62569,Merck-Saint-Liévin,664,0,59096,59096,89
63139,Dore-l'Église,664,8900,6000,14900,22.4
73162,Montailleur,664,0,15663,15663,23.6
76566,Sainte-Austreberthe,664,0,2218,2218,3.3
76593,Saint-Jean-de-la-Neuville,664,0,5060,5060,7.6
85193,Rosnay,664,0,14033,14033,21.1
89204,L'Isle-sur-Serein,664,1091,3205,4296,6.5
89223,Lézinnes,664,3300,1543,4843,7.3
90091,Saint-Germain-le-Châtelet,664,0,19778,19778,29.8
3112,Étroussat,663,0,13561,13561,20.5
5119,Risoul,663,0,21555,21555,32.5
10230,Mergey,663,0,9468,9468,14.3
25592,Vaux-et-Chantegrue,663,0,9618,9618,14.5
27417,Morgny,663,0,540,540,0.8
67306,Muhlbach-sur-Bruche,663,19503,47980,67483,101.8
76574,Saint-Denis-sur-Scie,663,0,5350,5350,8.1
79308,Sciecq,663,0,8936,8936,13.5
84008,Le Barroux,663,7400,21649,29049,43.8
84090,Peypin-d'Aigues,663,0,2975,2975,4.5
88253,Jeuxey,663,0,16673,16673,25.1
2821,Vivaise,662,0,25282,25282,38.2
18134,Lury-sur-Arnon,662,1875,8982,10857,16.4
21110,Brochon,662,0,3175,3175,4.8
34029,Bélarga,662,0,3576,3576,5.4
39164,Conliège,662,8001,20863,28864,43.6
50049,Besneville,662,0,20823,20823,31.5
59121,Cagnoncles,662,0,8605,8605,13
64072,Aubertin,662,4650,19546,24196,36.5
64168,Carresse-Cassaber,662,0,13838,13838,20.9
71257,Lessard-le-National,662,0,18202,18202,27.5
73081,Le Châtelard,662,0,8415,8415,12.7
78668,La Villeneuve-en-Chevrie,662,0,3384,3384,5.1
10260,Moussey,661,0,9439,9439,14.3
16082,Boisné-La Tude,661,6153,31082,37235,56.3
23131,Mérinchal,661,0,8678,8678,13.1
27125,Calleville,661,0,2850,2850,4.3
28132,Donnemain-Saint-Mamès,661,0,36119,36119,54.6
34184,Nizas,661,7828,7342,15170,23
38434,Saint-Ondras,661,0,5796,5796,8.8
41129,Maslives,661,0,4631,4631,7
49130,Écuillé,661,1850,10700,12550,19
56051,Cruguel,661,0,9954,9954,15.1
57263,Grundviller,661,0,9034,9034,13.7
59440,Noyelles-sur-Selle,661,10600,24867,35467,53.7
62382,Gouy-Saint-André,661,0,10465,10465,15.8
62892,Willerval,661,0,18592,18592,28.1
63021,Authezat,661,0,11849,11849,17.9
71590,Volesvres,661,0,2563,2563,3.9
76748,Vittefleur,661,0,4281,4281,6.5
89113,Collemiers,661,3200,4393,7593,11.5
5096,Orcières,660,98758,43912,142670,216.2
12154,Montlaur,660,0,25825,25825,39.1
29094,Kernouës,660,0,16630,16630,25.2
42089,Essertines-en-Châtelneuf,660,0,5913,5913,9
45311,Sigloy,660,0,1283,1283,1.9
50159,Dangy,660,0,9762,9762,14.8
62028,Ames,660,0,10891,10891,16.5
67271,Lobsann,660,0,15969,15969,24.2
77345,Orly-sur-Morin,660,0,10868,10868,16.5
77423,Saint-Martin-des-Champs,660,0,10868,10868,16.5
88357,Poussay,660,0,9485,9485,14.4
95584,Santeuil,660,0,30324,30324,45.9
1402,Sermoyer,659,0,9050,9050,13.7
2031,Aubenton,659,0,12936,12936,19.6
6020,La Bollène-Vésubie,659,0,12974,12974,19.7
7052,Champis,659,0,12875,12875,19.5
14083,Bonnebosq,659,0,10592,10592,16.1
16225,Montembœuf,659,7400,13558,20958,31.8
22157,Le Moustoir,659,0,22286,22286,33.8
23169,La Saunière,659,0,10762,10762,16.3
26086,Châtillon-en-Diois,659,31045,36639,67684,102.7
26207,Montmiral,659,2546,13358,15904,24.1
26249,Pont-de-Barret,659,0,22974,22974,34.9
28014,Aunay-sous-Crécy,659,0,881,881,1.3
31050,Beauchalot,659,0,35417,35417,53.7
32312,Pessan,659,0,23220,23220,35.2
36139,Neuillay-les-Bois,659,0,1044,1044,1.6
38370,Saint-Bonnet-de-Chavagne,659,0,10650,10650,16.2
39275,Lamoura,659,12900,4690,17590,26.7
41086,Fontaines-en-Sologne,659,0,4617,4617,7
47302,Sos,659,0,3195,3195,4.8
53180,Pommerieux,659,0,4363,4363,6.6
61258,Le Mêle-sur-Sarthe,659,5540,232,5772,8.8
61445,Saint-Pierre-d'Entremont,659,2000,22265,24265,36.8
63283,Pontaumur,659,0,22284,22284,33.8
67516,Waltenheim-sur-Zorn,659,1600,22147,23747,36
73161,Montagny,659,0,3945,3945,6
76586,Saint-Gilles-de-la-Neuville,659,0,5944,5944,9
76690,Thil-Manneville,659,0,5318,5318,8.1
81059,Carlus,659,3305,6397,9702,14.7
89093,Chaumont,659,1100,121,1221,1.9
2209,Condé-en-Brie,658,0,15209,15209,23.1
31077,Le Born,658,0,0,0,0
39219,Évans,658,2180,10383,12563,19.1
41017,Binas,658,0,2711,2711,4.1
47316,Varès,658,0,6808,6808,10.3
52088,Ceffonds,658,0,5959,5959,9.1
54590,Viviers-sur-Chiers,658,0,8353,8353,12.7
59162,Crochte,658,0,12673,12673,19.3
59184,Ebblinghem,658,0,4020,4020,6.1
59515,Rouvignies,658,0,12676,12676,19.3
64029,Aramits,658,18970,14170,33140,50.4
71134,Navour-sur-Grosne,658,0,8942,8942,13.6
72185,Mareil-sur-Loir,658,0,4770,4770,7.2
76096,Biville-la-Baignarde,658,0,5310,5310,8.1
77020,Bannost-Villegagnon,658,0,2373,2373,3.6
79117,Faye-sur-Ardin,658,0,5423,5423,8.2
89373,Saligny,658,850,4373,5223,7.9
91100,Bouville,658,0,1657,1657,2.5
17482,Vouhé,657,1250,27185,28435,43.3
19113,Liginiac,657,26282,9007,35289,53.7
24432,Saint-Julien-de-Lampon,657,3700,2514,6214,9.5
31240,Issus,657,0,10712,10712,16.3
31286,Lavelanet-de-Comminges,657,0,1130,1130,1.7
37097,Dolus-le-Sec,657,4980,11405,16385,24.9
46117,Gagnac-sur-Cère,657,0,21435,21435,32.6
47253,Sainte-Marthe,657,0,11087,11087,16.9
58087,Cossaye,657,0,1695,1695,2.6
67179,Haegen,657,3226,46340,49566,75.4
71401,Sainte-Croix-en-Bresse,657,0,2705,2705,4.1
77072,Chalautre-la-Grande,657,0,2369,2369,3.6
1295,Peyzieux-sur-Saône,656,0,3386,3386,5.2
16145,Foussignac,656,3260,24545,27805,42.4
18257,Sury-près-Léré,656,0,11818,11818,18
21048,Barges,656,0,3146,3146,4.8
27147,La Chapelle-du-Bois-des-Faulx,656,0,7715,7715,11.8
27167,Condé-sur-Risle,656,0,14818,14818,22.6
2B224,Pietracorbara,656,0,24058,24058,36.7
30193,Parignargues,656,0,48799,48799,74.4
33287,Mongauzy,656,7880,5341,13221,20.2
41214,Saint-Hilaire-la-Gravelle,656,0,3332,3332,5.1
51544,Sommepy-Tahure,656,0,6172,6172,9.4
56242,Séglien,656,0,4567,4567,7
58164,Mesves-sur-Loire,656,0,13079,13079,19.9
61292,Montsecret-Clairefougère,656,4016,22164,26180,39.9
62399,Habarcq,656,0,5451,5451,8.3
62582,Monchy-le-Preux,656,0,18451,18451,28.1
67107,Duntzenheim,656,7200,22046,29246,44.6
68127,Heidwiller,656,2740,17597,20337,31
82114,Monbéqui,656,0,8803,8803,13.4
86288,Vicq-sur-Gartempe,656,0,14930,14930,22.8
86289,Le Vigeant,656,0,26532,26532,40.4
88519,La Voivre,656,0,6378,6378,9.7
89079,Chamvres,656,994,5142,6136,9.4
1080,Champdor-Corcelles,655,0,24777,24777,37.8
16171,Juillac-le-Coq,655,2560,24507,27067,41.3
24081,Carlux,655,7120,2506,9626,14.7
25523,Sainte-Marie,655,1525,41464,42989,65.6
28206,Laons,655,0,876,876,1.3
36091,Lacs,655,0,14388,14388,22
42327,Vérin,655,0,20100,20100,30.7
46086,Cuzance,655,0,21370,21370,32.6
54513,Tantonville,655,0,0,0,0
59441,Obies,655,0,1849,1849,2.8
67492,Traenheim,655,2561,35575,38136,58.2
68065,Chavannes-sur-l'Étang,655,0,9327,9327,14.2
74122,Faucigny,655,0,3424,3424,5.2
76105,Le Bocasse,655,0,448,448,0.7
78036,Autouillet,655,0,283,283,0.4
2476,Mennevret,654,0,3605,3605,5.5
17037,Beauvais-sur-Matha,654,0,18217,18217,27.9
21192,Corcelles-les-Monts,654,0,18979,18979,29
27486,Quittebeuf,654,0,2813,2813,4.3
36219,Tendu,654,0,4802,4802,7.3
39498,Salans,654,1500,10320,11820,18.1
46216,Payrignac,654,0,19572,19572,29.9
47088,Escassefort,654,0,6766,6766,10.3
60298,Hanvoile,654,0,3209,3209,4.9
62681,Quiestède,654,0,58206,58206,89
67317,Neubois,654,5396,103734,109130,166.9
71328,Nanton,654,1200,7922,9122,13.9
76360,Heugleville-sur-Scie,654,0,5277,5277,8.1
76491,Ouville-l'Abbaye,654,0,1442,1442,2.2
82119,Montalzat,654,0,19337,19337,29.6
1239,Massignieu-de-Rives,653,0,7278,7278,11.1
2124,Brissy-Hamégicourt,653,0,0,0,0
23064,Clugnat,653,0,9815,9815,15
25345,Longevelle-sur-Doubs,653,2850,41337,44187,67.7
26110,Crozes-Hermitage,653,3600,28733,32333,49.5
27685,La Vieille-Lyre,653,0,18365,18365,28.1
40167,Luxey,653,0,5138,5138,7.9
42041,Chambéon,653,0,11836,11836,18.1
42266,Saint-Nizier-de-Fornas,653,0,15300,15300,23.4
62567,Mentque-Nortbécourt,653,0,58117,58117,89
65287,Loures-Barousse,653,0,4273,4273,6.5
67315,Neewiller-près-Lauterbourg,653,0,74881,74881,114.7
70084,Boulot,653,0,5469,5469,8.4
71582,La Vineuse sur Fregande,653,0,4538,4538,6.9
76470,Normanville,653,12508,4229,16737,25.6
77465,Thoury-Férottes,653,0,462,462,0.7
82088,Laguépie,653,0,9235,9235,14.1
88460,Soulosse-sous-Saint-Élophe,653,0,7295,7295,11.2
6003,Andon,652,0,16647,16647,25.5
6073,Isola,652,0,12837,12837,19.7
8366,Rocquigny,652,0,14300,14300,21.9
9257,Sainte-Croix-Volvestre,652,0,79009,79009,121.2
14305,Gonneville-sur-Mer,652,0,8282,8282,12.7
28225,Magny,652,0,2412,2412,3.7
30340,Valliguières,652,0,2563,2563,3.9
35214,Parcé,652,0,7983,7983,12.2
52074,Breuvannes-en-Bassigny,652,0,10031,10031,15.4
61443,Saint-Paul,652,1534,17463,18997,29.1
62566,Menneville,652,0,1883,1883,2.9
77381,Quiers,652,0,8394,8394,12.9
88134,Dinozé,652,0,16396,16396,25.1
1227,Magnieu,651,0,7256,7256,11.1
3267,Saulcet,651,2624,13316,15940,24.5
12287,Vailhourles,651,0,1899,1899,2.9
14106,Bréville-les-Monts,651,0,8270,8270,12.7
37092,Crotelles,651,0,2857,2857,4.4
46066,Cazals,651,0,18412,18412,28.3
47034,Bouglon,651,0,10985,10985,16.9
50448,Saint-Aubin-de-Terregatte,651,0,16017,16017,24.6
50452,Saint-Brice-de-Landelles,651,0,16017,16017,24.6
54527,Tonnoy,651,0,5180,5180,8
56204,Saint-Allouestre,651,0,2624,2624,4
57093,Blies-Guersviller,651,0,8897,8897,13.7
57604,Rustroff,651,0,9371,9371,14.4
57704,Veckring,651,0,4171,4171,6.4
67072,Butten,651,2850,8161,11011,16.9
67253,Kuttolsheim,651,2966,12386,15352,23.6
68128,Heimersdorf,651,3410,17463,20873,32.1
72376,Villaines-sous-Lucé,651,0,36711,36711,56.4
7024,Banne,650,0,15906,15906,24.5
9107,Dun,650,0,13464,13464,20.7
12294,Vézins-de-Lévézou,650,0,4609,4609,7.1
14644,Saint-Philbert-des-Champs,650,0,10447,10447,16.1
22074,Le Haut-Corlay,650,0,0,0,0
31104,Capens,650,0,1118,1118,1.7
38102,Chèzeneuve,650,0,7898,7898,12.2
40213,Orx,650,0,14604,14604,22.5
42300,Sevelinges,650,0,16864,16864,25.9
51381,Montmort-Lucy,650,0,941,941,1.4
55364,Mouzay,650,0,23504,23504,36.2
65369,Pouyastruc,650,0,4127,4127,6.3
69169,Ronno,650,0,7683,7683,11.8
69253,Tupin-et-Semons,650,0,5001,5001,7.7
70514,Valay,650,6742,3280,10022,15.4
76117,Bordeaux-Saint-Clair,650,0,5863,5863,9
76615,Saint-Martin-du-Bec,650,0,5863,5863,9
78407,Mittainville,650,0,1266,1266,1.9
89282,Ormoy,650,3850,4200,8050,12.4
89425,Turny,650,2800,4200,7000,10.8
15191,Saint-Illide,649,6600,10745,17345,26.7
18269,Vailly-sur-Sauldre,649,2340,11692,14032,21.6
22308,Saint-Juvat,649,0,17290,17290,26.6
27260,Foulbec,649,0,4849,4849,7.5
39569,Villers-Farlay,649,1650,6285,7935,12.2
54414,Pagney-derrière-Barine,649,0,1354,1354,2.1
55268,Lacroix-sur-Meuse,649,0,9564,9564,14.7
60307,Heilles,649,0,2696,2696,4.2
60534,Rethondes,649,0,4396,4396,6.8
74252,Saint-Sigismond,649,0,5905,5905,9.1
79320,Surin,649,0,5349,5349,8.2
91319,Janvry,649,0,2994,2994,4.6
3265,Saligny-sur-Roudon,648,0,11192,11192,17.3
11243,Montferrand,648,0,5694,5694,8.8
17132,Cram-Chaban,648,0,9441,9441,14.6
17400,Saint-Sever-de-Saintonge,648,0,20537,20537,31.7
18142,Meillant,648,2005,2855,4860,7.5
19060,Condat-sur-Ganaveix,648,0,0,0,0
22060,Gausson,648,0,0,0,0
24471,Sainte-Nathalène,648,4602,4082,8684,13.4
27540,Sainte-Geneviève-lès-Gasny,648,0,3405,3405,5.3
33528,Le Temple,648,0,406,406,0.6
35174,Mellé,648,0,7934,7934,12.2
38050,Le Bouchage,648,0,3345,3345,5.2
38303,La Pierre,648,5130,12040,17170,26.5
50298,Méautis,648,0,3512,3512,5.4
51624,Ville-en-Tardenois,648,0,11516,11516,17.8
52479,Sommevoire,648,0,5869,5869,9.1
57210,Fénétrange,648,0,4219,4219,6.5
60428,Le Mont-Saint-Adrien,648,0,25410,25410,39.2
60626,Talmontiers,648,6500,5312,11812,18.2
65130,Castelnau-Rivière-Basse,648,0,14637,14637,22.6
67238,Kindwiller,648,0,7879,7879,12.2
86252,Sammarçolles,648,0,3310,3310,5.1
88109,Cleurie,648,0,5061,5061,7.8
95169,Commeny,648,0,29773,29773,45.9
2218,Coucy-lès-Eppes,647,0,1741,1741,2.7
17175,Germignac,647,0,7640,7640,11.8
18139,Marseilles-lès-Aubigny,647,0,205,205,0.3
24104,Chantérac,647,7250,3527,10777,16.7
27097,Bouafles,647,0,3400,3400,5.3
27118,Brosville,647,7825,2783,10608,16.4
27282,Gauville-la-Campagne,647,0,7609,7609,11.8
35008,Availles-sur-Seiche,647,0,9720,9720,15
40103,Gaillères,647,0,8007,8007,12.4
46070,Cieurac,647,0,5463,5463,8.4
60600,Saint-Vaast-de-Longmont,647,55720,5827,61547,95.1
76463,Neuf-Marché,647,0,12222,12222,18.9
78006,Adainville,647,3410,6487,9897,15.3
85115,La Jaudonnière,647,0,13674,13674,21.1
90103,Vétrigne,647,0,22573,22573,34.9
4065,Cruis,646,21000,13120,34120,52.8
14207,Croisilles,646,0,19530,19530,30.2
18218,Saint-Just,646,2580,12374,14954,23.1
33508,Savignac,646,0,5259,5259,8.1
58144,Livry,646,0,4318,4318,6.7
58223,Rouy,646,0,3238,3238,5
60385,Marolles,646,0,2529,2529,3.9
60447,Néry,646,0,5818,5818,9
63135,Davayat,646,0,4262,4262,6.6
63185,Lamontgie,646,0,4199,4199,6.5
68273,Riespach,646,10157,17329,27486,42.5
72339,Souligné-Flacé,646,0,3460,3460,5.4
73107,Entremont-le-Vieux,646,0,44233,44233,68.5
76568,Saint-Clair-sur-les-Monts,646,0,1195,1195,1.8
77300,Montceaux-lès-Meaux,646,0,8810,8810,13.6
81215,Puybegon,646,0,35493,35493,54.9
82187,Varen,646,0,9136,9136,14.1
85185,Puyravault,646,0,13653,13653,21.1
1392,Samognat,645,0,24399,24399,37.8
3180,Montbeugny,645,0,8682,8682,13.5
21482,Perrigny-sur-l'Ognon,645,0,0,0,0
50488,Saint-Jean-de-Daye,645,0,9540,9540,14.8
50500,Saint-Laurent-de-Terregatte,645,0,15870,15870,24.6
51457,Cœur-de-la-Vallée,645,0,934,934,1.4
59565,Sepmeries,645,0,1820,1820,2.8
62536,Magnicourt-en-Comte,645,0,5360,5360,8.3
64093,Barcus,645,0,16761,16761,26
11124,Durban-Corbières,644,19789,991,20780,32.3
22133,Loscouët-sur-Meu,644,0,0,0,0
23092,Glénic,644,0,10517,10517,16.3
29034,Le Cloître-Saint-Thégonnec,644,1090,38614,39704,61.7
30101,Deaux,644,0,20130,20130,31.3
31110,Cassagne,644,0,34611,34611,53.7
34222,Puilacher,644,0,3479,3479,5.4
45213,Montereau,644,0,6603,6603,10.3
49262,Rou-Marson,644,9423,6274,15697,24.4
50641,Villiers-Fossard,644,0,9525,9525,14.8
51234,Esclavolles-Lurey,644,0,8403,8403,13
57651,Siersthal,644,0,14842,14842,23
60040,Bailleul-le-Soc,644,10150,603,10753,16.7
62384,Graincourt-lès-Havrincourt,644,0,801,801,1.2
64177,Castétis,644,0,17340,17340,26.9
74235,Saint-Germain-sur-Rhône,644,0,15555,15555,24.2
83152,Rayol-Canadel-sur-Mer,644,0,5160,5160,8
86126,Leignes-sur-Fontaine,644,2450,26047,28497,44.2
5012,Baratier,643,0,51383,51383,79.9
12259,Sanvensa,643,0,1875,1875,2.9
14542,Rosel,643,0,14308,14308,22.3
25219,Épenoy,643,65270,7596,72866,113.3
27440,Notre-Dame-de-l'Isle,643,0,3379,3379,5.3
27487,Radepont,643,0,4231,4231,6.6
2A181,Ocana,643,0,8777,8777,13.7
2B341,Venaco,643,0,11108,11108,17.3
37155,Monthodon,643,0,2822,2822,4.4
37240,Saunay,643,3340,2822,6162,9.6
45019,Baccon,643,0,2649,2649,4.1
62844,Verchocq,643,0,38050,38050,59.2
63472,Yronde-et-Buron,643,0,11526,11526,17.9
64463,Rébénacq,643,0,8161,8161,12.7
67060,Bourgheim,643,1850,19885,21735,33.8
68347,Vieux-Ferrette,643,0,17249,17249,26.8
70093,Breuches,643,0,618,618,1
74231,Saint-Eusèbe,643,0,8708,8708,13.5
78281,Goussonville,643,0,5984,5984,9.3
78344,Lommoye,643,0,3287,3287,5.1
79119,Fenioux,643,0,5300,5300,8.2
85181,Pouillé,643,0,4219,4219,6.6
22156,Moustéru,642,0,11496,11496,17.9
23105,Lavaveix-les-Mines,642,0,8428,8428,13.1
23124,Marsac,642,0,3556,3556,5.5
54062,Benney,642,0,0,0,0
54456,Réméréville,642,0,3799,3799,5.9
57468,Mittelbronn,642,0,1288,1288,2
61002,Almenêches,642,3720,4028,7748,12.1
67092,Dieffenbach-au-Val,642,2616,101831,104447,162.7
78296,Guitrancourt,642,0,5975,5975,9.3
14022,Asnelles,641,0,7859,7859,12.3
19147,Nespouls,641,8030,10230,18260,28.5
27421,Mousseaux-Neuville,641,0,7539,7539,11.8
29228,Primelin,641,7443,45878,53321,83.2
34285,Saint-Pons-de-Mauchiens,641,0,7120,7120,11.1
36163,Pouligny-Notre-Dame,641,7892,14080,21972,34.3
47180,Montagnac-sur-Auvignon,641,0,3108,3108,4.8
48147,Saint-Étienne-du-Valdonnez,641,4700,12990,17690,27.6
57456,Meisenthal,641,0,14773,14773,23
58010,Arleuf,641,0,7553,7553,11.8
67143,Fouchy,641,755,101672,102427,159.8
71093,La Chapelle-Saint-Sauveur,641,0,79,79,0.1
72099,Courcebœufs,641,0,36018,36018,56.2
80600,Noyelles-sur-Mer,641,0,15873,15873,24.8
81106,Grazac,641,0,35218,35218,54.9
95328,Labbeville,641,0,16919,16919,26.4
97208,Fonds-Saint-Denis,641,0,5804,5804,9.1
30183,Moulézan,640,0,2357,2357,3.7
34065,Cazedarnes,640,0,3618,3618,5.7
59657,West-Cappel,640,0,12326,12326,19.3
61421,Saint-Mars-d'Égrenne,640,5890,7942,13832,21.6
67410,Rosenwiller,640,0,23247,23247,36.3
70387,Noidans-le-Ferroux,640,0,1644,1644,2.6
82188,Varennes,640,0,8589,8589,13.4
86142,Maillé,640,0,33259,33259,52
10350,Saint-Mards-en-Othe,639,0,11148,11148,17.4
26355,Triors,639,0,12953,12953,20.3
33457,Saint-Pardon-de-Conques,639,0,6535,6535,10.2
59450,Ors,639,0,4391,4391,6.9
62176,Bréxent-Énocq,639,0,6798,6798,10.6
62864,Vis-en-Artois,639,0,795,795,1.2
77237,Jossigny,639,0,1580,1580,2.5
82026,Bruniquel,639,0,5187,5187,8.1
87112,Pageas,639,3370,8661,12031,18.8
2268,Domptin,638,0,347,347,0.5
24555,Tourtoirac,638,2700,11158,13858,21.7
28082,Charpont,638,0,853,853,1.3
35339,Trans-la-Forêt,638,0,5425,5425,8.5
41221,Saint-Léonard-en-Beauce,638,0,1921,1921,3
46307,Soturac,638,0,23197,23197,36.4
47291,La Sauvetat-sur-Lède,638,0,16291,16291,25.5
50083,Bricquebosq,638,3000,20068,23068,36.2
54514,Tellancourt,638,0,8099,8099,12.7
60022,Apremont,638,0,12786,12786,20
60101,Brégy,638,0,2498,2498,3.9
72094,Coudrecieux,638,0,11926,11926,18.7
76082,Bernières,638,0,4862,4862,7.6
78082,Boissy-Mauvoisin,638,0,3262,3262,5.1
79313,Sepvret,638,0,18426,18426,28.9
80498,Mailly-Maillet,638,0,713,713,1.1
80775,Valines,638,0,4242,4242,6.6
83089,Ollières,638,0,23903,23903,37.5
3092,Cressanges,637,0,9785,9785,15.4
11299,Preixan,637,0,4132,4132,6.5
12073,Comps-la-Grand-Ville,637,0,11482,11482,18
17083,Champagne,637,1275,10490,11765,18.5
24454,Saint-Martin-de-Gurson,637,6351,2220,8571,13.5
34070,Cébazan,637,0,3601,3601,5.7
37096,Dierre,637,0,14334,14334,22.5
46087,Dégagnac,637,0,18016,18016,28.3
59617,Vieux-Mesnil,637,0,22722,22722,35.7
60356,Lavilletertre,637,13590,13988,27578,43.3
67517,Wangen,637,0,34597,34597,54.3
70446,Rigny,637,0,3215,3215,5
74306,Villy-le-Bouveret,637,43401,11452,54853,86.1
79236,Saint-André-sur-Sèvre,637,0,18120,18120,28.4
85251,Saint-Maurice-des-Noues,637,0,13919,13919,21.9
18027,Bengy-sur-Craon,636,975,1244,2219,3.5
22087,Kergrist-Moëlou,636,0,58567,58567,92.1
25349,Loray,636,0,7513,7513,11.8
27110,Brestot,636,0,14366,14366,22.6
27256,La Forêt-du-Parc,636,0,7480,7480,11.8
27576,Sainte-Opportune-du-Bosc,636,0,2735,2735,4.3
29294,Le Tréhou,636,7703,4929,12632,19.9
33128,Civrac-en-Médoc,636,0,5592,5592,8.8
40306,Sorde-l'Abbaye,636,0,4733,4733,7.4
41152,Montrieux-en-Sologne,636,617,5307,5924,9.3
56196,Rochefort-en-Terre,636,0,4507,4507,7.1
68337,Traubach-le-Haut,636,0,9056,9056,14.2
71075,Chalmoux,636,0,3270,3270,5.1
74034,Le Biot,636,8000,44441,52441,82.5
76613,Saint-Martin-aux-Buneaux,636,0,4119,4119,6.5
82066,Génébrières,636,0,5163,5163,8.1
86300,Yversay,636,0,33051,33051,52
3074,Chevagnes,635,0,8548,8548,13.5
14678,Soumont-Saint-Quentin,635,0,9947,9947,15.7
24001,Abjat-sur-Bandiat,635,100,4255,4355,6.9
54525,Tiercelet,635,0,5929,5929,9.3
60323,Janville,635,2820,5719,8539,13.4
62011,Agnez-lès-Duisans,635,0,5277,5277,8.3
62673,Quéant,635,0,790,790,1.2
70363,Montigny-lès-Vesoul,635,0,32848,32848,51.7
89450,Villebougis,635,9600,2253,11853,18.7
91393,Mérobert,635,0,1599,1599,2.5
2346,Gizy,634,0,1706,1706,2.7
3085,Coulandon,634,0,8534,8534,13.5
12234,Sainte-Juliette-sur-Viaur,634,0,19404,19404,30.6
19143,Montaignac-sur-Doustre,634,0,8134,8134,12.8
22086,Kerfot,634,0,11353,11353,17.9
27050,Beaumontel,634,0,2733,2733,4.3
27324,Hébécourt,634,2150,517,2667,4.2
54011,Allondrelle-la-Malmaison,634,0,8049,8049,12.7
64482,Saint-Jammes,634,0,6618,6618,10.4
67074,Cleebourg,634,0,69856,69856,110.2
71184,Dracy-Saint-Loup,634,0,14185,14185,22.4
74145,Juvigny,634,0,10132,10132,16
77227,Hermé,634,5370,8979,14349,22.6
95150,Chaussy,634,9005,4008,13013,20.5
2071,Berny-Rivière,633,0,609,609,1
39258,Grande-Rivière Château,633,5870,4507,10377,16.4
40253,Saint-Cricq-Chalosse,633,0,14625,14625,23.1
53082,Courbeveille,633,0,4190,4190,6.6
53086,La Croixille,633,0,2877,2877,4.5
57652,Sillegny,633,0,24241,24241,38.3
60563,Sacy-le-Petit,633,0,925,925,1.5
61475,Soligny-la-Trappe,633,8570,2222,10792,17
62214,Carly,633,0,1828,1828,2.9
62610,Neuville-sous-Montreuil,633,0,6734,6734,10.6
67012,Aschbach,633,0,17442,17442,27.6
72211,Mont-Saint-Jean,633,0,12349,12349,19.5
73197,Peisey-Nancroix,633,0,31841,31841,50.3
80376,Gentelles,633,0,84,84,0.1
80412,Hamelet,633,0,84,84,0.1
4189,Saint-Martin-de-Brômes,632,0,7346,7346,11.6
12036,Brommat,632,0,21416,21416,33.9
14236,Ellon,632,0,24358,24358,38.5
17056,Bougneau,632,0,7462,7462,11.8
26367,Venterol,632,0,32475,32475,51.4
54148,Croismare,632,0,2792,2792,4.4
56087,Île-aux-Moines,632,0,5847,5847,9.3
56203,Saint-Aignan,632,0,4400,4400,7
58072,Chevenon,632,0,2361,2361,3.7
58176,Montigny-aux-Amognes,632,0,3167,3167,5
63054,Le Broc,632,0,4108,4108,6.5
63423,Sugères,632,0,4108,4108,6.5
68263,Ranspach-le-Bas,632,0,12284,12284,19.4
73120,Fréterive,632,0,11302,11302,17.9
81232,Rouffiac,632,1610,6135,7745,12.3
91093,Boullay-les-Troux,632,0,2915,2915,4.6
8237,Joigny-sur-Meuse,631,0,9824,9824,15.6
9002,Aigues-Vives,631,0,13070,13070,20.7
12237,Saint-Laurent-d'Olt,631,0,59762,59762,94.7
28203,Landelles,631,0,2335,2335,3.7
31336,Mazères-sur-Salat,631,0,33912,33912,53.7
33222,Lalande-de-Pomerol,631,0,12308,12308,19.5
40067,Carcen-Ponson,631,0,14843,14843,23.5
43261,Vézézoux,631,5332,7067,12399,19.6
50378,Notre-Dame-de-Cenilly,631,0,18257,18257,28.9
51155,Clesles,631,0,8234,8234,13
57584,Rimling,631,0,14542,14542,23
62324,Farbus,631,0,17748,17748,28.1
62803,Surques,631,0,1365,1365,2.2
63112,Clerlande,631,0,4772,4772,7.6
63192,La Tour-d'Auvergne,631,0,1975,1975,3.1
68137,Hindlingen,631,0,8985,8985,14.2
76208,Cuy-Saint-Fiacre,631,0,11920,11920,18.9
77195,Fouju,631,0,598,598,0.9
85233,Saint-Jean-de-Beugné,631,3426,0,3426,5.4
1240,Matafelon-Granges,630,0,23832,23832,37.8
19140,Monceaux-sur-Dordogne,630,0,1870,1870,3
22361,Tréguidel,630,0,12759,12759,20.3
38033,Beaulieu,630,0,10181,10181,16.2
42232,Saint-Haon-le-Châtel,630,14492,18591,33083,52.5
42312,La Tourette,630,0,5645,5645,9
61024,Banvou,630,5605,16873,22478,35.7
61423,Saint-Martin-d'Écublei,630,2144,6494,8638,13.7
62873,Wancourt,630,0,17720,17720,28.1
63306,La Roche-Noire,630,0,11293,11293,17.9
68351,Vogelgrun,630,0,10934,10934,17.4
70031,Athesans-Étroitefontaine,630,0,199,199,0.3
76067,Beauvoir-en-Lyons,630,0,11901,11901,18.9
76232,Életot,630,0,4088,4088,6.5
80549,Miraumont,630,0,704,704,1.1
88261,Laval-sur-Vologne,630,0,826,826,1.3
14194,Courtonne-les-Deux-Églises,629,0,7002,7002,11.1
14241,Épinay-sur-Odon,629,0,23324,23324,37.1
23239,Saint-Sébastien,629,0,18779,18779,29.9
24269,Mialet,629,4750,2075,6825,10.9
24364,Coly-Saint-Amand,629,24900,8732,33632,53.5
24558,Trémolat,629,49482,2285,51767,82.3
25382,Moncey,629,0,31353,31353,49.8
2A345,Vero,629,0,8586,8586,13.7
30168,Mialet,629,0,19661,19661,31.3
35276,Saint-Gondran,629,0,13512,13512,21.5
40020,Aurice,629,0,14532,14532,23.1
49017,Baracé,629,0,4812,4812,7.7
50486,Saint-Jacques-de-Néhou,629,0,19785,19785,31.5
55527,Varennes-en-Argonne,629,0,6576,6576,10.5
57382,Langatte,629,0,4095,4095,6.5
57736,Vry,629,0,1532,1532,2.4
60272,Gilocourt,629,0,2463,2463,3.9
62747,Saint-Floris,629,0,10380,10380,16.5
63051,Brenat,629,0,4089,4089,6.5
68363,Werentzhouse,629,0,16873,16873,26.8
69005,Ambérieux,629,0,5669,5669,9
76394,Longroy,629,0,1809,1809,2.9
76577,Sainte-Foy,629,0,5076,5076,8.1
76757,Yvecrique,629,5360,1387,6747,10.7
80732,Senarpont,629,0,868,868,1.4
88442,Sapois,629,0,4913,4913,7.8
89158,Étais-la-Sauvin,629,10968,28402,39370,62.6
1328,Romans,628,0,131,131,0.2
2487,Missy-sur-Aisne,628,0,1239,1239,2
7328,Vagnas,628,5509,38348,43857,69.8
17412,Saint-Vaize,628,10995,19903,30898,49.2
29288,Trégarantec,628,0,15824,15824,25.2
40285,Saint-Yaguen,628,0,14772,14772,23.5
47170,Monbahus,628,0,16036,16036,25.5
51287,Hautvillers,628,0,1552,1552,2.5
51357,Matougues,628,0,31920,31920,50.8
59371,Le Maisnil,628,0,10400,10400,16.6
62153,Bomy,628,0,55892,55892,89
63392,Saint-Rémy-de-Chargnat,628,0,4082,4082,6.5
70096,Brevilliers,628,0,4101,4101,6.5
76646,Saint-Riquier-ès-Plains,628,0,4067,4067,6.5
85229,Saint-Hilaire-de-Voust,628,87571,13722,101293,161.3
25197,Deluz,627,5000,11047,16047,25.6
42166,Parigny,627,0,18502,18502,29.5
50137,La Colombe,627,0,10594,10594,16.9
51343,Marcilly-sur-Seine,627,0,8181,8181,13
55258,Geville,627,0,7451,7451,11.9
59321,Inchy,627,0,4308,4308,6.9
60540,Rivecourt,627,0,587,587,0.9
64097,Barzun,627,1831,6545,8376,13.4
67185,Hattmatt,627,3600,44224,47824,76.3
67362,Orschwiller,627,0,12063,12063,19.2
67477,Steige,627,0,99452,99452,158.6
69240,Saint-Vincent-de-Reins,627,0,7411,7411,11.8
71022,Baudemont,627,0,12170,12170,19.4
76008,Ancourt,627,0,7620,7620,12.2
81277,Saussenac,627,0,19373,19373,30.9
88233,Harol,627,0,9011,9011,14.4
14237,Émiéville,626,0,5038,5038,8
18240,Sancergues,626,0,2160,2160,3.5
25051,Belleherbe,626,0,17258,17258,27.6
27152,Château-sur-Epte,626,0,510,510,0.8
28286,Ollé,626,0,18241,18241,29.1
37236,Saint-Règle,626,0,16992,16992,27.1
39104,Chapelle-Voland,626,2200,16638,18838,30.1
39435,Pont-de-Poitte,626,4750,18218,22968,36.7
53109,Grazay,626,0,23263,23263,37.2
61074,Carrouges,626,0,2816,2816,4.5
62020,Alembon,626,0,3832,3832,6.1
68264,Ranspach-le-Haut,626,0,12167,12167,19.4
77492,Verdelot,626,0,10308,10308,16.5
87013,Bersac-sur-Rivalier,626,0,1014,1014,1.6
21126,Cessey-sur-Tille,625,0,14,14,0
28147,Favières,625,0,836,836,1.3
40238,Pujo-le-Plan,625,0,5971,5971,9.6
42297,Salvizinet,625,250,11329,11579,18.5
47099,Fongrave,625,0,4790,4790,7.7
52079,Brousseval,625,0,5660,5660,9.1
53113,Hambers,625,0,4471,4471,7.2
53153,Mézangers,625,0,4471,4471,7.2
67213,Hunspach,625,0,68864,68864,110.2
79207,La Petite-Boissière,625,0,17779,17779,28.4
83075,Les Mayons,625,0,2675,2675,4.3
2260,Danizy,624,0,11212,11212,18
3121,Gennetines,624,0,8400,8400,13.5
4013,Aubignosc,624,7750,13744,21494,34.4
28423,Yermenonville,624,0,3621,3621,5.8
38038,Belmont,624,0,5472,5472,8.8
47257,Saint-Martin-Petit,624,0,6456,6456,10.3
53051,Champéon,624,0,23189,23189,37.2
54327,Lucey,624,0,1302,1302,2.1
57072,Bettelainville,624,0,3998,3998,6.4
59201,Erquinghem-le-Sec,624,0,10333,10333,16.6
62670,Preures,624,0,36926,36926,59.2
64184,Cescau,624,0,16802,16802,26.9
77386,Recloses,624,0,5195,5195,8.3
78325,Jumeauville,624,3969,5807,9776,15.7
84144,Viens,624,0,12719,12719,20.4
89342,Saint-Denis-lès-Sens,624,0,4147,4147,6.6
1274,Les Neyrolles,623,0,23567,23567,37.8
10053,Bouranton,623,0,8896,8896,14.3
14297,Gavrus,623,0,1102,1102,1.8
17302,Romegoux,623,4660,15869,20529,33
40275,Saint-Maurice-sur-Adour,623,0,2911,2911,4.7
45077,La Chapelle-sur-Aveyron,623,0,6388,6388,10.3
50145,Courcy,623,0,18026,18026,28.9
59422,Naves,623,0,8098,8098,13
62054,Audinghen,623,0,2478,2478,4
80107,Blangy-Tronville,623,0,39941,39941,64.1
80690,Rumigny,623,0,39941,39941,64.1
86034,Bouresse,623,9503,25198,34701,55.7
28249,Mévoisins,622,0,3609,3609,5.8
31430,Ponlat-Taillebourg,622,0,12884,12884,20.7
51338,Mailly-Champagne,622,0,11054,11054,17.8
57618,Saint-Louis,622,0,1248,1248,2
58112,La Fermeté,622,0,1604,1604,2.6
60547,Rosoy,622,0,260,260,0.4
84098,Roaix,622,0,728,728,1.2
6058,Escragnolles,621,0,15855,15855,25.5
7051,Champagne,621,0,10223,10223,16.5
9066,Brassac,621,0,16691,16691,26.9
11197,Lauraguel,621,5980,8174,14154,22.8
21442,Morey-Saint-Denis,621,0,2978,2978,4.8
22140,La Malhoure,621,2050,7495,9545,15.4
25207,Dung,621,3785,39312,43097,69.4
27682,Vesly,621,0,506,506,0.8
33423,Saint-Julien-Beychevelle,621,0,5460,5460,8.8
34131,Lauret,621,3200,11571,14771,23.8
37180,Parçay-sur-Vienne,621,0,16850,16850,27.1
42336,Virigneux,621,4169,31126,35295,56.8
45334,Vieilles-Maisons-sur-Joudry,621,0,6367,6367,10.3
46057,Cardaillac,621,4422,18339,22761,36.7
50540,Saint-Pierre-Langers,621,0,15029,15029,24.2
51136,Châtillon-sur-Marne,621,0,899,899,1.4
51162,Conflans-sur-Seine,621,0,8103,8103,13
60191,Cuvilly,621,13850,5429,19279,31
67177,Gunstett,621,4800,15026,19826,31.9
67490,Thanvillé,621,1676,98500,100176,161.3
68208,Michelbach-le-Haut,621,2530,12070,14600,23.5
69174,Les Sauvages,621,0,7340,7340,11.8
71196,Le Fay,621,2260,2556,4816,7.8
76737,Vibeuf,621,2305,1369,3674,5.9
78276,Gommecourt,621,0,3175,3175,5.1
79161,Luzay,621,0,9662,9662,15.6
80650,Querrieu,621,0,39813,39813,64.1
86173,Mouterre-Silly,621,0,3172,3172,5.1
88028,La Baffe,621,0,15616,15616,25.1
89318,Quarré-les-Tombes,621,3660,1347,5007,8.1
91629,Valpuiseaux,621,0,1564,1564,2.5
11256,Montséret,620,0,8400,8400,13.5
21261,Fauverney,620,0,14,14,0
25217,Émagny,620,0,419,419,0.7
27034,Bacqueville,620,0,4079,4079,6.6
30095,Corconne,620,0,1289,1289,2.1
33088,Camps-sur-l'Isle,620,0,12094,12094,19.5
34061,Causses-et-Veyran,620,0,1213,1213,2
34280,Saint-Nazaire-de-Pézan,620,0,6778,6778,10.9
37221,Saint-Hippolyte,620,19209,10762,29971,48.3
38055,Brangues,620,0,3201,3201,5.2
41134,Menars,620,0,23762,23762,38.3
46262,Lendou-en-Quercy,620,0,15240,15240,24.6
50382,Nouainville,620,0,19502,19502,31.5
57262,Grostenquin,620,0,10586,10586,17.1
57560,Racrange,620,0,10586,10586,17.1
61422,Les Aspres,620,9570,6391,15961,25.7
62155,Bonningues-lès-Ardres,620,0,1341,1341,2.2
62900,Witternesse,620,0,10231,10231,16.5
77451,Signy-Signets,620,0,2415,2415,3.9
89031,Beaumont,620,2450,4006,6456,10.4
3229,Saint-Ennemond,619,0,8332,8332,13.5
25105,Byans-sur-Doubs,619,0,10907,10907,17.6
26382,Saint-Vincent-la-Commanderie,619,0,12548,12548,20.3
2B166,Monte,619,0,11542,11542,18.6
38117,Cognin-les-Gorges,619,0,10003,10003,16.2
39183,Crotenay,619,2400,6267,8667,14
39279,Larnaud,619,2500,16452,18952,30.6
42132,Malleval,619,0,18995,18995,30.7
50098,Carantilly,619,0,9155,9155,14.8
61329,Le Pin-la-Garenne,619,4820,2173,6993,11.3
64225,Ance Féas,619,3966,13330,17296,27.9
77120,Cocherel,619,0,9089,9089,14.7
77165,Les Écrennes,619,0,587,587,0.9
80672,Ribemont-sur-Ancre,619,0,82,82,0.1
95023,Arronville,619,0,16339,16339,26.4
1028,Baneins,618,0,129,129,0.2
7035,Boffres,618,1970,12074,14044,22.7
8260,Lonny,618,0,9621,9621,15.6
10153,Fontaine-Mâcon,618,0,3819,3819,6.2
12206,Roussennac,618,0,10615,10615,17.2
15016,Ayrens,618,2285,20939,23224,37.6
35157,Le Loroux,618,0,7567,7567,12.2
35324,La Selle-en-Luitré,618,0,7567,7567,12.2
39283,Lavancia-Epercy,618,9287,17986,27273,44.1
40252,Sainte-Colombe,618,0,14278,14278,23.1
43033,Blesle,618,24023,30287,54310,87.9
47263,Saint-Pardoux-du-Breuil,618,0,6394,6394,10.3
50519,Saint-Martin-le-Gréard,618,0,19439,19439,31.5
51052,Berru,618,0,10983,10983,17.8
51065,Blacy,618,0,9748,9748,15.8
51281,Grauves,618,0,12281,12281,19.9
53040,Bourgon,618,0,26896,26896,43.5
59073,Berthen,618,0,3776,3776,6.1
59191,Élincourt,618,0,4246,4246,6.9
59338,Ledringhem,618,0,11902,11902,19.3
60574,Saint-Félix,618,0,2567,2567,4.2
63255,Nonette-Orsonnette,618,0,4017,4017,6.5
78655,Vieille-Église-en-Yvelines,618,0,1204,1204,1.9
85171,Péault,618,0,13061,13061,21.1
87029,Les Cars,618,1450,8377,9827,15.9
4121,Mézel,617,0,25862,25862,41.9
10231,Le Mériot,617,0,3813,3813,6.2
16277,Réparsac,617,7328,23085,30413,49.3
18229,Saint-Palais,617,0,4676,4676,7.6
33335,Le Pout,617,0,60918,60918,98.7
48198,Villefort,617,33440,12504,45944,74.5
49045,La Breille-les-Pins,617,0,6011,6011,9.7
64224,Eysus,617,0,13287,13287,21.5
67146,Friesenheim,617,0,11408,11408,18.5
67320,Neuve-Église,617,0,97865,97865,158.6
76715,Trouville,617,0,4702,4702,7.6
81267,Saint-Pierre-de-Trivisy,617,0,5765,5765,9.3
9161,Léran,616,0,12760,12760,20.7
11063,Campagne-sur-Aude,616,0,6767,6767,11
21502,Pouilly-sur-Saône,616,0,4619,4619,7.5
33211,Labarde,616,0,175,175,0.3
40034,Bélus,616,0,4584,4584,7.4
54102,Bruley,616,0,1285,1285,2.1
54118,Charency-Vezin,616,0,7820,7820,12.7
59195,Englos,616,0,10201,10201,16.6
62056,Audresselles,616,0,2451,2451,4
69012,Les Ardillats,616,2540,0,2540,4.1
71370,Rigny-sur-Arroux,616,0,3167,3167,5.1
76111,Bois-l'Évêque,616,0,421,421,0.7
78230,La Falaise,616,0,5733,5733,9.3
79007,Allonne,616,0,16150,16150,26.2
95627,Vallangoujard,616,0,16259,16259,26.4
3204,Paray-sous-Briailles,615,0,12579,12579,20.5
7347,Vocance,615,4526,3168,7694,12.5
19042,Chanteix,615,0,11670,11670,19
24014,Aubas,615,2650,8537,11187,18.2
25348,Longevilles-Mont-d'Or,615,0,36627,36627,59.6
26014,Arthémonay,615,0,27060,27060,44
31175,Estancarbon,615,18200,12739,30939,50.3
34086,Courniou,615,0,2328,2328,3.8
43007,Araules,615,20188,14416,34604,56.3
43039,Le Brignon,615,3380,25590,28970,47.1
52423,Rimaucourt,615,0,9462,9462,15.4
55145,Damvillers,615,0,11240,11240,18.3
57324,Hilbesheim,615,0,4004,4004,6.5
57541,Philippsbourg,615,0,14174,14174,23
63170,La Goutelle,615,0,20796,20796,33.8
67468,Siltzheim,615,327,8405,8732,14.2
73068,Chamousset,615,0,10998,10998,17.9
73253,Saint-Marcel,615,0,47709,47709,77.6
12142,Mayran,614,0,1321,1321,2.2
16071,Chabrac,614,2150,12633,14783,24.1
17030,Balanzac,614,0,15640,15640,25.5
18212,Saint-Germain-des-Bois,614,3410,5719,9129,14.9
21388,Marliens,614,0,14,14,0
31518,Saint-Thomas,614,0,763,763,1.2
35038,Bréal-sous-Vitré,614,0,9225,9225,15
38495,La Sône,614,0,9923,9923,16.2
42033,Le Cergne,614,2461,15930,18391,30
46180,Lunan,614,0,18132,18132,29.5
48128,Rimeize,614,0,6307,6307,10.3
57057,Béchy,614,0,23513,23513,38.3
64470,Saint-Armou,614,6690,6409,13099,21.3
66066,Enveitg,614,0,0,0,0
67195,Hessenheim,614,0,12933,12933,21.1
67304,Morschwiller,614,2394,7466,9860,16.1
72103,Courdemanche,614,0,34624,34624,56.4
77273,Marchémoret,614,0,467,467,0.8
77509,Villeneuve-les-Bordes,614,1784,8695,10479,17.1
78084,Boissy-sans-Avoir,614,0,265,265,0.4
79263,Saint-Laurs,614,0,5061,5061,8.2
89056,Brion,614,3488,4813,8301,13.5
4195,Saint-Pons,613,24920,183070,207990,339.3
11138,Fendeille,613,6710,5386,12096,19.7
26081,Châteaudouble,613,0,12426,12426,20.3
34008,Les Aires,613,0,5707,5707,9.3
35170,Mecé,613,0,9210,9210,15
35290,Saint-Malon-sur-Mel,613,0,11903,11903,19.4
35317,Saint-Symphorien,613,0,13168,13168,21.5
38219,Marcollin,613,0,6688,6688,10.9
38345,Rovon,613,0,9906,9906,16.2
38458,Saint-Sorlin-de-Morestel,613,0,3165,3165,5.2
40163,Lüe,613,0,16729,16729,27.3
43142,Montregard,613,9904,4909,14813,24.2
45303,Sceaux-du-Gâtinais,613,0,6013,6013,9.8
51582,Trigny,613,0,10894,10894,17.8
57553,Pournoy-la-Chétive,613,0,30393,30393,49.6
59283,Hargnies,613,0,1730,1730,2.8
59554,Sars-et-Rosières,613,0,23061,23061,37.6
64406,Morlanne,613,0,9598,9598,15.7
70324,Mailley-et-Chazelot,613,6150,1575,7725,12.6
70348,Moffans-et-Vacheresse,613,0,26946,26946,44
76441,Monchaux-Soreng,613,0,12,12,0
77179,Féricy,613,2300,581,2881,4.7
80034,Athies,613,0,11684,11684,19.1
81174,Montdragon,613,0,9168,9168,15
85209,Saint-Étienne-de-Brillouet,613,0,12955,12955,21.1
2702,Savy,612,0,5545,5545,9.1
12037,Broquiès,612,0,10993,10993,18
26097,Cliousclat,612,0,7413,7413,12.1
33301,Naujan-et-Postiac,612,0,4270,4270,7
47038,Bourran,612,0,5879,5879,9.6
50045,Benoîtville,612,0,19250,19250,31.5
50090,Buais-Les-Monts,612,0,15058,15058,24.6
50277,Longueville,612,0,14812,14812,24.2
53002,Alexain,612,0,22743,22743,37.2
53269,Vautorte,612,0,2781,2781,4.5
54373,Moncel-lès-Lunéville,612,4828,2704,7532,12.3
60396,Méry-la-Bataille,612,0,3391,3391,5.5
62327,Febvin-Palfart,612,0,54468,54468,89
64387,Momas,612,0,9582,9582,15.7
67429,Saint-Pierre,612,4924,18926,23850,39
67479,Steinseltz,612,0,67432,67432,110.2
71365,Rancy,612,0,3567,3567,5.8
72293,Saint-Jean-du-Bois,612,0,3278,3278,5.4
76092,Beuzevillette,612,0,4664,4664,7.6
76436,Le Mesnil-sous-Jumièges,612,2772,17481,20253,33.1
76543,Rouville,612,0,4664,4664,7.6
77511,Villeneuve-sous-Dammartin,612,0,7590,7590,12.4
80100,Bettencourt-Saint-Ouen,612,0,1053,1053,1.7
80613,Oust-Marest,612,0,1760,1760,2.9
86102,Frozes,612,0,31804,31804,52
88044,Bazoilles-sur-Meuse,612,0,6837,6837,11.2
89014,Arces-Dilo,612,2814,1187,4001,6.5
17270,Ozillac,611,0,7215,7215,11.8
24090,Celles,611,15123,4640,19763,32.3
25139,La Chaux,611,0,6691,6691,11
25497,Roches-lès-Blamont,611,0,38679,38679,63.3
26365,Vaunaveys-la-Rochette,611,24550,7401,31951,52.3
36129,Montipouret,611,0,1792,1792,2.9
40127,Hontanx,611,0,5837,5837,9.6
45081,Charsonville,611,0,2518,2518,4.1
47163,Mauvezin-sur-Gupie,611,0,6322,6322,10.3
52398,Poissons,611,0,2263,2263,3.7
53035,Bouchamps-lès-Craon,611,0,4045,4045,6.6
56201,Le Saint,611,0,19530,19530,32
58220,Raveau,611,0,34484,34484,56.4
61279,Mieuxcé,611,874,18057,18931,31
63424,Surat,611,0,4621,4621,7.6
67514,Waldhambach,611,3755,7660,11415,18.7
70526,Vauvillers,611,0,3883,3883,6.4
81084,Escoussens,611,0,680,680,1.1
3006,Arfeuilles,610,0,16711,16711,27.4
5174,Val-des-Prés,610,0,43516,43516,71.3
17465,La Vergne,610,0,16991,16991,27.9
18047,La Chapelle-d'Angillon,610,600,0,600,1
21645,Trouhans,610,0,4574,4574,7.5
27192,Crosville-la-Vieille,610,0,2623,2623,4.3
30066,Cannes-et-Clairan,610,0,45377,45377,74.4
35146,Langouet,610,0,13103,13103,21.5
40320,Uchacq-et-Parentis,610,0,7549,7549,12.4
56250,Théhillac,610,0,8702,8702,14.3
57011,Albestroff,610,0,2019,2019,3.3
62278,Drouvin-le-Marais,610,0,10066,10066,16.5
62854,Villers-au-Bois,610,0,16433,16433,26.9
67033,Bernolsheim,610,0,7417,7417,12.2
67289,Menchhoffen,610,3811,16438,20249,33.2
77233,Iverny,610,2320,464,2784,4.6
11396,Trausse,609,0,3950,3950,6.5
16105,Condéon,609,7295,32564,39859,65.4
17418,Salignac-sur-Charente,609,0,7191,7191,11.8
22200,Pléven,609,0,0,0,0
27480,Puchay,609,0,496,496,0.8
2B318,Taglio-Isolaccio,609,0,4370,4370,7.2
30319,Serviers-et-Labaume,609,0,4680,4680,7.7
38462,Saint-Théoffrey,609,0,6377,6377,10.5
43229,Saint-Vidal,609,2270,25340,27610,45.3
47006,Allez-et-Cazeneuve,609,0,4667,4667,7.7
58228,Saint-Andelain,609,0,12142,12142,19.9
59397,Merckeghem,609,0,11729,11729,19.3
61208,Irai,609,5250,6278,11528,18.9
67510,Wahlenheim,609,0,7405,7405,12.2
76602,Saint-Maclou-de-Folleville,609,0,4914,4914,8.1
2399,Juvincourt-et-Damary,608,0,1636,1636,2.7
4208,Simiane-la-Rotonde,608,21060,1602,22662,37.3
22165,Penguily,608,38485,7338,45823,75.4
27209,Écaquelon,608,0,13734,13734,22.6
33328,Pomerol,608,0,11860,11860,19.5
34191,Pailhès,608,0,1189,1189,2
35086,Combourtillé,608,0,7445,7445,12.2
50276,Lolif,608,0,14959,14959,24.6
50370,Néhou,608,0,19124,19124,31.5
50435,Rocheville,608,0,19124,19124,31.5
52500,Valcourt,608,0,5506,5506,9.1
57361,Kerling-lès-Sierck,608,0,8752,8752,14.4
59078,Beugnies,608,0,4816,4816,7.9
61023,Bailleul,608,0,1284,1284,2.1
71510,Semur-en-Brionnais,608,0,17230,17230,28.3
76314,Graimbouville,608,0,5484,5484,9
1445,Villemotier,607,0,11735,11735,19.3
2242,Crouttes-sur-Marne,607,0,330,330,0.5
2544,Neuve-Maison,607,0,11915,11915,19.6
14452,Morteaux-Coulibœuf,607,0,9509,9509,15.7
16065,Brillac,607,1670,12489,14159,23.3
40068,Cassen,607,0,9506,9506,15.7
41035,Champigny-en-Beauce,607,4019,23264,27283,44.9
43147,Paulhac,607,3286,29748,33034,54.4
58148,Luthenay-Uxeloup,607,0,4058,4058,6.7
64131,Biron,607,0,16344,16344,26.9
67453,Schœnau,607,8245,12786,21031,34.6
73308,Venthon,607,0,14318,14318,23.6
86005,Angliers,607,0,3101,3101,5.1
95213,Épiais-Rhus,607,0,16022,16022,26.4
6070,Gréolières,606,0,7343,7343,12.1
14755,Villerville,606,0,47966,47966,79.2
26185,Mirmande,606,0,7341,7341,12.1
28232,Manou,606,0,431,431,0.7
38250,Montcarra,606,0,3129,3129,5.2
40120,Hastingues,606,0,4510,4510,7.4
50510,Saint-Martin-d'Aubigny,606,0,12662,12662,20.9
58060,Charrin,606,0,31258,31258,51.6
59427,La Neuville,606,0,10343,10343,17.1
60379,Mareuil-la-Motte,606,8930,5298,14228,23.5
62572,Metz-en-Couture,606,0,3013,3013,5
65147,Cieutat,606,0,4549,4549,7.5
72343,Souvigné-sur-Sarthe,606,0,14094,14094,23.3
74174,Mégevette,606,6344,3167,9511,15.7
77365,Le Plessis-Feu-Aussoux,606,0,3080,3080,5.1
1412,Sulignat,605,0,126,126,0.2
2246,Cugny,605,0,86468,86468,142.9
2613,Pontavert,605,0,1628,1628,2.7
12032,Boussac,605,0,18517,18517,30.6
18175,Ourouer-les-Bourdelins,605,1720,1183,2903,4.8
18272,Veaugues,605,2200,10900,13100,21.7
25305,L'Hôpital-du-Grosbois,605,0,4409,4409,7.3
30107,Estézargues,605,0,2378,2378,3.9
37148,Marigny-Marmande,605,0,16416,16416,27.1
37247,Sepmes,605,2863,10502,13365,22.1
38213,Longechenal,605,0,6601,6601,10.9
38392,Saint-Hilaire-de-Brens,605,0,3123,3123,5.2
38539,Vertrieu,605,0,3123,3123,5.2
50161,Le Dézert,605,0,8948,8948,14.8
50464,Saint-Denis-le-Vêtu,605,0,17505,17505,28.9
52456,Saint-Urbain-Maconcourt,605,0,2241,2241,3.7
57544,Plaine-de-Walsch,605,0,3939,3939,6.5
57624,Sainte-Ruffine,605,0,29996,29996,49.6
60043,Bailly,605,0,3074,3074,5.1
60319,La Houssoye,605,1500,13285,14785,24.4
60548,Rosoy-en-Multien,605,0,2369,2369,3.9
62273,Doudeauville,605,0,1747,1747,2.9
64255,Halsou,605,18822,15721,34543,57.1
69216,Saint-Julien-sur-Bibost,605,0,4829,4829,8
11172,Homps,604,0,8184,8184,13.5
21186,Comblanchien,604,0,2897,2897,4.8
40191,Montaut,604,0,13955,13955,23.1
46240,Rocamadour,604,0,19706,19706,32.6
46267,Saint-Germain-du-Bel-Air,604,0,18075,18075,29.9
62355,Fresnes-lès-Montauban,604,1600,752,2352,3.9
65257,Lanne,604,0,5770,5770,9.6
70116,Chagey,604,0,3945,3945,6.5
71126,Chevagny-les-Chevrières,604,6636,15428,22064,36.5
71480,Saint-Sernin-du-Plain,604,0,16607,16607,27.5
72341,Soulitré,604,0,11291,11291,18.7
77446,Savins,604,2400,8554,10954,18.1
79010,Arçais,604,0,8140,8140,13.5
81088,Fauch,604,0,12601,12601,20.9
86202,La Puye,604,0,35986,35986,59.6
1187,Haut Valromey,603,0,6721,6721,11.1
10271,Origny-le-Sec,603,0,0,0,0
11090,Cépie,603,12859,7938,20797,34.5
14024,Auberville,603,0,7660,7660,12.7
21138,Champdôtre,603,0,0,0,0
27129,Caorches-Saint-Nicolas,603,0,2600,2600,4.3
33509,Savignac-de-l'Isle,603,0,11762,11762,19.5
34232,Roquebrun,603,16050,2283,18333,30.4
40139,Laglorieuse,603,0,7463,7463,12.4
45165,Gy-les-Nonains,603,0,1828,1828,3
51115,Champfleury,603,0,10716,10716,17.8
51362,Merfy,603,0,10716,10716,17.8
51518,Saint-Thierry,603,0,10716,10716,17.8
51617,La Veuve,603,0,30649,30649,50.8
55041,Behonne,603,0,7270,7270,12.1
58003,Alligny-en-Morvan,603,0,7105,7105,11.8
69196,Saint-Didier-sur-Beaujeu,603,0,0,0,0
71279,Le Rousset-Marizy,603,0,2338,2338,3.9
76445,Montérolier,603,2100,14086,16186,26.8
86147,Marigny-Chemereau,603,1671,13777,15448,25.6
2717,Séry-lès-Mézières,602,0,0,0,0
3187,Montoldre,602,0,10398,10398,17.3
22119,Lanvellec,602,0,11959,11959,19.9
36207,Saint-Plantaire,602,0,1750,1750,2.9
45268,Saint-Aignan-le-Jaillard,602,0,3526,3526,5.9
45331,Vannes-sur-Cosson,602,0,3526,3526,5.9
57234,Frauenberg,602,0,8227,8227,13.7
57439,Manderen-Ritzing,602,0,8666,8666,14.4
58118,Fours,602,0,31052,31052,51.6
67423,Saessolsheim,602,615,42461,43076,71.6
76056,Bardouville,602,0,17195,17195,28.6
80546,Miannay,602,0,4002,4002,6.6
14535,Reviers,601,0,4046,4046,6.7
32306,Pauilhac,601,0,341,341,0.6
33385,Saint-Christophe-de-Double,601,0,11723,11723,19.5
38488,Siccieu-Saint-Julien-et-Carisieu,601,0,3103,3103,5.2
57154,Coume,601,0,3620,3620,6
57346,Insming,601,0,1989,1989,3.3
57384,Laning,601,0,10262,10262,17.1
57548,Pontoy,601,0,23015,23015,38.3
60393,Mello,601,0,2496,2496,4.2
64521,Serres-Sainte-Marie,601,0,16183,16183,26.9
67129,Ernolsheim-lès-Saverne,601,7746,42390,50136,83.4
78071,Boinville-le-Gaillard,601,4627,1171,5798,9.6
85117,Lairoux,601,3030,12702,15732,26.2
86064,Château-Garnier,601,0,13534,13534,22.5
90047,Fontaine,601,4150,20968,25118,41.8
10409,Villacerf,600,0,8568,8568,14.3
14728,Vaucelles,600,0,23125,23125,38.5
22249,Pont-Melvez,600,0,10744,10744,17.9
25018,Anteuil,600,0,1384,1384,2.3
26194,Montchenu,600,967,26400,27367,45.6
30229,Saint-André-de-Majencoules,600,0,30014,30014,50
31049,Bazus,600,0,6730,6730,11.2
35035,Bovel,600,0,5415,5415,9
35311,Saint-Séglin,600,0,5415,5415,9
49310,Saint-Paul-du-Bois,600,36769,24932,61701,102.8
54127,Chenières,600,0,5602,5602,9.3
57092,Blies-Ébersing,600,0,8200,8200,13.7
60326,Jonquières,600,0,5404,5404,9
60674,Vieux-Moulin,600,0,5404,5404,9
65019,Arcizac-Adour,600,0,5732,5732,9.6
70415,Polaincourt-et-Clairefontaine,600,0,3563,3563,5.9
72135,La Fontaine-Saint-Martin,600,0,4350,4350,7.2
3202,Noyant-d'Allier,599,0,9201,9201,15.4
19213,Saint-Jal,599,7496,11366,18862,31.5
25220,Épeugney,599,0,4365,4365,7.3
26294,Saint-Bardoux,599,1500,12142,13642,22.8
27410,Miserey,599,0,7045,7045,11.8
2B193,Omessa,599,0,2252,2252,3.8
37178,Panzoult,599,0,16253,16253,27.1
38500,Têche,599,0,9680,9680,16.2
42333,Villers,599,7366,15540,22906,38.2
45156,Girolles,599,0,5875,5875,9.8
53055,Chantrigné,599,0,7898,7898,13.2
59642,Warlaing,599,0,7203,7203,12
60211,Éragny-sur-Epte,599,7030,13154,20184,33.7
63009,Ardes,599,0,3894,3894,6.5
63168,Glaine-Montaigut,599,0,5745,5745,9.6
67295,Mittelbergheim,599,7620,18524,26144,43.6
67371,La Petite-Pierre,599,3515,16141,19656,32.8
72332,Ségrie,599,0,28195,28195,47.1
77252,Limoges-Fourches,599,0,8346,8346,13.9
79301,Saint-Vincent-la-Châtre,599,0,17299,17299,28.9
80486,Long,599,0,14833,14833,24.8
2694,Saint-Simon,598,0,85468,85468,142.9
17184,La Gripperie-Saint-Symphorien,598,1073,9848,10921,18.3
18025,Beffes,598,0,2064,2064,3.5
27288,Glos-sur-Risle,598,0,13508,13508,22.6
27313,La Harengère,598,0,17734,17734,29.7
27408,Mézières-en-Vexin,598,0,3142,3142,5.3
33168,Flaujagues,598,0,4173,4173,7
35050,Cardroc,598,0,7486,7486,12.5
35156,Longaulnay,598,0,7486,7486,12.5
39146,Chilly-le-Vignoble,598,1314,18846,20160,33.7
60343,Lalande-en-Son,598,4160,4902,9062,15.2
62156,Bonningues-lès-Calais,598,0,17973,17973,30.1
62254,Coyecques,598,0,53222,53222,89
69236,Saint-Romain-en-Gier,598,0,4601,4601,7.7
71231,La Guiche,598,200,4156,4356,7.3
74254,Saint-Sylvestre,598,0,4619,4619,7.7
85252,Saint-Maurice-le-Girard,598,55526,13066,68592,114.7
90003,Anjoutey,598,6200,17812,24012,40.2
11296,Pouzols-Minervois,597,0,9232,9232,15.5
30084,Codolet,597,0,8712,8712,14.6
39389,Ney,597,0,6044,6044,10.1
51245,Faverolles-et-Coëmy,597,0,10610,10610,17.8
54369,Millery,597,0,5749,5749,9.6
63188,Laps,597,0,10702,10702,17.9
67141,Forstheim,597,0,14445,14445,24.2
68081,Saint-Bernard,597,2580,16015,18595,31.1
70095,Breurey-lès-Faverney,597,0,3546,3546,5.9
72149,Joué-en-Charnie,597,0,5425,5425,9.1
72239,Poillé-sur-Vègre,597,0,5425,5425,9.1
77448,Sept-Sorts,597,5937,2325,8262,13.8
79220,Prin-Deyrançon,597,0,8046,8046,13.5
81206,Penne,597,0,15190,15190,25.4
89369,Saint-Sérotin,597,4150,110,4260,7.1
2619,Prémontré,596,0,590,590,1
8254,Liart,596,0,15581,15581,26.1
15003,Ally,596,19068,9868,28936,48.6
15231,Talizat,596,19260,13183,32443,54.4
15236,Thiézac,596,6480,2662,9142,15.3
21173,Chorey-les-Beaune,596,0,2592,2592,4.3
22268,Ruca,596,0,15878,15878,26.6
31551,Tarabel,596,0,2907,2907,4.9
36025,Briantes,596,0,13092,13092,22
42290,Saint-Thomas-la-Garde,596,0,5340,5340,9
58205,Ouroux-en-Morvan,596,0,7023,7023,11.8
59645,Wasnes-au-Bac,596,0,22422,22422,37.6
77340,Nonville,596,0,2073,2073,3.5
77427,Saint-Mesmes,596,0,453,453,0.8
79050,Bretignolles,596,0,16954,16954,28.4
80295,Étinehem-Méricourt,596,0,666,666,1.1
1082,Chanay,595,0,7165,7165,12
3246,Saint-Martinien,595,0,2421,2421,4.1
6013,Belvédère,595,0,11714,11714,19.7
13012,Beaurecueil,595,0,16723,16723,28.1
15266,Yolet,595,13042,20160,33202,55.8
16136,La Faye,595,3692,13024,16716,28.1
17098,Chenac-Saint-Seurin-d'Uzet,595,4292,9371,13663,23
18210,Saint-Georges-sur-la-Prée,595,11780,8597,20377,34.2
18214,Saint-Hilaire-de-Court,595,0,8597,8597,14.4
24008,Angoisse,595,4860,7481,12341,20.7
30043,Boissières,595,2000,0,2000,3.4
33460,Saint-Pey-de-Castets,595,0,4152,4152,7
36026,Brion,595,0,97,97,0.2
36058,Concremiers,595,0,3271,3271,5.5
40071,Castelnau-Chalosse,595,0,1615,1615,2.7
43048,La Chaise-Dieu,595,7510,24758,32268,54.2
50034,Baudre,595,0,8800,8800,14.8
50217,Le Grand-Celland,595,0,14640,14640,24.6
51144,Cheminon,595,0,5389,5389,9.1
51410,Œuilly,595,0,861,861,1.4
54519,Thiaville-sur-Meurthe,595,0,2629,2629,4.4
54571,Ville-en-Vermois,595,3235,4735,7970,13.4
71251,Laizy,595,0,13312,13312,22.4
71324,Moroges,595,0,9126,9126,15.3
71463,Saint-Maurice-lès-Châteauneuf,595,0,11548,11548,19.4
71516,Serley,595,350,1113,1463,2.5
76002,Alvimare,595,0,4534,4534,7.6
77145,Crisenoy,595,8000,564,8564,14.4
80530,Méricourt-l'Abbé,595,0,79,79,0.1
83084,Montmeyan,595,0,6103,6103,10.3
85028,Bouillé-Courdault,595,0,9325,9325,15.7
90004,Argiésans,595,0,20758,20758,34.9
91671,Villeneuve-sur-Auvers,595,0,4029,4029,6.8
24324,Peyrignac,594,1968,10388,12356,20.8
26034,La Baume-d'Hostun,594,3020,12041,15061,25.4
27632,Le Thil,594,0,484,484,0.8
2B020,Aregno,594,0,0,0,0
30343,Verfeuil,594,0,8668,8668,14.6
42220,Saint-Forgeux-Lespinasse,594,3629,17529,21158,35.6
47221,Réaup-Lisse,594,0,2880,2880,4.8
50593,Teurthéville-Bocage,594,1650,18684,20334,34.2
58037,Brassy,594,0,6999,6999,11.8
58047,Cervon,594,0,9237,9237,15.6
62794,Setques,594,0,1285,1285,2.2
64290,Labastide-Monréjeau,594,0,15994,15994,26.9
64364,Macaye,594,29950,15436,45386,76.4
70177,Corre,594,0,1798,1798,3
74226,Saint-André-de-Boëge,594,0,9543,9543,16.1
76520,Réalcamp,594,0,11,11,0
77184,Flagy,594,0,2066,2066,3.5
80557,Estrées-Mons,594,0,4256,4256,7.2
87127,La Roche-l'Abeille,594,4000,18191,22191,37.4
15117,Marcolès,593,33525,5200,38725,65.3
27181,Courdemanche,593,0,6974,6974,11.8
30268,Saint-Jean-de-Valériscle,593,0,18536,18536,31.3
40195,Montgaillard,593,0,13701,13701,23.1
67077,Cosswiller,593,1830,32207,34037,57.4
68311,Sondernach,593,0,23804,23804,40.1
71300,Le Miroir,593,0,2441,2441,4.1
71416,Saint-Gengoux-de-Scissé,593,0,13800,13800,23.3
72216,Neuvillalais,593,0,11569,11569,19.5
76528,Rieux,593,11525,11,11536,19.5
95510,Puiseux-Pontoise,593,0,17680,17680,29.8
3087,Couleuvre,592,0,9307,9307,15.7
5177,Vars,592,0,19247,19247,32.5
7146,Lyas,592,0,1975,1975,3.3
17237,Moëze,592,2110,9749,11859,20
19201,Saint-Exupéry-les-Roches,592,0,8116,8116,13.7
22001,Allineuc,592,0,0,0,0
29036,Collorec,592,0,4852,4852,8.2
31031,Ausson,592,0,12262,12262,20.7
34042,Brissac,592,5450,12680,18130,30.6
52246,Humes-Jorquenay,592,0,2716,2716,4.6
54311,Lenoncourt,592,0,3503,3503,5.9
57136,Chémery-les-Deux,592,0,8522,8522,14.4
60167,Couloisy,592,6400,4010,10410,17.6
60215,Erquery,592,6910,3140,10050,17
69120,Longessaigne,592,0,29672,29672,50.1
77338,Noisy-Rudignon,592,0,418,418,0.7
79246,Sainte-Eanne,592,0,3291,3291,5.6
80811,Voyennes,592,0,11284,11284,19.1
90043,Faverois,592,0,3521,3521,5.9
1063,Brion,591,0,22356,22356,37.8
10334,Saint-Aubin,591,0,3652,3652,6.2
10437,Virey-sous-Bar,591,0,10317,10317,17.5
12171,Nauviale,591,4701,24386,29087,49.2
15090,Lafeuillade-en-Vézie,591,3816,5182,8998,15.2
21411,Meursanges,591,0,2570,2570,4.3
22260,Le Quillio,591,0,0,0,0
23174,Soumans,591,0,8883,8883,15
31525,Salles-sur-Garonne,591,0,1016,1016,1.7
33160,Eynesse,591,0,4461,4461,7.5
35091,Le Crouais,591,0,11476,11476,19.4
40156,Liposthey,591,0,4650,4650,7.9
51564,Val de Livre,591,0,1461,1461,2.5
52348,Neuilly-l'Évêque,591,0,2712,2712,4.6
57245,Gavisse,591,0,14388,14388,24.3
62519,Lisbourg,591,0,12767,12767,21.6
73075,La Chapelle-Blanche,591,0,10569,10569,17.9
76513,Quevillon,591,0,16881,16881,28.6
81286,Serviès,591,0,8839,8839,15
87034,Champagnac-la-Rivière,591,6490,260,6750,11.4
2053,Vallées en Champagne,590,0,13637,13637,23.1
2199,Clastres,590,0,84324,84324,142.9
8179,Francheval,590,0,13553,13553,23
22306,Saint-Judoce,590,0,15718,15718,26.6
28261,Montigny-le-Chartif,590,0,2183,2183,3.7
33241,Lestiac-sur-Garonne,590,0,18091,18091,30.7
37073,Chisseaux,590,0,13276,13276,22.5
38136,Crachier,590,0,7169,7169,12.2
39021,La Chailleuse,590,300,17171,17471,29.6
46044,Caillac,590,0,4982,4982,8.4
48137,Saint-Bauzile,590,4400,23275,27675,46.9
54061,Bénaménil,590,0,2607,2607,4.4
55167,Dun-sur-Meuse,590,0,21334,21334,36.2
58280,Sougy-sur-Loire,590,0,1522,1522,2.6
62904,Zouafques,590,0,52510,52510,89
71385,Saint-Amour-Bellevue,590,1600,15070,16670,28.3
76115,Bolleville,590,0,4496,4496,7.6
82001,Albefeuille-Lagarde,590,0,5137,5137,8.7
86152,Mauprévoir,590,0,23863,23863,40.4
88284,Mandray,590,0,5736,5736,9.7
89279,Noyers,590,10550,2848,13398,22.7
1380,Saint-Nizier-le-Bouchoux,589,0,11387,11387,19.3
10275,Ossey-les-Trois-Maisons,589,0,0,0,0
21500,Pouillenay,589,0,0,0,0
24054,Bouniagues,589,0,13112,13112,22.3
26167,Luc-en-Diois,589,23560,32748,56308,95.6
27597,Saint-Pierre-du-Val,589,0,4401,4401,7.5
45186,Lorcy,589,0,4464,4464,7.6
47046,Calonges,589,0,6094,6094,10.3
47111,Granges-sur-Lot,589,0,5658,5658,9.6
55443,Rouvres-en-Woëvre,589,0,10640,10640,18.1
57303,Hauconcourt,589,0,1196,1196,2
61207,Igé,589,5240,6838,12078,20.5
62704,Renty,589,0,52421,52421,89
63418,Sermentizon,589,0,13656,13656,23.2
65218,Hèches,589,0,1759,1759,3
67432,Salmbach,589,1770,67542,69312,117.7
74055,Challonges,589,0,14227,14227,24.2
3073,Chemilly,588,0,7915,7915,13.5
7099,Gras,588,0,46873,46873,79.7
8289,Messincourt,588,0,20818,20818,35.4
16400,Verteuil-sur-Charente,588,5069,12871,17940,30.5
32282,Montégut,588,0,20718,20718,35.2
34122,Jonquières,588,0,3176,3176,5.4
40145,Larrivière-Saint-Savin,588,0,2747,2747,4.7
46204,Montfaucon,588,0,3402,3402,5.8
57219,Flévy,588,0,1194,1194,2
57425,Luppy,588,0,22518,22518,38.3
59492,Ramillies,588,0,7643,7643,13
60310,Herchies,588,0,23057,23057,39.2
62166,Bours,588,0,12703,12703,21.6
62903,Zoteux,588,0,34795,34795,59.2
63058,Bulhon,588,0,2701,2701,4.6
68188,Linthal,588,3000,14510,17510,29.8
69167,Rivolet,588,0,12484,12484,21.2
71069,Bussières,588,9583,15019,24602,41.8
89298,Piffonds,588,0,2086,2086,3.5
1125,Corveissiat,587,0,11348,11348,19.3
10110,Courteranges,587,0,8382,8382,14.3
11405,Ventenac-en-Minervois,587,13176,9078,22254,37.9
14377,Longues-sur-Mer,587,0,22624,22624,38.5
24255,Marquay,587,4443,3698,8141,13.9
28211,Logron,587,0,32076,32076,54.6
32095,Caussens,587,0,2257,2257,3.8
32404,Saint-Puy,587,29876,2257,32133,54.7
41184,Prunay-Cassereau,587,5583,7260,12843,21.9
41225,Saint-Martin-des-Bois,587,0,7260,7260,12.4
48016,Balsièges,587,2990,23156,26146,44.5
60443,Muirancourt,587,0,0,0,0
60481,Orrouy,587,0,2298,2298,3.9
61094,La Chapelle-au-Moine,587,0,15722,15722,26.8
63414,Sauviat,587,0,13610,13610,23.2
64114,Bernadets,587,4914,6127,11041,18.8
80188,Chaussoy-Epagny,587,0,3606,3606,6.1
85036,La Bretonnière-la-Claye,587,0,12406,12406,21.1
2002,Achery,586,0,10529,10529,18
2074,Bertaucourt-Epourdon,586,0,10529,10529,18
6071,Guillaumes,586,0,13206,13206,22.5
12248,Saint-Sernin-sur-Rance,586,0,22930,22930,39.1
18289,Vornay,586,0,2701,2701,4.6
60239,Fleury,586,0,12868,12868,22
62196,La Calotterie,586,0,6234,6234,10.6
62614,Nielles-lès-Ardres,586,0,3587,3587,6.1
67104,Drachenbronn-Birlenbach,586,0,64567,64567,110.2
69057,Chevinay,586,0,4677,4677,8
72369,Verneil-le-Chétif,586,0,2938,2938,5
73310,Verel-Pragondran,586,0,7449,7449,12.7
82012,Les Barthes,586,0,2988,2988,5.1
86135,Liniers,586,1700,34913,36613,62.5
11212,Mailhac,585,0,9047,9047,15.5
16378,Taizé-Aizie,585,4500,12805,17305,29.6
28055,Le Boullay-Thierry,585,0,782,782,1.3
57449,Marsilly,585,0,1424,1424,2.4
64101,Baudreix,585,0,6256,6256,10.7
64501,Sallespisse,585,0,15752,15752,26.9
66046,Caudiès-de-Fenouillèdes,585,0,14304,14304,24.5
66103,Marquixanes,585,0,17521,17521,30
68008,Appenwihr,585,0,10153,10153,17.4
72104,Courgains,585,0,10848,10848,18.5
72160,Lavernat,585,0,32989,32989,56.4
74151,Lornay,585,0,7922,7922,13.5
76128,Bosville,585,5700,3789,9489,16.2
14438,Mondrainville,584,0,1033,1033,1.8
24398,Saint-Estèphe,584,2900,3913,6813,11.7
37277,Villeloin-Coulangé,584,0,10137,10137,17.4
39018,Aromas,584,330,16996,17326,29.7
39169,Courbouzon,584,2153,18404,20557,35.2
53043,Brée,584,0,4177,4177,7.2
60440,Moyenneville,584,0,3236,3236,5.5
61454,Sainte-Scolasse-sur-Sarthe,584,4760,206,4966,8.5
64095,Barinque,584,4800,6096,10896,18.7
66004,Les Angles,584,0,0,0,0
67501,Uttenheim,584,2390,10797,13187,22.6
72331,Sceaux-sur-Huisne,584,0,3563,3563,6.1
80003,Acheux-en-Amiénois,584,0,653,653,1.1
80633,Ponthoile,584,0,14461,14461,24.8
84094,Puyméras,584,0,683,683,1.2
88092,Charmois-l'Orgueilleux,584,0,14686,14686,25.1
89283,Ouanne,584,15086,26370,41456,71
91435,Morsang-sur-Seine,584,0,11579,11579,19.8
91654,Videlles,584,0,20347,20347,34.8
10237,Mesnil-Saint-Loup,583,0,0,0,0
12267,La Selve,583,0,31814,31814,54.6
24160,Église-Neuve-de-Vergt,583,4145,3256,7401,12.7
52429,Roches-sur-Marne,583,0,5280,5280,9.1
59407,Monchaux-sur-Écaillon,583,0,11231,11231,19.3
60611,Senantes,583,0,2860,2860,4.9
68170,Kœtzingue,583,0,11332,11332,19.4
71359,Préty,583,0,13568,13568,23.3
76725,Vattetot-sous-Beaumont,583,0,6904,6904,11.8
76739,Vieux-Rouen-sur-Bresle,583,0,11,11,0
79342,Vernoux-en-Gâtine,583,0,15285,15285,26.2
83139,Tourtour,583,0,2271,2271,3.9
86094,Dienné,583,0,13320,13320,22.8
88467,Thiéfosse,583,0,4554,4554,7.8
17286,Les Portes-en-Ré,582,0,35937,35937,61.7
18254,Soye-en-Septaine,582,0,2682,2682,4.6
18290,Vouzeron,582,2165,8409,10574,18.2
26331,Saint-Thomas-en-Royans,582,570,36450,37020,63.6
26336,Saou,582,9277,7050,16327,28.1
28317,Roinville,582,0,16959,16959,29.1
30349,Vic-le-Fesq,582,0,1210,1210,2.1
33370,Saint-Androny,582,0,5425,5425,9.3
34016,Aumelas,582,21000,3144,24144,41.5
39560,Villard-Saint-Sauveur,582,1400,2143,3543,6.1
40035,Bénesse-lès-Dax,582,4725,4982,9707,16.7
41083,La Ferté-Beauharnais,582,0,4856,4856,8.3
57475,Mondorff,582,0,14169,14169,24.3
64288,Labastide-Cézéracq,582,0,15671,15671,26.9
65054,Avezac-Prat-Lahitte,582,0,1738,1738,3
67494,Trimbach,582,0,66739,66739,114.7
86275,Usseau,582,0,13246,13246,22.8
89265,Montigny-la-Resle,582,4358,11386,15744,27.1
95298,Haravilliers,582,0,26741,26741,45.9
95456,Noisy-sur-Oise,582,0,2073,2073,3.6
11327,Roullens,581,0,3768,3768,6.5
14495,Périers-sur-le-Dan,581,0,12928,12928,22.3
16169,Javrezac,581,4340,21738,26078,44.9
31365,Montbrun-Bocage,581,0,999,999,1.7
33373,Saint-Antoine-sur-l'Isle,581,0,11333,11333,19.5
35140,Lalleu,581,6738,8456,15194,26.2
51265,Gaye,581,0,7581,7581,13
54189,Favières,581,0,19263,19263,33.2
60001,Abancourt,581,0,2850,2850,4.9
69209,Saint-Igny-de-Vers,581,0,0,0,0
71489,Saint-Vincent-en-Bresse,581,0,2392,2392,4.1
71556,Varennes-lès-Mâcon,581,0,14840,14840,25.5
9113,Ercé,580,0,70284,70284,121.2
10094,Chavanges,580,0,12244,12244,21.1
10331,Rumilly-lès-Vaudes,580,0,10125,10125,17.5
11131,Val-du-Faby,580,15000,6372,21372,36.8
27154,Chavigny-Bailleul,580,0,6821,6821,11.8
27468,Pont-Authou,580,0,13101,13101,22.6
27591,Saint-Pierre-de-Cormeilles,580,0,8932,8932,15.4
41003,Areines,580,280,7174,7454,12.9
51049,Bergères-lès-Vertus,580,0,11526,11526,19.9
59119,Buysscheure,580,0,3544,3544,6.1
61050,Cour-Maugis sur Huisne,580,7145,6797,13942,24
62359,Fressin,580,0,34322,34322,59.2
80509,Marchélepot-Misery,580,0,10497,10497,18.1
82141,Pommevic,580,0,62316,62316,107.4
87167,Saint-Martin-Terressus,580,0,2387,2387,4.1
8262,Lucquy,579,0,12699,12699,21.9
16068,Cellefrouin,579,3475,7279,10754,18.6
27578,Sainte-Marie-d'Attez,579,0,16284,16284,28.1
29298,Tréogat,579,0,18546,18546,32
2B016,Antisanti,579,0,4408,4408,7.6
32076,Castelnau-Barbarens,579,0,20401,20401,35.2
44112,Noyal-sur-Brutz,579,0,9711,9711,16.8
57469,Mittersheim,579,0,3769,3769,6.5
62003,Acheville,579,0,15598,15598,26.9
62225,Clairmarais,579,5545,51531,57076,98.6
62583,Mondicourt,579,0,4811,4811,8.3
64533,Tardets-Sorholus,579,18300,15046,33346,57.6
70104,Bucey-lès-Gy,579,0,2618,2618,4.5
73050,Bourdeau,579,0,3203,3203,5.5
76437,Meulers,579,0,3662,3662,6.3
76494,Parc-d'Anxtot,579,0,4413,4413,7.6
76649,Saint-Saire,579,0,13525,13525,23.4
77129,Coulombs-en-Valois,579,0,8502,8502,14.7
89428,Vallery,579,0,2054,2054,3.5
1393,Sandrans,578,0,120,120,0.2
14461,Mutrécy,578,0,17474,17474,30.2
15248,Valuéjols,578,9200,12785,21985,38
17389,Sainte-Radegonde,578,100,14723,14823,25.6
17469,Villars-en-Pons,578,3410,9629,13039,22.6
18120,Jussy-le-Chaudrier,578,0,1995,1995,3.5
24450,Saint-Martial-de-Nabirat,578,6364,990,7354,12.7
25502,Roset-Fluans,578,0,10184,10184,17.6
57042,Avricourt,578,0,3763,3763,6.5
60170,Courteuil,578,0,0,0,0
67422,Saasenheim,578,0,12175,12175,21.1
68230,Nambsheim,578,0,10032,10032,17.4
70206,Échenans-sous-Mont-Vaudois,578,0,3775,3775,6.5
73307,Valmeinier,578,0,15990,15990,27.7
77187,Fontaine-Fourches,578,2050,8186,10236,17.7
80556,Mons-Boubert,578,0,1763,1763,3.1
80679,Ronssoy,578,0,4141,4141,7.2
88262,Laveline-devant-Bruyères,578,0,758,758,1.3
3305,Verneix,577,0,20613,20613,35.7
4066,Curbans,577,14000,818,14818,25.7
17263,Nieul-le-Virouil,577,0,6813,6813,11.8
25332,Lavernay,577,0,390,390,0.7
32348,Roquelaure,577,0,20331,20331,35.2
36168,Prissac,577,0,11637,11637,20.2
37218,Saint-Flovier,577,8463,10016,18479,32
39325,Mesnay,577,1360,12762,14122,24.5
50148,Couvains,577,0,8534,8534,14.8
60361,Liancourt-Saint-Pierre,577,3425,12671,16096,27.9
62158,Boubers-sur-Canche,577,0,12465,12465,21.6
67138,Fessenheim-le-Bas,577,2681,10978,13659,23.7
72131,Fercé-sur-Sarthe,577,0,3090,3090,5.4
73297,Tournon,577,0,13611,13611,23.6
76070,Bellencombre,577,0,13479,13479,23.4
77246,Léchelle,577,0,2080,2080,3.6
82020,Bouillac,577,0,7743,7743,13.4
1352,Saint-Étienne-sur-Reyssouze,576,0,7911,7911,13.7
26232,Peyrus,576,500,11676,12176,21.1
27207,Drucourt,576,0,8870,8870,15.4
30230,Saint-André-de-Roquepertuis,576,0,8405,8405,14.6
38032,Beaufort,576,0,6284,6284,10.9
38113,Clelles,576,0,16136,16136,28
38446,Saint-Pierre-d'Entremont,576,0,39440,39440,68.5
40074,Castel-Sarrazin,576,0,1564,1564,2.7
48104,Nasbinals,576,46561,21286,67847,117.8
50408,Pontaubault,576,0,14172,14172,24.6
60073,Blacourt,576,0,4722,4722,8.2
61432,Saint-Michel-Tubœuf,576,8700,5938,14638,25.4
62469,Inchy-en-Artois,576,0,717,717,1.2
62832,Tubersent,576,0,6128,6128,10.6
63008,Arconsat,576,0,13355,13355,23.2
71525,Sologny,576,7222,14713,21935,38.1
76106,Bois-d'Ennebourg,576,0,394,394,0.7
76740,La Vieux-Rue,576,0,394,394,0.7
84139,Fontaine-de-Vaucluse,576,0,4803,4803,8.3
3083,Contigny,575,0,11761,11761,20.5
5148,Saint-Laurent-du-Cros,575,0,38257,38257,66.5
12046,Camjac,575,0,17599,17599,30.6
12213,Saint-Beauzély,575,0,10328,10328,18
17202,Landes,575,0,16016,16016,27.9
17317,Saint-Ciers-du-Taillon,575,0,6789,6789,11.8
27644,Tilly,575,0,3021,3021,5.3
41065,Coulommiers-la-Tour,575,19232,7112,26344,45.8
53193,Ruillé-Froid-Fonds,575,0,3455,3455,6
58281,Suilly-la-Tour,575,0,11464,11464,19.9
59141,Cauroir,575,0,7474,7474,13
62162,Bourecq,575,0,9489,9489,16.5
62612,Neuvireuil,575,0,715,715,1.2
81138,Lasgraisses,575,0,31592,31592,54.9
2776,Vendhuile,574,0,5201,5201,9.1
9223,Oust,574,0,69557,69557,121.2
10239,Mesnil-Sellières,574,4005,2135,6140,10.7
11148,Fontcouverte,574,7225,7777,15002,26.1
17410,Saint-Thomas-de-Conac,574,0,6778,6778,11.8
21493,Poncey-lès-Athée,574,0,0,0,0
28425,Ymeray,574,0,3331,3331,5.8
36007,Argy,574,0,909,909,1.6
64104,Bedous,574,0,12361,12361,21.5
80555,Monchy-Lagache,574,0,10940,10940,19.1
7085,Empurany,573,2660,16405,19065,33.3
11421,Villedaigne,573,0,8861,8861,15.5
14037,Malherbe-sur-Ajon,573,0,21248,21248,37.1
22110,Lanmérin,573,0,11383,11383,19.9
31442,Puydaniel,573,0,3014,3014,5.3
37116,Les Hermites,573,0,2514,2514,4.4
39009,Andelot-en-Montagne,573,2200,5801,8001,14
39217,L'Étoile,573,100,18058,18158,31.7
42161,Notre-Dame-de-Boisset,573,1500,16909,18409,32.1
47172,Moncaut,573,0,2778,2778,4.8
51318,Lavannes,573,0,10183,10183,17.8
59255,Fressies,573,0,7448,7448,13
64522,Sévignacq-Meyracq,573,1400,7273,8673,15.1
77057,Bussières,573,0,2232,2232,3.9
77527,Voinsles,573,0,2912,2912,5.1
3242,Saint-Loup,572,0,11700,11700,20.5
7178,Pont-de-Labeaume,572,10328,2350,12678,22.2
14289,Fresné-la-Mère,572,0,8960,8960,15.7
16384,Touvérac,572,9400,30586,39986,69.9
22039,La Chèze,572,0,0,0,0
23165,Royère-de-Vassivière,572,0,17935,17935,31.4
47206,Pinel-Hauterive,572,0,4616,4616,8.1
57337,Hoste,572,0,18236,18236,31.9
59057,Beaudignies,572,0,1614,1614,2.8
60486,Paillart,572,0,12899,12899,22.6
65042,Asté,572,0,4293,4293,7.5
67054,Bolsenheim,572,6545,10576,17121,29.9
67187,Heidolsheim,572,0,12049,12049,21.1
71225,Granges,572,0,8773,8773,15.3
72021,Avoise,572,0,13303,13303,23.3
73022,Attignat-Oncin,572,0,29303,29303,51.2
78236,Flexanville,572,0,247,247,0.4
2706,Septmonts,571,0,4777,4777,8.4
9334,Val-de-Sos,571,0,82233,82233,144
16272,Puyréaux,571,432,7178,7610,13.3
16283,Ronsenac,571,0,26850,26850,47
25631,Vorges-les-Pins,571,0,10061,10061,17.6
45220,Nancray-sur-Rimarde,571,0,4328,4328,7.6
46153,Lanzac,571,0,18629,18629,32.6
55514,Trémont-sur-Saulx,571,0,6884,6884,12.1
57052,Barst,571,0,18204,18204,31.9
57255,Gosselming,571,0,3717,3717,6.5
60053,Beaulieu-les-Fontaines,571,5150,4992,10142,17.8
67116,Ebersmunster,571,0,10985,10985,19.2
68160,Kappelen,571,16683,11098,27781,48.7
79095,Clussais-la-Pommeraie,571,0,16491,16491,28.9
80392,Grouches-Luchuel,571,0,2226,2226,3.9
80643,Prouzel,571,0,788,788,1.4
86262,Sillars,571,15397,23094,38491,67.4
2352,Gouy,570,0,5164,5164,9.1
14251,Esson,570,0,17232,17232,30.2
23244,Saint-Sulpice-le-Dunois,570,0,17017,17017,29.9
2A211,Petreto-Bicchisano,570,0,0,0,0
31586,Villeneuve-Lécussan,570,0,11807,11807,20.7
32123,Escornebœuf,570,0,7240,7240,12.7
46202,Montdoumerc,570,0,3205,3205,5.6
50279,Le Lorey,570,0,8430,8430,14.8
53108,La Gravelle,570,0,24807,24807,43.5
64254,Hagetaubin,570,0,15348,15348,26.9
77174,Everly,570,29120,8072,37192,65.2
79046,Le Bourdet,570,508,7682,8190,14.4
86203,Queaux,570,0,23054,23054,40.4
91186,Courson-Monteloup,570,0,2629,2629,4.6
1299,Le Plantay,569,0,119,119,0.2
7162,Montréal,569,20850,8965,29815,52.4
11340,Sainte-Eulalie,569,0,3691,3691,6.5
18038,Bruère-Allichamps,569,3100,2507,5607,9.9
28247,Le Mesnil-Simon,569,0,761,761,1.3
32285,Montesquiou,569,0,8627,8627,15.2
34117,Graissessac,569,6050,5298,11348,19.9
36176,Ruffec,569,0,3128,3128,5.5
47292,Sauveterre-la-Lémance,569,0,3278,3278,5.8
49358,Turquant,569,8348,5544,13892,24.4
51372,Moncetz-Longevas,569,0,28921,28921,50.8
70168,Conflans-sur-Lanterne,569,0,3616,3616,6.4
71145,Cormatin,569,0,6893,6893,12.1
71218,Gibles,569,0,11044,11044,19.4
72004,Amné,569,0,5170,5170,9.1
74135,Giez,569,0,4692,4692,8.2
82159,Saint-Cirq,569,0,16824,16824,29.6
95308,Hérouville-en-Vexin,569,0,15019,15019,26.4
11390,Thézan-des-Corbières,568,0,7696,7696,13.5
15181,Saint-Constant-Fournoulès,568,7850,4980,12830,22.6
17182,La Grève-sur-Mignon,568,0,8276,8276,14.6
19258,Servières-le-Château,568,0,1686,1686,3
21008,Alise-Sainte-Reine,568,0,0,0,0
25101,Burgille,568,0,384,384,0.7
38167,Flachères,568,0,3040,3040,5.4
38531,Velanne,568,0,9649,9649,17
39131,La Chaux-du-Dombief,568,15850,4045,19895,35
39210,Équevillon,568,1489,5751,7240,12.7
54574,Villers-la-Chèvre,568,0,7211,7211,12.7
65401,Salles-Adour,568,0,5426,5426,9.6
69225,Saint-Marcel-l'Éclairé,568,0,6714,6714,11.8
71219,Gigny-sur-Saône,568,0,6881,6881,12.1
77138,Courtomer,568,0,2887,2887,5.1
78278,Goupillières,568,0,245,245,0.4
88385,Remoncourt,568,0,200,200,0.4
12061,Castelnau-de-Mandailles,567,0,53700,53700,94.7
14436,Monceaux-en-Bessin,567,0,21853,21853,38.5
15235,Les Ternes,567,5100,12541,17641,31.1
26319,Saint-Michel-sur-Savasse,567,1987,11494,13481,23.8
27251,Fontaine-l'Abbé,567,0,2444,2444,4.3
37094,Cussay,567,1202,9842,11044,19.5
42098,Fourneaux,567,21500,16074,37574,66.3
50413,Précey,567,0,13951,13951,24.6
54165,Dommartemont,567,0,18935,18935,33.4
55224,Haironville,567,0,11083,11083,19.5
57117,Buding,567,0,3633,3633,6.4
57488,Moussey,567,0,3691,3691,6.5
59628,Volckerinckhove,567,0,10920,10920,19.3
61055,Boucé,567,1860,1198,3058,5.4
62247,Coupelle-Vieille,567,0,33553,33553,59.2
62796,Simencourt,567,0,4711,4711,8.3
64370,Maucor,567,2850,5919,8769,15.5
71213,La Genête,567,0,3305,3305,5.8
87164,Saint-Martin-de-Jussac,567,4143,12400,16543,29.2
91482,Pecqueuse,567,0,2616,2616,4.6
7068,Colombier-le-Jeune,566,23086,24904,47990,84.8
7168,Orgnac-l'Aven,566,0,34562,34562,61.1
7294,Saint-Sauveur-de-Cruzières,566,0,22973,22973,40.6
16011,Anais,566,12650,7115,19765,34.9
50138,Colomby,566,0,17803,17803,31.5
57095,Boucheporn,566,0,26265,26265,46.4
57195,Epping,566,0,13044,13044,23
63326,Saint-Bonnet-près-Orcival,566,0,1772,1772,3.1
63405,Sallèdes,566,0,10146,10146,17.9
69042,La Chapelle-sur-Coise,566,3522,28369,31891,56.3
71018,Bantanges,566,0,3299,3299,5.8
73077,Les Chapelles,566,0,12025,12025,21.2
79241,Saint-Christophe-sur-Roc,566,0,4665,4665,8.2
88077,Brû,566,0,2824,2824,5
18031,Blet,565,0,1105,1105,2
33204,Hure,565,2120,4600,6720,11.9
38350,Sainte-Agnès,565,0,10498,10498,18.6
39335,Moissey,565,7390,11467,18857,33.4
42221,Sainte-Foy-Saint-Sulpice,565,0,5062,5062,9
42245,Vêtre-sur-Anzon,565,10913,5062,15975,28.3
45109,Coulmiers,565,0,2328,2328,4.1
45195,Mareau-aux-Bois,565,0,702,702,1.2
47290,La Sauvetat-du-Dropt,565,0,10522,10522,18.6
49216,Montreuil-sur-Loir,565,0,4323,4323,7.7
51339,Mairy-sur-Marne,565,0,943,943,1.7
51532,Sermiers,565,0,10041,10041,17.8
66137,Le Perthus,565,0,23433,23433,41.5
67298,Mittelschaeffolsheim,565,600,6870,7470,13.2
70492,Soing-Cubry-Charentenay,565,0,1451,1451,2.6
71347,Perreuil,565,0,9079,9079,16.1
74035,Bloye,565,4339,7651,11990,21.2
76363,Hodeng-au-Bosc,565,8800,11,8811,15.6
80171,Caours,565,0,1724,1724,3.1
82192,Verlhac-Tescou,565,0,4586,4586,8.1
86002,Amberre,565,0,29361,29361,52
86125,Leigné-les-Bois,565,0,12859,12859,22.8
89091,Châtel-Censoir,565,4817,1225,6042,10.7
89122,Courgenay,565,2940,1096,4036,7.1
3127,Hérisson,564,0,8867,8867,15.7
17382,Saint-Pierre-d'Amilly,564,0,23337,23337,41.4
2B172,Murato,564,0,3410,3410,6
40162,Lucbardez-et-Bargues,564,0,6980,6980,12.4
42152,Nandax,564,0,14632,14632,25.9
45136,Ervauville,564,0,1710,1710,3
57148,Colligny-Maizery,564,0,1373,1373,2.4
57407,Lixheim,564,0,1132,1132,2
59091,Borre,564,0,3446,3446,6.1
60028,Aumont-en-Halatte,564,0,0,0,0
62512,Ligny-lès-Aire,564,0,9307,9307,16.5
63181,Jozerand,564,0,3721,3721,6.6
71074,Chaintré,564,0,14406,14406,25.5
78324,Jouy-Mauvoisin,564,0,5249,5249,9.3
86059,Chapelle-Viviers,564,7994,22811,30805,54.6
8349,Pure,563,0,19932,19932,35.4
18282,Villabon,563,0,2595,2595,4.6
2B188,Olmeta-di-Tuda,563,0,3403,3403,6
33444,Saint-Martin-de-Sescas,563,0,4584,4584,8.1
50240,Helleville,563,4830,17709,22539,40
63182,Jumeaux,563,0,3660,3660,6.5
68019,Baltzenheim,563,0,9771,9771,17.4
77223,Gurcy-le-Châtel,563,2754,7973,10727,19.1
80542,Mesnil-Saint-Nicaise,563,0,10731,10731,19.1
86299,Vouzailles,563,5410,29257,34667,61.6
87197,Thouron,563,1000,912,1912,3.4
89278,Noé,563,5700,3741,9441,16.8
9030,Auzat,562,0,80937,80937,144
15164,Roffiac,562,5130,12431,17561,31.2
16425,Yvrac-et-Malleyrand,562,1165,10022,11187,19.9
22189,Plésidy,562,0,10063,10063,17.9
35260,Saint-Christophe-des-Bois,562,0,8443,8443,15
37065,Chaveignes,562,0,15249,15249,27.1
42295,Les Salles,562,14276,10543,24819,44.2
47190,Montpezat,562,0,5399,5399,9.6
56227,Saint-Malo-des-Trois-Fontaines,562,0,8463,8463,15.1
59658,Wicres,562,0,9307,9307,16.6
62646,Palluel,562,0,699,699,1.2
71256,Lessard-en-Bresse,562,0,3276,3276,5.8
76273,Fontaine-sous-Préaux,562,0,16053,16053,28.6
79163,Mairé-Levescault,562,0,16231,16231,28.9
80024,Argœuves,562,0,967,967,1.7
80751,Thennes,562,0,3452,3452,6.1
82039,Cayrac,562,0,16617,16617,29.6
86079,La Roche-Rigault,562,0,2871,2871,5.1
87180,Saint-Sornin-Leulac,562,0,17057,17057,30.4
2065,Bellicourt,561,0,5083,5083,9.1
14034,Avenay,561,0,992,992,1.8
14486,Ouilly-le-Tesson,561,0,8788,8788,15.7
14713,Montillières-sur-Orne,561,0,16960,16960,30.2
40196,Montsoué,561,0,12961,12961,23.1
51158,Val-des-Marais,561,0,11149,11149,19.9
54022,Arnaville,561,0,3349,3349,6
60026,Auchy-la-Montagne,561,0,21998,21998,39.2
68237,Niedermorschwihr,561,0,11529,11529,20.6
79238,Saint-Aubin-du-Plain,561,0,15959,15959,28.4
80265,Embreville,561,0,1613,1613,2.9
80645,Puchevillers,561,0,627,627,1.1
82170,Saint-Paul-d'Espis,561,0,60275,60275,107.4
3131,Isserpent,560,0,1126,1126,2
5178,Ventavon,560,0,16695,16695,29.8
14145,Cauvicourt,560,0,16930,16930,30.2
23062,Chéniers,560,0,16719,16719,29.9
24491,Saint-Rabier,560,4120,9794,13914,24.8
37066,Chédigny,560,0,9721,9721,17.4
42130,Magneux-Haute-Rive,560,0,5017,5017,9
42141,Mars,560,0,14529,14529,25.9
47248,Saint-Jean-de-Thurac,560,0,12819,12819,22.9
53028,Belgeard,560,0,20810,20810,37.2
59451,Orsinval,560,0,1580,1580,2.8
78415,Montainville,560,0,1314,1314,2.3
4031,Bras-d'Asse,559,2935,23430,26365,47.2
10190,Laubressel,559,0,7983,7983,14.3
13008,Aurons,559,0,15712,15712,28.1
14499,Petiville,559,0,7101,7101,12.7
25278,Gonsans,559,0,6603,6603,11.8
25406,Montrond-le-Château,559,0,4074,4074,7.3
27698,Vitot,559,0,2404,2404,4.3
30180,Montignargues,559,0,2059,2059,3.7
32180,Lagraulet-du-Gers,559,0,2149,2149,3.8
33306,Noaillac,559,0,4551,4551,8.1
37142,Maillé,559,0,15168,15168,27.1
42251,Saint-Laurent-la-Conche,559,1770,10132,11902,21.3
47144,Lavergne,559,0,10410,10410,18.6
53209,Saint-Cyr-le-Gravelais,559,0,24328,24328,43.5
63232,Mons,559,0,2285,2285,4.1
63235,Montcel,559,0,3688,3688,6.6
63419,Servant,559,0,868,868,1.6
67287,Melsheim,559,0,18786,18786,33.6
71354,Poisson,559,0,2167,2167,3.9
74221,Le Reposoir,559,0,5086,5086,9.1
80424,Hébécourt,559,0,35838,35838,64.1
82137,Parisot,559,0,7905,7905,14.1
89334,Le Val d'Ocre,559,3550,13221,16771,30
2112,Brancourt-le-Grand,558,0,5056,5056,9.1
2368,Haramont,558,0,537,537,1
12106,Gabriac,558,0,2763,2763,5
12161,Mouret,558,0,23024,23024,41.3
14421,Le Mesnil-Guillaume,558,0,6211,6211,11.1
16023,Aunac-sur-Charente,558,2890,7015,9905,17.8
22104,Languédias,558,0,14865,14865,26.6
23139,Moutier-Malcard,558,0,1501,1501,2.7
24029,Beaupouyet,558,3150,26720,29870,53.5
25336,Liesle,558,0,4066,4066,7.3
25569,Trépot,558,0,4066,4066,7.3
27358,Jouy-sur-Eure,558,0,6563,6563,11.8
28149,La Ferté-Vidame,558,0,9961,9961,17.9
30306,Salinelles,558,2000,41509,43509,78
33242,Les Lèves-et-Thoumeyragues,558,0,4212,4212,7.5
37056,La Chapelle-aux-Naux,558,0,8882,8882,15.9
40086,Coudures,558,0,12892,12892,23.1
46012,Aynac,558,0,16478,16478,29.5
51636,Villers-Marmery,558,0,9917,9917,17.8
52305,Mandres-la-Côte,558,0,61292,61292,109.8
57427,Lutzelbourg,558,0,1120,1120,2
59246,Forest-en-Cambrésis,558,0,1575,1575,2.8
59311,Honnechy,558,0,3834,3834,6.9
71110,Chassigny-sous-Dun,558,0,10830,10830,19.4
73200,Planaise,558,0,9979,9979,17.9
86026,Beuxes,558,0,2850,2850,5.1
3065,Châtel-de-Neuvre,557,0,8556,8556,15.4
6106,Roquestéron,557,0,12552,12552,22.5
16107,Coulgens,557,1160,9933,11093,19.9
22243,Plusquellec,557,0,9974,9974,17.9
25393,Montécheroux,557,0,3880,3880,7
27054,Bémécourt,557,0,15665,15665,28.1
27666,La Vacherie,557,0,16518,16518,29.7
31361,Montaut,557,0,958,958,1.7
41271,Vernou-en-Sologne,557,4014,4648,8662,15.6
48002,Albaret-Sainte-Marie,557,0,5722,5722,10.3
54540,Val-et-Châtillon,557,0,1976,1976,3.5
57140,Chesny,557,0,27616,27616,49.6
69060,Claveisolles,557,0,6584,6584,11.8
71565,Vendenesse-sur-Arroux,557,0,2863,2863,5.1
77164,Échouboulains,557,8540,528,9068,16.3
81208,Peyrole,557,0,30603,30603,54.9
95170,Condécourt,557,0,25592,25592,45.9
2046,Barenton-Bugny,556,0,2801,2801,5
3132,Jaligny-sur-Besbre,556,0,9603,9603,17.3
24150,Daglan,556,15935,952,16887,30.4
34045,Cabrières,556,10050,633,10683,19.2
37084,Couesmes,556,0,5158,5158,9.3
37147,Marcilly-sur-Vienne,556,0,15086,15086,27.1
53228,Blandouet-Saint Jean,556,0,3977,3977,7.2
58254,Saint-Martin-d'Heuille,556,0,31380,31380,56.4
71533,Tancon,556,0,10791,10791,19.4
74313,Vovray-en-Bornes,556,10393,9996,20389,36.7
78202,Drocourt,556,0,5175,5175,9.3
80456,Lafresguimont-Saint-Martin,556,0,768,768,1.4
84140,Vaugines,556,0,5419,5419,9.7
89189,Gisy-les-Nobles,556,3275,102,3377,6.1
9019,Artigat,555,0,9871,9871,17.8
11151,Fontiès-d'Aude,555,0,3600,3600,6.5
12159,Morlhon-le-Haut,555,0,1619,1619,2.9
14127,Campagnolles,555,0,254,254,0.5
24120,Cherveix-Cubas,555,7995,6978,14973,27
31264,Lagrâce-Dieu,555,0,2919,2919,5.3
31380,Montgeard,555,0,2707,2707,4.9
34096,Faugères,555,0,1086,1086,2
42066,Cleppé,555,8000,10060,18060,32.5
43217,Saint-Pierre-du-Champ,555,0,23093,23093,41.6
47133,Lamontjoie,555,0,2691,2691,4.8
53013,Averton,555,0,4936,4936,8.9
54334,Mairy-Mainville,555,0,2445,2445,4.4
57564,Réchicourt-le-Château,555,0,3613,3613,6.5
58063,Château-Chinon (Campagne),555,1360,6540,7900,14.2
60165,Le Coudray-sur-Thelle,555,0,2305,2305,4.2
61288,Montmerrei,555,5755,3482,9237,16.6
62592,Moringhem,555,0,49395,49395,89
62716,Rodelinghem,555,0,3397,3397,6.1
63404,Saint-Yvoine,555,0,3608,3608,6.5
68045,Bourbach-le-Bas,555,0,9340,9340,16.8
70165,Combeaufontaine,555,0,1680,1680,3
72298,Saint-Mars-de-Locquenay,555,0,0,0,0
80213,Cottenchy,555,0,3409,3409,6.1
80350,Franvillers,555,0,73,73,0.1
84018,Blauvac,555,720,9004,9724,17.5
86044,Ceaux-en-Loudun,555,0,2835,2835,5.1
36195,Saint-Georges-sur-Arnon,554,0,13080,13080,23.6
63317,Saint-André-le-Coq,554,0,2264,2264,4.1
71353,Plottes,554,75,12893,12968,23.4
76442,Monchy-sur-Eu,554,0,1593,1593,2.9
90058,Lachapelle-sous-Rougemont,554,3900,16502,20402,36.8
3279,Teillet-Argenty,553,0,13017,13017,23.5
6016,Beuil,553,0,12462,12462,22.5
7002,Ailhon,553,0,9439,9439,17.1
23220,Saint-Médard-la-Rochette,553,0,7260,7260,13.1
24188,Fossemagne,553,6240,9671,15911,28.8
28057,Bouville,553,0,1017,1017,1.8
28105,Combres,553,0,394,394,0.7
30018,Aspères,553,0,41137,41137,74.4
46187,Mauroux,553,0,20107,20107,36.4
49359,Les Ulmes,553,0,5388,5388,9.7
50446,Saint-André-de-l'Épine,553,0,8179,8179,14.8
52492,Torcenay,553,0,10906,10906,19.7
57730,Volmerange-lès-Boulay,553,0,3331,3331,6
59150,Cobrieux,553,0,9438,9438,17.1
60030,Auteuil,553,0,21685,21685,39.2
60357,Léglantiers,553,0,3064,3064,5.5
63379,Saint-Myon,553,0,3648,3648,6.6
76173,La Chaussée,553,0,4462,4462,8.1
77411,Saint-Germain-sous-Doue,553,0,9106,9106,16.5
89051,Les Bordes,553,0,3675,3675,6.6
3215,Rongères,552,0,9534,9534,17.3
14124,La Cambe,552,0,3821,3821,6.9
22063,Gommenec'h,552,0,11179,11179,20.3
31492,Saint-Julien-sur-Garonne,552,0,949,949,1.7
31500,Saint-Mamet,552,0,5284,5284,9.6
43077,Costaros,552,7370,2676,10046,18.2
47025,Beauville,552,0,12636,12636,22.9
54595,Xermaménil,552,0,2439,2439,4.4
57321,Hesse,552,0,3594,3594,6.5
59300,Hem-Lenglet,552,0,7175,7175,13
59413,Montigny-en-Cambrésis,552,0,3793,3793,6.9
64424,Ordiarp,552,0,14344,14344,26
64438,Ouillon,552,0,5762,5762,10.4
72153,Jupilles,552,0,31128,31128,56.4
2370,Hargicourt,551,0,4992,4992,9.1
2484,Mézy-Moulins,551,0,12736,12736,23.1
2750,Trosly-Loire,551,0,545,545,1
10363,Saint-Thibault,551,0,7868,7868,14.3
18086,Drevant,551,1670,2428,4098,7.4
18166,Nohant-en-Goût,551,2668,2539,5207,9.5
24117,Les Coteaux Périgourdins,551,3840,9636,13476,24.5
27009,Ambenay,551,0,15496,15496,28.1
33184,Générac,551,0,5639,5639,10.2
43099,Frugerès-les-Mines,551,2450,6171,8621,15.6
51340,Maisons-en-Champagne,551,0,8691,8691,15.8
60299,Hardivillers,551,0,12426,12426,22.6
62123,Beussent,551,0,32606,32606,59.2
62648,Parenty,551,0,32606,32606,59.2
63454,Vertolaye,551,9100,4979,14079,25.6
67515,Waldolwisheim,551,7308,38864,46172,83.8
73073,Chanaz,551,0,3048,3048,5.5
80524,Méharicourt,551,0,9972,9972,18.1
85286,La Taillée,551,0,11645,11645,21.1
86200,Pressac,551,0,22285,22285,40.4
90054,Grosmagny,551,1655,16412,18067,32.8
6022,Bouyon,550,0,6665,6665,12.1
30300,Saint-Théodorit,550,0,1143,1143,2.1
39517,Sirod,550,1276,5569,6845,12.4
42135,Marclopt,550,800,9969,10769,19.6
47119,Houeillès,550,0,9281,9281,16.9
50048,Beslon,550,0,9293,9293,16.9
51303,Jâlons,550,0,27955,27955,50.8
53023,La Bazouge-des-Alleux,550,0,3934,3934,7.2
55516,Tréveray,550,0,10750,10750,19.5
57371,Haute-Kontz,550,0,13390,13390,24.3
58012,Arquian,550,0,24835,24835,45.2
63446,Vensat,550,0,2248,2248,4.1
65408,Sarrancolin,550,0,26442,26442,48.1
71223,La Grande-Verrière,550,0,12306,12306,22.4
2737,Tavaux-et-Pontséricourt,549,0,2766,2766,5
16024,Aussac-Vadalle,549,2870,6902,9772,17.8
17363,Saint-Martial-de-Vitaterne,549,0,6482,6482,11.8
22062,Gomené,549,0,0,0,0
23004,Anzême,549,0,8966,8966,16.3
24554,La Tour-Blanche-Cercles,549,3616,4169,7785,14.2
33503,Saumos,549,0,344,344,0.6
36074,Fléré-la-Rivière,549,0,13710,13710,25
39385,Neublans-Abergement,549,2350,3252,5602,10.2
41137,Mesland,549,1767,21041,22808,41.5
46221,Planioles,549,0,16212,16212,29.5
51448,Prouilly,549,0,9757,9757,17.8
59055,Bazuel,549,0,3772,3772,6.9
62049,Auchy-au-Bois,549,0,9060,9060,16.5
63334,Saint-Dier-d'Auvergne,549,0,5266,5266,9.6
63341,Saint-Ferréol-des-Côtes,549,1813,4961,6774,12.3
67346,Oberlauterbach,549,0,62955,62955,114.7
67440,Schaffhouse-près-Seltz,549,3910,62955,66865,121.8
68147,Hunawihr,549,0,1312,1312,2.4
74130,Franclens,549,0,13260,13260,24.2
85274,Saint-Valérien,549,0,3602,3602,6.6
87142,Saint-Denis-des-Murs,549,0,2260,2260,4.1
88089,La Chapelle-devant-Bruyères,549,0,5338,5338,9.7
88317,Moussey,549,0,5338,5338,9.7
1342,Sainte-Croix,548,0,7462,7462,13.6
4061,Colmars,548,42300,19377,61677,112.5
11185,Lagrasse,548,0,7425,7425,13.5
16205,Manot,548,3500,11275,14775,27
17196,Jazennes,548,1611,9129,10740,19.6
22326,Saint-Rieul,548,11395,6614,18009,32.9
27536,Saint-Éloi-de-Fourques,548,0,2363,2363,4.3
50456,Saint-Clément-Rancoudray,548,0,13483,13483,24.6
51483,Saint-Gibrien,548,0,27854,27854,50.8
64431,Os-Marsillon,548,0,14755,14755,26.9
66005,Angoustrine-Villeneuve-des-Escaldes,548,0,0,0,0
71167,Damerey,548,2985,6324,9309,17
71383,Saint-Albain,548,0,12753,12753,23.3
76308,Gonneville-sur-Scie,548,0,4422,4422,8.1
80172,Cappy,548,0,613,613,1.1
80236,Davenescourt,548,0,661,661,1.2
86195,Port-de-Piles,548,0,12472,12472,22.8
86253,Sanxay,548,0,32649,32649,59.6
1060,Brénod,547,0,20692,20692,37.8
16211,Marthon,547,14022,9755,23777,43.5
24171,Eyzerac,547,13900,1805,15705,28.7
32345,La Romieu,547,0,311,311,0.6
60261,Fresnoy-le-Luat,547,0,2142,2142,3.9
60694,Les Hauts-Talican,547,0,1760,1760,3.2
65446,Tostat,547,0,12356,12356,22.6
76223,Écalles-Alix,547,0,1012,1012,1.9
76285,Fresne-le-Plan,547,0,374,374,0.7
79087,Chey,547,0,15798,15798,28.9
89163,La Ferté-Loupière,547,1480,12937,14417,26.4
2145,Caumont,546,0,9810,9810,18
2293,Étaves-et-Bocquiaux,546,0,4947,4947,9.1
12172,Le Nayrac,546,0,2704,2704,5
24573,Verteillac,546,13037,4146,17183,31.5
2A163,Monacia-d'Aullène,546,9600,8008,17608,32.2
33442,Saint-Martin-de-Laye,546,0,10650,10650,19.5
37202,La Roche-Clermault,546,0,29969,29969,54.9
55228,Hannonville-sous-les-Côtes,546,0,7068,7068,12.9
56027,Buléon,546,0,2201,2201,4
58286,Tannay,546,8315,8491,16806,30.8
62579,Monchy-au-Bois,546,0,4537,4537,8.3
77035,Blennes,546,0,386,386,0.7
89367,Saints-en-Puisaye,546,1243,24654,25897,47.4
2525,Morcourt,545,0,77893,77893,142.9
6050,Coursegoules,545,0,6604,6604,12.1
7053,Chandolas,545,4450,38001,42451,77.9
14398,Manerbe,545,0,8759,8759,16.1
14527,Belle Vie en Auge,545,0,6067,6067,11.1
17459,Varaize,545,0,15181,15181,27.9
23057,Châtelus-Malvaleix,545,0,1466,1466,2.7
24463,Saint-Médard-d'Excideuil,545,5580,6852,12432,22.8
25326,Lantenne-Vertière,545,0,368,368,0.7
26380,Gervans,545,0,23980,23980,44
27036,Bâlines,545,0,15327,15327,28.1
33230,Lapouyade,545,0,10631,10631,19.5
33254,Loupiac-de-la-Réole,545,1720,4437,6157,11.3
33280,Mazion,545,0,5080,5080,9.3
42296,Salt-en-Donzy,545,2056,9879,11935,21.9
50030,Barfleur,545,16200,17143,33343,61.2
67522,Weislingen,545,2709,6832,9541,17.5
70357,Montbozon,545,2230,1744,3974,7.3
73071,Champagny-en-Vanoise,545,0,3262,3262,6
77073,Chalautre-la-Petite,545,0,1965,1965,3.6
80184,Cerisy,545,0,72,72,0.1
82099,Lizac,545,0,6999,6999,12.8
4134,La Motte-du-Caire,544,7500,16218,23718,43.6
9206,Montferrier,544,0,4831,4831,8.9
15262,Villedieu,544,4330,12033,16363,30.1
17451,Les Touches-de-Périgny,544,0,15153,15153,27.9
18278,Vesdun,544,5952,1458,7410,13.6
21031,Aubigny-en-Plaine,544,0,4079,4079,7.5
27185,Crestot,544,4860,2340,7200,13.2
27217,Émanville,544,0,2340,2340,4.3
33010,Arcins,544,0,155,155,0.3
33361,Ruch,544,0,3796,3796,7
33538,Valeyrac,544,0,526,526,1
35329,Sougeal,544,0,4626,4626,8.5
36119,Mérigny,544,0,2990,2990,5.5
47317,Verteuil-d'Agenais,544,0,4390,4390,8.1
57331,Hombourg-Budange,544,0,3486,3486,6.4
60209,La Corne-en-Vexin,544,7000,11946,18946,34.8
60254,Francières,544,0,509,509,0.9
62835,Valhuon,544,0,11752,11752,21.6
64490,Saint-Martin-d'Arrossa,544,0,14136,14136,26
72109,Crissé,544,0,10613,10613,19.5
76515,Quiberville-sur-Mer,544,7851,4390,12241,22.5
76755,Ypreville-Biville,544,0,3530,3530,6.5
79104,Cours,544,0,4484,4484,8.2
80770,Tully,544,0,3617,3617,6.6
11211,Magrie,543,4200,7148,11348,20.9
24007,Allemans,543,1895,4123,6018,11.1
24428,Saint-Jory-de-Chalais,543,3280,1792,5072,9.3
25054,Berche,543,0,34374,34374,63.3
32159,L'Isle-de-Noé,543,0,8233,8233,15.2
45168,Ingrannes,543,0,1056,1056,1.9
50350,Montpinchon,543,0,15711,15711,28.9
53145,Marigné-Peuton,543,0,24377,24377,44.9
56226,Saint-Malo-de-Beignon,543,0,6606,6606,12.2
61156,Essay,543,22319,3407,25726,47.4
63223,Menat,543,0,843,843,1.6
64535,Tarsacq,543,0,14621,14621,26.9
69022,Bibost,543,0,4334,4334,8
72031,Beillé,543,0,3313,3313,6.1
80422,Hautvillers-Ouville,543,0,13446,13446,24.8
85205,Saint-Cyr-des-Gâts,543,5425,3563,8988,16.6
86006,Antigny,543,2550,21962,24512,45.1
86279,Vaux-sur-Vienne,543,0,12358,12358,22.8
2741,Thenelles,542,120055,0,120055,221.5
7165,Belsentes,542,1790,11588,13378,24.7
9246,Rimont,542,0,65679,65679,121.2
16124,Écuras,542,14150,9665,23815,43.9
21565,Saint-Philibert,542,0,2599,2599,4.8
24106,La Chapelle-Aubareil,542,4250,7524,11774,21.7
26302,Sainte-Eulalie-en-Royans,542,1380,33945,35325,65.2
27199,Dangu,542,0,442,442,0.8
31413,Pelleport,542,0,4534,4534,8.4
32368,Sainte-Christie,542,0,19097,19097,35.2
42030,Bussy-Albieux,542,0,4856,4856,9
43150,Le Pertuis,542,400,22552,22952,42.3
45055,Bricy,542,0,764,764,1.4
57055,Bazoncourt,542,0,1320,1320,2.4
57204,Failly,542,0,1320,1320,2.4
59595,Thun-Saint-Martin,542,0,7045,7045,13
59669,Zuytpeene,542,0,3311,3311,6.1
60545,Romescamps,542,0,2659,2659,4.9
61387,Saint-Fraimbault,542,800,6726,7526,13.9
68039,Bisel,542,0,14539,14539,26.8
70429,Pusy-et-Épenoux,542,0,28037,28037,51.7
71391,Saint-Bérain-sur-Dheune,542,0,14902,14902,27.5
76088,Berville-sur-Seine,542,23779,15481,39260,72.4
77242,Jutigny,542,0,7676,7676,14.2
2426,Levergies,541,0,4902,4902,9.1
7150,Mariac,541,2277,11567,13844,25.6
19270,Troche,541,0,5203,5203,9.6
24074,Calviac-en-Périgord,541,7960,2070,10030,18.5
24251,Manzac-sur-Vern,541,2262,3021,5283,9.8
27177,Coudres,541,0,6363,6363,11.8
35046,Les Brulais,541,0,4882,4882,9
38159,Eydoche,541,0,2895,2895,5.4
45162,Guigneville,541,1142,672,1814,3.4
53106,Gesvres,541,0,4811,4811,8.9
54110,Cerville,541,0,3201,3201,5.9
55045,Belrupt-en-Verdunois,541,0,3443,3443,6.4
57639,Schorbach,541,0,12468,12468,23
60480,Oroër,541,0,12200,12200,22.6
62067,Avroult,541,0,48149,48149,89
62530,Lottinghen,541,0,1562,1562,2.9
63335,Saint-Diéry,541,0,3950,3950,7.3
65410,Sarrouilles,541,0,5168,5168,9.6
66231,Vingrau,541,0,4506,4506,8.3
73033,La Bauche,541,0,37043,37043,68.5
74065,Chaumont,541,0,13067,13067,24.2
80802,Villers-Faucon,541,0,3876,3876,7.2
81292,Tanus,541,0,12377,12377,22.9
87144,Saint-Genest-sur-Roselle,541,1170,8675,9845,18.2
1147,Domsure,540,0,10440,10440,19.3
2279,Épaux-Bézu,540,7325,12482,19807,36.7
6144,La Tour,540,0,10631,10631,19.7
12266,Ségur,540,0,3829,3829,7.1
16174,Julienne,540,8380,20204,28584,52.9
21022,Argilly,540,0,2590,2590,4.8
2B261,Rogliano,540,0,19804,19804,36.7
30069,Carnas,540,0,1122,1122,2.1
40066,Carcarès-Sainte-Croix,540,0,12702,12702,23.5
42236,Saint-Hilaire-sous-Charlieu,540,7100,14010,21110,39.1
43249,Valprivas,540,1264,48765,50029,92.6
48038,Bel-Air-Val-d'Ance,540,0,4838,4838,9
51403,Nogent-l'Abbesse,540,0,9597,9597,17.8
56202,Saint-Abraham,540,0,6569,6569,12.2
60133,Catillon-Fumechon,540,0,2992,2992,5.5
61426,Saint-Martin-du-Vieux-Bellême,540,2330,6270,8600,15.9
64245,Goès,540,0,11629,11629,21.5
64271,Iholdy,540,0,14032,14032,26
67163,Gougenheim,540,2173,10274,12447,23
67236,Kienheim,540,2845,10274,13119,24.3
79115,Exoudun,540,0,15595,15595,28.9
80785,Vecquemont,540,0,71,71,0.1
82032,Castelsagrat,540,0,58018,58018,107.4
2755,Urcel,539,0,534,534,1
4004,Allemagne-en-Provence,539,0,6265,6265,11.6
7171,Payzac,539,1150,37582,38732,71.9
10049,Les Bordes-Aumont,539,0,7697,7697,14.3
12113,Gramond,539,0,16497,16497,30.6
21185,Combertault,539,0,2344,2344,4.3
31450,Renneville,539,0,2629,2629,4.9
37012,Avon-les-Roches,539,0,14625,14625,27.1
39439,Port-Lesney,539,3900,5220,9120,16.9
45133,Engenville,539,0,670,670,1.2
45241,Ouvrouer-les-Champs,539,0,1048,1048,1.9
60498,Le Plessier-sur-Saint-Just,539,0,2986,2986,5.5
76369,La Houssaye-Béranger,539,0,368,368,0.7
78285,Gressey,539,0,5404,5404,10
79134,Glénay,539,0,8386,8386,15.6
84097,Richerenches,539,0,14511,14511,26.9
3176,Monétay-sur-Allier,538,0,11004,11004,20.5
3300,Vaumas,538,0,9292,9292,17.3
7028,Beaulieu,538,5400,13165,18565,34.5
11102,Couffoulens,538,0,3490,3490,6.5
17246,Moragne,538,8135,8860,16995,31.6
18149,Méry-ès-Bois,538,7800,0,7800,14.5
19131,Meilhards,538,0,0,0,0
22040,Coadout,538,0,9634,9634,17.9
24200,Grand-Brassac,538,3068,4085,7153,13.3
25248,Les Fontenelles,538,0,9035,9035,16.8
26178,Menglon,538,7100,29912,37012,68.8
28374,Serazereux,538,0,720,720,1.3
2A336,Valle-di-Mezzana,538,0,5394,5394,10
33132,Comps,538,0,5506,5506,10.2
39379,Nance,538,780,14300,15080,28
50489,Saint-Jean-de-la-Haize,538,0,13237,13237,24.6
52248,Is-en-Bassigny,538,0,2469,2469,4.6
54007,Aingeray,538,0,1122,1122,2.1
59596,Tilloy-lez-Marchiennes,538,0,6469,6469,12
62112,Berles-au-Bois,538,0,4470,4470,8.3
63434,Tours-sur-Meymont,538,0,4862,4862,9
67208,Hohengœft,538,8326,29220,37546,69.8
71122,Cheilly-lès-Maranges,538,0,14792,14792,27.5
73229,Saint-Christophe,538,0,36838,36838,68.5
76247,Esteville,538,0,368,368,0.7
80120,Bouillancourt-en-Séry,538,0,10,10,0
80237,Démuin,538,0,3305,3305,6.1
81114,Labastide-Gabausse,538,0,12308,12308,22.9
85290,Thiré,538,4080,11370,15450,28.7
87138,Saint-Bonnet-Briance,538,0,2214,2214,4.1
6134,Séranon,537,0,13711,13711,25.5
7183,Pradons,537,3326,32791,36117,67.3
11240,Montazels,537,0,7069,7069,13.2
13057,Mas-Blanc-des-Alpilles,537,0,988,988,1.8
28372,Senantes,537,0,3116,3116,5.8
30251,Saint-Étienne-des-Sorts,537,0,7836,7836,14.6
39270,Jouhe,537,2090,10899,12989,24.2
39305,La Loye,537,1800,5200,7000,13
42143,Mizérieux,537,0,9734,9734,18.1
45340,Villemurlin,537,0,3145,3145,5.9
47079,Dausse,537,0,3094,3094,5.8
48116,Pont de Montvert - Sud Mont Lozère,537,0,29247,29247,54.5
50428,Reffuveille,537,0,13212,13212,24.6
51379,Montigny-sur-Vesle,537,0,9544,9544,17.8
51418,Ormes,537,0,9544,9544,17.8
57706,Vergaville,537,0,1777,1777,3.3
59081,Bévillers,537,0,3690,3690,6.9
59181,Dourlers,537,0,4254,4254,7.9
60625,Suzoy,537,0,0,0,0
67039,Bilwisheim,537,0,6529,6529,12.2
67425,Saint-Jean-Saverne,537,1315,37876,39191,73
70404,Passavant-la-Rochère,537,0,3413,3413,6.4
72048,Briosne-lès-Sables,537,0,9958,9958,18.5
76488,Ouainville,537,0,3478,3478,6.5
78162,Choisel,537,0,677,677,1.3
78677,Villette,537,1600,5384,6984,13
80047,Aveluy,537,0,600,600,1.1
81291,Taïx,537,0,12286,12286,22.9
88198,Gerbépal,537,0,5221,5221,9.7
5037,Châteauvieux,536,0,760,760,1.4
8408,Sécheval,536,0,12313,12313,23
10329,Rouilly-Saint-Loup,536,0,7654,7654,14.3
11001,Aigues-Vives,536,0,3477,3477,6.5
16424,Yviers,536,5755,25204,30959,57.8
30267,Saint-Jean-de-Serres,536,0,16754,16754,31.3
38078,La Chapelle-du-Bard,536,0,9959,9959,18.6
42060,Chenereilles,536,0,4802,4802,9
50512,Saint-Martin-de-Bonfossé,536,0,7928,7928,14.8
51078,Bouy,536,0,27244,27244,50.8
58187,Myennes,536,0,10686,10686,19.9
62096,Beaumetz-lès-Cambrai,536,0,2665,2665,5
62674,Quelmes,536,0,1160,1160,2.2
64120,Beyrie-sur-Joyeuse,536,0,13928,13928,26
72297,Saint-Marceau,536,0,25230,25230,47.1
80129,Bouzincourt,536,0,599,599,1.1
5087,Montmaur,535,0,20021,20021,37.4
7015,Arras-sur-Rhône,535,1895,8807,10702,20
30277,Saint-Laurent-de-Carnols,535,0,7807,7807,14.6
43154,Pradelles,535,0,2593,2593,4.8
50262,La Lande-d'Airou,535,0,9040,9040,16.9
51643,Vinay,535,0,10632,10632,19.9
59023,Aubencheul-au-Bac,535,0,6954,6954,13
60281,Gournay-sur-Aronde,535,0,4677,4677,8.7
62505,Leulinghen-Bernes,535,0,2128,2128,4
67242,Kirrwiller,535,2996,14417,17413,32.5
74271,Seytroux,535,9320,37383,46703,87.3
82165,Saint-Loup,535,0,57481,57481,107.4
88328,Nompatelize,535,0,5202,5202,9.7
95254,Frémécourt,535,3800,24581,28381,53
10099,Chessy-les-Prés,534,0,9942,9942,18.6
16181,Lessac,534,425,10987,11412,21.4
25122,Chapelle-d'Huin,534,0,12070,12070,22.6
28291,Ouarville,534,0,2805,2805,5.3
29166,Ploéven,534,0,8416,8416,15.8
30001,Aigaliers,534,0,4103,4103,7.7
34206,Poilhes,534,0,3019,3019,5.7
38390,Saint-Gervais,534,0,8630,8630,16.2
41062,Couddes,534,1388,9813,11201,21
46033,Porte-du-Quercy,534,0,13126,13126,24.6
51358,Maurupt-le-Montois,534,0,4836,4836,9.1
54105,Bulligny,534,0,17705,17705,33.2
55169,Écouviez,534,0,19091,19091,35.8
58185,Moux-en-Morvan,534,0,6292,6292,11.8
69053,Chénas,534,0,0,0,0
71283,Marnay,534,0,14682,14682,27.5
72038,Boëssé-le-Sec,534,0,3258,3258,6.1
73025,Avressieux,534,0,791,791,1.5
73184,Nances,534,0,27356,27356,51.2
76465,Neuville-Ferrières,534,0,12474,12474,23.4
77130,Coulommes,534,0,2080,2080,3.9
79122,Fontenille-Saint-Martin-d'Entraigues,534,0,15422,15422,28.9
3240,Saint-Léon,533,0,9206,9206,17.3
12265,Sébrazac,533,0,2640,2640,5
17150,Les Églises-d'Argenteuil,533,0,14846,14846,27.9
17357,Saint-Maigrin,533,0,6294,6294,11.8
18181,Plou,533,6923,1485,8408,15.8
21618,Talmay,533,0,0,0,0
22238,Plufur,533,0,10588,10588,19.9
22310,Saint-Laurent,533,0,9544,9544,17.9
24481,Saint-Paul-la-Roche,533,5300,1759,7059,13.2
36043,Chassignolles,533,0,11708,11708,22
42051,La Chapelle-Villars,533,0,16356,16356,30.7
46109,Fontanes,533,0,4500,4500,8.4
46301,Sauzet,533,0,19379,19379,36.4
50084,Bricqueville-la-Blouette,533,0,15422,15422,28.9
53089,Daon,533,0,23928,23928,44.9
54374,Moncel-sur-Seille,533,0,3154,3154,5.9
59454,Oxelaëre,533,0,3256,3256,6.1
60195,Delincourt,533,10432,11704,22136,41.5
60383,Margny-sur-Matz,533,0,4660,4660,8.7
64277,Isturits,533,12327,13850,26177,49.1
68200,Manspach,533,0,7590,7590,14.2
70532,Vellefaux,533,0,1706,1706,3.2
73268,Saint-Paul-sur-Isère,533,0,12573,12573,23.6
79159,Luché-Thouarsais,533,0,8293,8293,15.6
81319,Villeneuve-sur-Vère,533,0,12194,12194,22.9
85199,Saint-Aubin-la-Plaine,533,6443,11265,17708,33.2
91079,Boissy-la-Rivière,533,0,1342,1342,2.5
2190,Chivres-Val,532,0,1049,1049,2
16002,Les Adjots,532,4045,11645,15690,29.5
23024,Blessac,532,0,20120,20120,37.8
23039,La Celle-Dunoise,532,0,15883,15883,29.9
23116,Mainsat,532,0,6984,6984,13.1
24392,Saint-Crépin-et-Carlucet,532,0,2036,2036,3.8
25148,La Chenalotte,532,0,8934,8934,16.8
25571,Trévillers,532,0,3706,3706,7
27431,La Neuve-Lyre,532,0,14962,14962,28.1
27617,Saussay-la-Campagne,532,0,434,434,0.8
32190,Lannepax,532,14295,0,14295,26.9
32253,Miradoux,532,18730,302,19032,35.8
34266,Saint-Jean-de-Cuculles,532,700,9913,10613,19.9
54372,Moivrons,532,0,3148,3148,5.9
55541,Vavincourt,532,0,6414,6414,12.1
56072,Gueltas,532,15246,3704,18950,35.6
57030,Arry,532,0,3176,3176,6
59351,Limont-Fontaine,532,0,18977,18977,35.7
60045,Barbery,532,0,0,0,0
61095,La Chapelle-Biche,532,1100,14249,15349,28.9
62438,Hermaville,532,0,4421,4421,8.3
63314,Saint-Amant-Roche-Savine,532,0,4807,4807,9
66057,Corneilla-de-Conflent,532,0,15933,15933,29.9
89101,Chéu,532,4800,3438,8238,15.5
3042,Le Breuil,531,0,1068,1068,2
8320,La Neuville-en-Tourne-à-Fuy,531,0,10155,10155,19.1
12118,Lacroix-Barrez,531,0,17993,17993,33.9
15124,Menet,531,24525,8189,32714,61.6
16363,Saulgond,531,4000,10925,14925,28.1
25374,Mercey-le-Grand,531,0,359,359,0.7
30102,Dions,531,0,1956,1956,3.7
30151,Lussan,531,0,4080,4080,7.7
33294,Morizès,531,0,4323,4323,8.1
37136,Le Louroux,531,2690,9217,11907,22.4
45171,Isdes,531,0,3110,3110,5.9
57015,Altviller,531,0,9067,9067,17.1
60023,Armancourt,531,0,4783,4783,9
62237,Conteville-lès-Boulogne,531,0,17950,17950,33.8
63107,Chavaroux,531,0,4016,4016,7.6
63412,Sauvessanges,531,35938,4798,40736,76.7
64217,Esquiule,531,0,11435,11435,21.5
64305,Lahontan,531,0,11100,11100,20.9
67265,Lichtenberg,531,1666,14309,15975,30.1
80452,Jumel,531,0,3262,3262,6.1
81164,Mézens,531,0,29175,29175,54.9
81314,Viane,531,0,9394,9394,17.7
86248,Saint-Secondin,531,0,11958,11958,22.5
89186,Germigny,531,8570,3431,12001,22.6
4151,Pierrerue,530,2170,10764,12934,24.4
8133,Coucy,530,0,10136,10136,19.1
9119,Eycheil,530,0,64225,64225,121.2
10186,Laines-aux-Bois,530,0,7568,7568,14.3
14621,Saint-Martin-de-Bienfaite-la-Cressonnière,530,0,5900,5900,11.1
24345,Queyssac,530,2150,11799,13949,26.3
27039,Barneville-sur-Seine,530,0,2171,2171,4.1
28267,Montreuil,530,0,709,709,1.3
32019,Auterive,530,0,18675,18675,35.2
37093,Crouzilles,530,0,14381,14381,27.1
40113,Goos,530,0,8300,8300,15.7
45096,Les Choux,530,0,6859,6859,12.9
45257,Pressigny-les-Pins,530,0,5434,5434,10.3
47232,Saint-Barthélemy-d'Agenais,530,0,5483,5483,10.3
49113,Courchamps,530,0,5164,5164,9.7
51439,Pomacle,530,0,9419,9419,17.8
62657,Pihen-lès-Guînes,530,0,15930,15930,30.1
65080,Bénac,530,0,5063,5063,9.6
65244,Lagarde,530,0,5063,5063,9.6
69137,Montmelas-Saint-Sorlin,530,0,11252,11252,21.2
73259,Saint-Martin-sur-la-Chambre,530,0,75932,75932,143.3
3038,Bransat,529,0,10820,10820,20.5
4053,Châteauneuf-Val-Saint-Donat,529,4350,11651,16001,30.2
7045,Burzet,529,0,2174,2174,4.1
7210,Saint-Andéol-de-Vals,529,1050,9029,10079,19.1
8483,Ville-sur-Lumes,529,0,12152,12152,23
14694,Le Torquesne,529,0,8502,8502,16.1
19286,Vignols,529,0,8443,8443,16
27219,Épégard,529,0,2275,2275,4.3
28054,Le Boullay-Mivoye,529,0,708,708,1.3
38248,Montaud,529,0,8549,8549,16.2
39452,Rans,529,3200,8348,11548,21.8
46001,Albas,529,0,19234,19234,36.4
47226,Roumagne,529,0,9851,9851,18.6
50144,Coulouvray-Boisbenâtre,529,0,8939,8939,16.9
50474,Saint-Georges-de-Rouelley,529,0,13016,13016,24.6
51266,Germaine,529,0,1308,1308,2.5
59347,Liessies,529,6145,4191,10336,19.5
60230,Le Fay-Saint-Quentin,529,0,20744,20744,39.2
61260,Le Ménil-de-Briouze,529,0,14168,14168,26.8
62207,Campigneulles-les-Petites,529,0,5628,5628,10.6
68125,Hecken,529,4615,7533,12148,23
71084,Chânes,529,4514,13512,18026,34.1
72224,Nuillé-le-Jalais,529,0,9889,9889,18.7
77050,Bransles,529,0,557,557,1.1
78618,Tilly,529,0,5304,5304,10
8370,Rouvroy-sur-Audry,528,0,13803,13803,26.1
11276,Paziols,528,0,813,813,1.5
14458,Les Moutiers-en-Cinglais,528,0,15963,15963,30.2
19035,Chabrignac,528,0,8427,8427,16
26099,Colonzelle,528,0,14215,14215,26.9
30239,Sainte-Cécile-d'Andorge,528,0,16504,16504,31.3
54069,Beuvillers,528,0,2326,2326,4.4
57076,Beyren-lès-Sierck,528,0,12855,12855,24.3
58204,Vaux d'Amognes,528,1000,2646,3646,6.9
62428,Hénin-sur-Cojeul,528,0,14851,14851,28.1
69026,Le Breuil,528,0,4758,4758,9
76200,Critot,528,0,12334,12334,23.4
81269,Saint-Salvy-de-la-Balme,528,0,4933,4933,9.3
87083,Laurière,528,0,856,856,1.6
89483,Voisines,528,0,3509,3509,6.6
2465,Marigny-en-Orxois,527,0,287,287,0.5
3230,Saint-Étienne-de-Vicq,527,0,1060,1060,2
4139,Noyers-sur-Jabron,527,0,11607,11607,22
8429,Sormonne,527,0,8204,8204,15.6
12296,Viala-du-Tarn,527,0,9466,9466,18
17355,Sainte-Lheurine,527,0,6223,6223,11.8
26070,Chamaret,527,0,14188,14188,26.9
26107,Crépol,527,0,10683,10683,20.3
26247,Ponsas,527,0,8675,8675,16.5
38277,Notre-Dame-de-Commiers,527,0,20358,20358,38.6
41070,Vallée-de-Ronsard,527,77,6518,6595,12.5
50004,Airel,527,0,7794,7794,14.8
50463,Saint-Denis-le-Gast,527,0,15248,15248,28.9
51505,Saint-Masmes,527,0,9366,9366,17.8
52044,Roches-Bettaincourt,527,0,8108,8108,15.4
52155,Culmont,527,0,10394,10394,19.7
59562,Sémeries,527,2591,4175,6766,12.8
62580,Monchy-Breton,527,0,11385,11385,21.6
62754,Saint-Léger,527,0,2620,2620,5
67542,Wintzenheim-Kochersberg,527,3114,10027,13141,24.9
78013,Andelu,527,0,1237,1237,2.3
80545,Mézières-en-Santerre,527,0,3237,3237,6.1
2299,Évergnicourt,526,0,1415,1415,2.7
11120,La Digne-d'Aval,526,5381,6924,12305,23.4
12070,Compeyre,526,0,5436,5436,10.3
15101,Laveissière,526,12000,118,12118,23
17078,Chadenac,526,0,6211,6211,11.8
24382,Saint-Capraise-de-Lalinde,526,22492,1911,24403,46.4
28294,Oysonville,526,0,2763,2763,5.3
31148,Clermont-le-Fort,526,0,8576,8576,16.3
31174,Estadens,526,0,28269,28269,53.7
34141,La Livinière,526,0,1991,1991,3.8
37197,Rigny-Ussé,526,0,8373,8373,15.9
38307,Pisieu,526,0,13446,13446,25.6
38402,Saint-Jean-de-Vaulx,526,0,5507,5507,10.5
42009,Arthun,526,0,4713,4713,9
45054,Briarres-sur-Essonne,526,0,3986,3986,7.6
58247,Saint-Jean-aux-Amognes,526,0,2636,2636,5
61303,Nécy,526,0,1111,1111,2.1
67314,Natzwiller,526,4100,38065,42165,80.2
67354,Odratzheim,526,3950,28568,32518,61.8
70178,La Côte,526,0,23122,23122,44
72128,Val-d'Étangson,526,0,7111,7111,13.5
74068,Chêne-en-Semine,526,0,12705,12705,24.2
77429,Saint-Ouen-sur-Morin,526,0,8662,8662,16.5
79229,La Rochénard,526,0,7089,7089,13.5
85137,Marsais-Sainte-Radégonde,526,3420,3451,6871,13.1
87094,Meilhac,526,636,7130,7766,14.8
12059,Castanet,525,0,16068,16068,30.6
16077,Champmillon,525,1750,19643,21393,40.7
16282,La Rochette,525,1850,9362,11212,21.4
23130,Méasnes,525,0,1412,1412,2.7
26168,Lus-la-Croix-Haute,525,9150,29189,38339,73
27300,Grosley-sur-Risle,525,0,2263,2263,4.3
27664,Le Tronquay,525,0,3454,3454,6.6
42017,Le Bessat,525,0,10741,10741,20.5
47288,Sauvagnas,525,0,12018,12018,22.9
51152,Chigny-les-Roses,525,0,9330,9330,17.8
54137,Cons-la-Grandville,525,0,4902,4902,9.3
55009,Ancemont,525,0,3342,3342,6.4
57574,Basse-Rentgen,525,0,12782,12782,24.3
58155,La Marche,525,0,29630,29630,56.4
60420,Montjavoult,525,0,11529,11529,22
67278,Mackwiller,525,1360,6582,7942,15.1
67541,Wintzenbach,525,7600,60203,67803,129.1
71384,Saint-Ambreuil,525,0,6360,6360,12.1
71559,Varennes-sous-Dun,525,0,10190,10190,19.4
72134,Flée,525,0,29606,29606,56.4
76340,Harcanville,525,9450,1157,10607,20.2
76686,Theuville-aux-Maillots,525,0,3407,3407,6.5
80298,Étricourt-Manancourt,525,0,3761,3761,7.2
80654,Quesnoy-le-Montant,525,0,3490,3490,6.6
86129,Lésigny,525,0,11949,11949,22.8
87077,Janailhac,525,5980,7116,13096,24.9
89069,Chailley,525,5827,3392,9219,17.6
1349,Saint-Éloi,524,0,8943,8943,17.1
2328,Fossoy,524,0,12112,12112,23.1
11366,Sainte-Valière,524,3750,8103,11853,22.6
12092,Durenque,524,0,28594,28594,54.6
12297,Le Vibal,524,0,9445,9445,18
22351,Treffrin,524,0,17720,17720,33.8
27538,Saint-Étienne-l'Allier,524,0,8069,8069,15.4
41042,Châteauvieux,524,4404,9629,14033,26.8
45100,Combleux,524,0,7664,7664,14.6
53203,Saint-Brice,524,0,3149,3149,6
54194,Fillières,524,0,4893,4893,9.3
55094,Buzy-Darmont,524,0,9465,9465,18.1
57152,Contz-les-Bains,524,0,12757,12757,24.3
57392,Lemud,524,0,20067,20067,38.3
59612,Vertain,524,0,132,132,0.3
60273,Giraumont,524,0,4581,4581,8.7
60340,Lagny,524,0,4581,4581,8.7
61255,Mauves-sur-Huisne,524,2500,1840,4340,8.3
62105,Belle-et-Houllefort,524,0,1513,1513,2.9
76030,Aubermesnil-Beaumais,524,0,6368,6368,12.2
76334,Gueures,524,7533,4228,11761,22.4
89037,Béon,524,0,4107,4107,7.8
2559,Nouvion-et-Catillon,523,0,2635,2635,5
5053,Garde-Colombe,523,0,15592,15592,29.8
22358,Trégonneau,523,0,9365,9365,17.9
23137,Mourioux-Vieilleville,523,0,2897,2897,5.5
29285,Tréflaouénan,523,14774,994,15768,30.1
32463,Viella,523,0,5235,5235,10
33191,Gours,523,0,10202,10202,19.5
34185,Notre-Dame-de-Londres,523,14780,9745,24525,46.9
36053,Ciron,523,0,2875,2875,5.5
38260,Moras,523,0,2700,2700,5.2
38278,Notre-Dame-de-l'Osier,523,0,8452,8452,16.2
42083,Dargoire,523,0,12254,12254,23.4
43189,Saint-Georges-Lagricol,523,57488,21762,79250,151.5
46132,Issendolus,523,0,15445,15445,29.5
46266,Saint-Félix,523,0,15445,15445,29.5
51416,Orbais-l'Abbaye,523,0,757,757,1.4
55517,Seuil-d'Argonne,523,0,7080,7080,13.5
57033,Arzviller,523,0,1050,1050,2
71462,Saint-Maurice-en-Rivière,523,3999,6035,10034,19.2
78053,Béhoust,523,0,226,226,0.4
80436,Hescamps,523,0,722,722,1.4
89238,Mailly-le-Château,523,9300,71,9371,17.9
91121,Buno-Bonnevaux,523,0,18222,18222,34.8
2009,Alaincourt,522,0,0,0,0
2197,Clairfontaine,522,0,9308,9308,17.8
7073,Le Crestet,522,2825,14945,17770,34
16032,Bassac,522,600,19531,20131,38.6
18187,Préveranges,522,0,1399,1399,2.7
33344,Pujols,522,0,3642,3642,7
36173,Rosnay,522,0,2869,2869,5.5
42036,Chagnon,522,0,12231,12231,23.4
42061,Cherier,522,1250,9792,11042,21.2
53176,Le Pas,522,0,6882,6882,13.2
54393,Moyen,522,0,2306,2306,4.4
54405,Ochey,522,0,17307,17307,33.2
60264,Frocourt,522,0,20469,20469,39.2
61362,Saint-André-de-Messei,522,1854,13981,15835,30.3
62055,Audrehem,522,0,1129,1129,2.2
62151,Boisleux-au-Mont,522,0,14682,14682,28.1
62422,Hébuterne,522,0,2595,2595,5
63332,Saint-Clément-de-Régnat,522,0,2133,2133,4.1
64005,Abos,522,0,14055,14055,26.9
70563,Villers-le-Sec,522,0,1931,1931,3.7
76502,Pierreval,522,0,357,357,0.7
80149,Buigny-Saint-Maclou,522,0,12926,12926,24.8
80315,Flers-sur-Noye,522,0,3207,3207,6.1
2306,La Ferté-Chevresis,521,0,0,0,0
3133,Jenzat,521,0,10657,10657,20.5
8115,Chémery-Chéhéry,521,0,18446,18446,35.4
14609,Saint-Loup-Hors,521,0,20080,20080,38.5
17292,Puy-du-Lac,521,0,14512,14512,27.9
22332,Saint-Trimoël,521,1623,6288,7911,15.2
29070,Guiler-sur-Goyen,521,10479,16688,27167,52.1
41071,Crouy-sur-Cosson,521,3062,3650,6712,12.9
51444,Pouillon,521,0,9259,9259,17.8
53238,Saint-Mars-sur-la-Futaie,521,0,6869,6869,13.2
54534,Trondes,521,0,1087,1087,2.1
55102,Charny-sur-Meuse,521,0,32293,32293,62
57739,Waldweistroff,521,0,7500,7500,14.4
60027,Auger-Saint-Vincent,521,0,2040,2040,3.9
60252,Fournival,521,0,2887,2887,5.5
60344,Lalandelle,521,0,4271,4271,8.2
60650,Trumilly,521,0,2040,2040,3.9
70018,Ancier,521,0,2629,2629,5
70145,Chaux-la-Lotière,521,0,4364,4364,8.4
72349,Teillé,521,0,29275,29275,56.2
77524,Vimpelles,521,0,7378,7378,14.2
80438,Heudicourt,521,0,3733,3733,7.2
80495,Lucheux,521,0,2031,2031,3.9
82180,Sérignac,521,0,12213,12213,23.4
91441,Nainville-les-Roches,521,0,766,766,1.5
95270,Genainville,521,1413,3293,4706,9
7344,Vinzieux,520,0,2679,2679,5.2
15088,Lacapelle-Viescamp,520,16548,17618,34166,65.7
19264,Soursac,520,0,7129,7129,13.7
21210,Créancey,520,0,7903,7903,15.2
26093,Clansayes,520,0,8040,8040,15.5
33026,Balizac,520,0,5318,5318,10.2
33089,Campugnan,520,0,5322,5322,10.2
34186,Octon,520,0,592,592,1.1
34251,Saint-Étienne-de-Gourgas,520,3800,5840,9640,18.5
37238,Saint-Senoch,520,3116,9026,12142,23.4
51252,Fleury-la-Rivière,520,0,753,753,1.4
54049,Baslieux,520,0,6601,6601,12.7
60222,Essuiles,520,0,2881,2881,5.5
62717,Roëllecourt,520,0,11234,11234,21.6
63267,Palladuc,520,0,12056,12056,23.2
63422,Solignat,520,0,3380,3380,6.5
68232,Neuwiller,520,10500,10107,20607,39.6
73170,Monthion,520,0,12266,12266,23.6
74114,Essert-Romand,520,0,36335,36335,69.9
89404,Subligny,520,4600,1845,6445,12.4
8329,Novion-Porcien,519,0,11383,11383,21.9
12156,Montpeyroux,519,0,17587,17587,33.9
14275,Fontaine-Henry,519,0,6363,6363,12.3
17050,Bois,519,0,6128,6128,11.8
2B265,Rutali,519,0,3137,3137,6
38325,Proveysieux,519,0,20049,20049,38.6
39520,Souvans,519,4800,5026,9826,18.9
51569,Thillois,519,0,9224,9224,17.8
57319,Herny,519,0,24084,24084,46.4
60483,Orvillers-Sorel,519,0,4537,4537,8.7
63427,Teilhède,519,0,3424,3424,6.6
70418,La Romaine,519,0,1333,1333,2.6
72282,Saint-Georges-le-Gaultier,519,0,24430,24430,47.1
80238,Dernancourt,519,5294,580,5874,11.3
84032,Caseneuve,519,0,10579,10579,20.4
88435,Saint-Remy,519,0,5046,5046,9.7
89209,Jouy,519,2540,1841,4381,8.4
25598,Venise,518,0,9127,9127,17.6
27489,Reuilly,518,0,6092,6092,11.8
35295,Saint-Maugan,518,0,10058,10058,19.4
38280,Notre-Dame-de-Vaulx,518,0,5424,5424,10.5
40062,Campet-et-Lamolère,518,0,6411,6411,12.4
48043,Châteauneuf-de-Randon,518,10170,6101,16271,31.4
53253,Saint-Saturnin-du-Limet,518,0,3429,3429,6.6
57060,Bénestroff,518,0,1714,1714,3.3
57270,Val-de-Bride,518,0,1714,1714,3.3
59587,Terdeghem,518,0,3165,3165,6.1
60493,Pisseleu,518,0,2541,2541,4.9
62772,Salperwick,518,0,46102,46102,89
76015,Angiens,518,0,3355,3355,6.5
76559,Saint-Aubin-de-Crétot,518,0,3948,3948,7.6
80670,Revelles,518,0,33210,33210,64.1
87120,La Porcherie,518,1230,8306,9536,18.4
89172,Fontaine-la-Gaillarde,518,5101,3442,8543,16.5
89365,Saint-Privé,518,30,23390,23420,45.2
2054,Bazoches-et-Saint-Thibaut,517,0,1020,1020,2
2319,Fonsomme,517,0,73891,73891,142.9
2816,Villers-sur-Fère,517,0,11950,11950,23.1
3289,Treteau,517,0,8930,8930,17.3
5109,Puy-Saint-Pierre,517,0,36881,36881,71.3
6154,Valderoure,517,0,13200,13200,25.5
7174,Peyraud,517,0,8511,8511,16.5
7312,Sécheras,517,2453,22748,25201,48.7
10359,Saint-Phal,517,3472,9625,13097,25.3
12214,Saint-Chély-d'Aubrac,517,0,17519,17519,33.9
12246,Saint-Santin,517,0,5195,5195,10
12272,Sonnac,517,0,15267,15267,29.5
27013,Amfreville-sous-les-Monts,517,0,15332,15332,29.7
2A031,Bastelica,517,0,7057,7057,13.6
2A048,Calcatoggio,517,8200,2382,10582,20.5
31550,Soueich,517,0,27786,27786,53.7
39176,Cramans,517,3680,5007,8687,16.8
43049,Chamalières-sur-Loire,517,3782,21512,25294,48.9
47029,Blanquefort-sur-Briolance,517,0,2978,2978,5.8
52386,Perthes,517,0,4682,4682,9.1
57311,Hellimer,517,0,8828,8828,17.1
59103,Boussières-sur-Sambre,517,0,18442,18442,35.7
60126,Cannectancourt,517,2250,4520,6770,13.1
62515,Ligny-Thilloy,517,0,2570,2570,5
64425,Orègue,517,0,13435,13435,26
68161,Katzenthal,517,4841,26401,31242,60.4
68212,Mœrnach,517,0,13869,13869,26.8
70267,Gevigney-et-Mercey,517,0,1565,1565,3
72064,La Chapelle-Huon,517,0,6989,6989,13.5
72204,Montaillé,517,0,6989,6989,13.5
72375,Villaines-la-Gonais,517,0,3154,3154,6.1
76201,Croisy-sur-Andelle,517,0,9767,9767,18.9
76588,Saint-Hellier,517,0,12077,12077,23.4
81014,Anglès,517,0,9146,9146,17.7
87035,Champnétery,517,0,2128,2128,4.1
87068,Fromental,517,0,838,838,1.6
2308,Fesmy-le-Sart,516,0,9201,9201,17.8
8400,Sapogne-et-Feuchères,516,0,11853,11853,23
14465,Nonant,516,0,19888,19888,38.5
17071,La Brousse,516,0,14373,14373,27.9
28246,Meslay-le-Vidame,516,0,15036,15036,29.1
32121,Endoufielle,516,0,36707,36707,71.1
33206,Isle-Saint-Georges,516,0,4660,4660,9
38183,Granieu,516,0,4525,4525,8.8
45073,Chantecoq,516,0,1564,1564,3
47055,Castelnaud-de-Gratecambe,516,0,13176,13176,25.5
67466,Siegen,516,1631,59171,60802,117.8
68074,Durlinsdorf,516,0,13842,13842,26.8
68197,Magstatt-le-Bas,516,1700,10029,11729,22.7
76237,Épinay-sur-Duclair,516,0,14739,14739,28.6
76698,Torcy-le-Petit,516,0,4164,4164,8.1
80036,Aubigny,516,0,68,68,0.1
85105,Le Gué-de-Velluire,516,0,10905,10905,21.1
86073,Cherves,516,0,26815,26815,52
89254,Mézilles,516,9695,23299,32994,63.9
5180,Les Vigneaux,515,0,35523,35523,69
7286,Saint-Pierreville,515,1050,11011,12061,23.4
11330,Rustiques,515,0,3340,3340,6.5
12028,Boisse-Penchot,515,0,5175,5175,10
33451,Saint-Michel-de-Fronsac,515,0,7752,7752,15.1
41053,Choue,515,0,15382,15382,29.9
42086,Écoche,515,0,13361,13361,25.9
47222,La Réunion,515,0,8690,8690,16.9
51621,Vienne-le-Château,515,0,7647,7647,14.8
52543,Voillecomte,515,0,4664,4664,9.1
63187,Lapeyrouse,515,0,799,799,1.6
65335,Ordizan,515,0,3866,3866,7.5
67524,Weiterswiller,515,811,13878,14689,28.5
67528,Weyer,515,2881,6456,9337,18.1
76735,Veules-les-Roses,515,0,3335,3335,6.5
80199,Cléry-sur-Somme,515,0,3690,3690,7.2
80268,Épagne-Épagnette,515,0,1571,1571,3.1
88177,La Forge,515,0,4023,4023,7.8
89153,Épineuil,515,0,1196,1196,2.3
95271,Génicourt,515,0,13593,13593,26.4
1415,Talissieu,514,0,5729,5729,11.1
2405,Landouzy-la-Ville,514,0,10090,10090,19.6
9176,Luzenac,514,139420,74024,213444,415.3
11324,Roubia,514,8474,6964,15438,30
15250,Vebret,514,11300,2630,13930,27.1
17395,Saint-Sauvant,514,3810,16290,20100,39.1
23068,Cressat,514,0,7726,7726,15
38518,Valbonnais,514,0,5382,5382,10.5
41156,Mulsans,514,0,1548,1548,3
46177,Loubressac,514,0,16770,16770,32.6
54252,Haroué,514,0,0,0,0
55324,Marville,514,0,18376,18376,35.8
57509,Nitting,514,0,3346,3346,6.5
57720,Villing,514,0,3096,3096,6
60037,Babœuf,514,0,0,0,0
62845,Verlincthun,514,0,1484,1484,2.9
73178,La Motte-en-Bauges,514,0,6533,6533,12.7
76054,Bailly-en-Rivière,514,0,3251,3251,6.3
80173,Cardonnette,514,0,32953,32953,64.1
1127,Courmangoux,513,0,9918,9918,19.3
1436,Vesancy,513,0,6604,6604,12.9
2001,Abbécourt,513,0,9217,9217,18
10020,Avant-lès-Marcilly,513,0,0,0,0
12077,Cornus,513,0,21967,21967,42.8
16001,Abzac,513,2638,10555,13193,25.7
16347,Saint-Romain,513,9212,24123,33335,65
17214,Luchat,513,0,16259,16259,31.7
25136,Chaucenne,513,1700,9039,10739,20.9
26223,Oriol-en-Royans,513,0,32129,32129,62.6
32269,Monfort,513,0,1936,1936,3.8
53225,Saint-Germain-le-Guillaume,513,0,2331,2331,4.5
57679,Tritteling-Redlach,513,0,23805,23805,46.4
60431,Morlincourt,513,0,0,0,0
62150,Boisjean,513,0,8122,8122,15.8
62442,Hernicourt,513,0,11082,11082,21.6
67035,Berstheim,513,0,6238,6238,12.2
71237,Igornay,513,0,11478,11478,22.4
71399,Saint-Christophe-en-Brionnais,513,0,14538,14538,28.3
76506,Pommeréval,513,0,11984,11984,23.4
88508,Ville-sur-Illon,513,0,7373,7373,14.4
95483,Le Perchay,513,2280,23570,25850,50.4
2330,Francilly-Selency,512,0,4639,4639,9.1
21361,Lux,512,0,7288,7288,14.2
24271,Milhac-de-Nontron,512,5450,3431,8881,17.3
24577,Vézac,512,4790,3226,8016,15.7
25050,Le Bélieu,512,0,6095,6095,11.9
33078,Cabara,512,0,3572,3572,7
33456,Saint-Palais,512,0,4772,4772,9.3
35320,Saint-Uniac,512,0,9942,9942,19.4
45139,Estouy,512,0,636,636,1.2
50443,Sacey,512,0,12597,12597,24.6
51567,Thiéblemont-Farémont,512,0,3181,3181,6.2
60118,Caisnes,512,0,0,0,0
60565,Saint-André-Farivillers,512,0,11546,11546,22.6
62335,Fillièvres,512,0,8106,8106,15.8
67210,Le Hohwald,512,0,15834,15834,30.9
68103,Geispitzen,512,4440,9952,14392,28.1
68357,Waltenheim,512,0,9952,9952,19.4
70101,Broye-Aubigney-Montseugny,512,0,2584,2584,5
72098,Coulongé,512,0,2567,2567,5
73039,Belmont-Tramonet,512,0,758,758,1.5
81005,Albine,512,17085,4420,21505,42
81255,Saint-Jean-de-Rives,512,0,1672,1672,3.3
2757,Vadencourt,511,0,2817,2817,5.5
7100,Gravières,511,4770,12505,17275,33.8
7297,Saint-Sylvestre,511,0,9983,9983,19.5
8039,Avaux,511,0,9773,9773,19.1
9224,Pailhès,511,0,9088,9088,17.8
11339,Saint-Denis,511,0,6601,6601,12.9
17163,Fontaines-d'Ozillac,511,0,6034,6034,11.8
17210,Lorignac,511,0,6034,6034,11.8
18219,Saint-Laurent,511,2300,7383,9683,18.9
24100,Champniers-et-Reilhac,511,820,3424,4244,8.3
33098,Cardan,511,0,15669,15669,30.7
36150,Parnac,511,0,10306,10306,20.2
50606,Tribehou,511,0,2769,2769,5.4
51119,Champillon,511,0,1263,1263,2.5
51546,Somme-Suippe,511,0,4808,4808,9.4
54548,Vannes-le-Châtel,511,0,16943,16943,33.2
59432,Niergnies,511,0,6642,6642,13
60348,Larbroye,511,0,0,0,0
61248,Mantilly,511,6616,6341,12957,25.4
62661,Bouin-Plumoison,511,0,8090,8090,15.8
67428,Saint-Nabor,511,0,18561,18561,36.3
71242,Joncy,511,0,3552,3552,7
71438,Saint-Léger-du-Bois,511,0,11433,11433,22.4
72295,Saint-Longis,511,0,9476,9476,18.5
73322,Villarodin-Bourget,511,0,9029,9029,17.7
74046,Boussy,511,0,6920,6920,13.5
76220,Douvrend,511,2440,3232,5672,11.1
80592,Neuville-Coppegueule,511,0,706,706,1.4
85201,Saint-Benoist-sur-Mer,511,0,10259,10259,20.1
5098,Les Orres,510,65100,40755,105855,207.6
11413,Villardonnel,510,0,6588,6588,12.9
14480,Osmanville,510,0,3530,3530,6.9
14603,Saint-Laurent-de-Condel,510,0,15418,15418,30.2
15114,Marcenat,510,22580,115,22695,44.5
19081,Eyrein,510,3500,9677,13177,25.8
21017,Arcenant,510,0,2446,2446,4.8
22019,Bringolo,510,0,10329,10329,20.3
27258,Fort-Moville,510,0,7854,7854,15.4
27496,Rosay-sur-Lieure,510,0,3356,3356,6.6
30298,Saint-Sébastien-d'Aigrefeuille,510,0,15941,15941,31.3
36182,Saint-Benoît-du-Sault,510,0,10285,10285,20.2
47328,Saint-Georges,510,0,2938,2938,5.8
53143,Maisoncelles-du-Maine,510,0,3064,3064,6
60003,Abbeville-Saint-Lucien,510,0,11501,11501,22.6
61097,La Chapelle-Montligeon,510,9243,1791,11034,21.6
62286,Ecquedecques,510,0,8416,8416,16.5
65070,Bartrès,510,0,4872,4872,9.6
67484,Stundwiller,510,0,14053,14053,27.6
71155,Cronat,510,0,2622,2622,5.1
71426,Sainte-Hélène,510,0,7822,7822,15.3
72361,Tresson,510,0,9534,9534,18.7
81133,Lamillarié,510,0,10640,10640,20.9
86117,Jouhet,510,0,20627,20627,40.4
87072,Glanges,510,3975,8178,12153,23.8
1057,Boz,509,0,6990,6990,13.7
3207,Pierrefitte-sur-Loire,509,0,8791,8791,17.3
14576,Val-de-Vie,509,0,5666,5666,11.1
16072,Chadurie,509,2200,23935,26135,51.3
16131,Esse,509,4116,10472,14588,28.7
16207,Marcillac-Lanville,509,2400,35286,37686,74
16349,Sainte-Sévère,509,1700,19045,20745,40.8
21285,Franxault,509,0,3816,3816,7.5
28362,Saint-Victor-de-Buthon,509,0,362,362,0.7
2A070,Casaglione,509,0,2345,2345,4.6
32378,Saint-Germé,509,0,5095,5095,10
39422,Plainoiseau,509,1000,13529,14529,28.5
41251,Souvigny-en-Sologne,509,0,4179,4179,8.2
42306,Tarentaise,509,0,10414,10414,20.5
45276,Saint-Firmin-sur-Loire,509,0,5925,5925,11.6
54410,Onville,509,0,3039,3039,6
55150,Demange-Baudignécourt,509,0,9949,9949,19.5
59229,Féron,509,0,8350,8350,16.4
62251,Courset,509,0,1470,1470,2.9
62298,Épinoy,509,0,633,633,1.2
65035,Artagnan,509,0,11498,11498,22.6
67349,Oberrœdern,509,0,14025,14025,27.6
67545,Witternheim,509,0,9411,9411,18.5
74261,Saxel,509,0,8177,8177,16.1
78590,Senlisse,509,0,642,642,1.3
80834,Yzengremer,509,0,3384,3384,6.6
88159,Entre-deux-Eaux,509,0,4949,4949,9.7
88244,La Houssière,509,0,4949,4949,9.7
2483,Mézières-sur-Oise,508,0,0,0,0
3238,Saint-Hilaire,508,0,7803,7803,15.4
4122,Mirabeau,508,4682,21293,25975,51.1
12277,Taussac,508,0,17214,17214,33.9
14737,Versainville,508,0,7958,7958,15.7
24196,Génis,508,1000,6387,7387,14.5
29033,Le Cloître-Pleyben,508,0,8006,8006,15.8
2B079,Castello-di-Rostino,508,0,1910,1910,3.8
36191,Saint-Florentin,508,0,10318,10318,20.3
37026,Betz-le-Château,508,13640,8818,22458,44.2
40329,Le Vignau,508,0,2374,2374,4.7
46023,Belfort-du-Quercy,508,0,2856,2856,5.6
57066,Berthelming,508,0,3307,3307,6.5
59241,Floyon,508,0,4024,4024,7.9
63155,Estandeuil,508,0,4873,4873,9.6
65267,Lau-Balagnas,508,0,20802,20802,40.9
67069,Buhl,508,520,58254,58774,115.7
68158,Jettingen,508,0,13627,13627,26.8
71393,Saint-Bonnet-de-Cray,508,0,14396,14396,28.3
71494,La Salle,508,4859,12976,17835,35.1
71570,Verjux,508,0,5862,5862,11.5
76395,Longueil,508,0,4099,4099,8.1
80076,Béhen,508,0,3377,3377,6.6
81119,Laboutarie,508,0,10598,10598,20.9
97211,Grand'Rivière,508,19000,4599,23599,46.5
2659,Rouvroy,507,0,72462,72462,142.9
10158,Fouchères,507,0,8850,8850,17.5
12098,Estaing,507,0,2511,2511,5
14209,Crouay,507,0,3510,3510,6.9
18036,Brinay,507,1105,6879,7984,15.7
22244,Plussulien,507,0,0,0,0
24286,Montagrier,507,0,3850,3850,7.6
31045,Barbazan,507,0,4853,4853,9.6
34221,Puéchabon,507,0,2739,2739,5.4
39451,Ranchot,507,1400,8000,9400,18.5
41216,Saint-Jean-Froidmentel,507,0,2575,2575,5.1
42148,Montchal,507,4655,9190,13845,27.3
45199,Melleroy,507,0,1537,1537,3
57626,Sanry-lès-Vigy,507,0,1235,1235,2.4
80282,Érondelle,507,0,1547,1547,3.1
80345,Franleu,507,0,1547,1547,3.1
80808,Vironchaux,507,0,12555,12555,24.8
3113,Ferrières-sur-Sichon,506,0,13862,13862,27.4
8198,Grandpré,506,0,12243,12243,24.2
24380,Saint-Barthélemy-de-Bellegarde,506,0,3846,3846,7.6
25187,Dambelin,506,0,32032,32032,63.3
26103,Condorcet,506,0,26001,26001,51.4
27374,Louversey,506,0,4502,4502,8.9
28234,Marchéville,506,0,1872,1872,3.7
31360,Montauban-de-Luchon,506,0,4844,4844,9.6
33305,Le Nizan,506,0,168,168,0.3
39338,Molay,506,990,2997,3987,7.9
52512,Vecqueville,506,0,1874,1874,3.7
57169,Dannelbourg,506,0,1015,1015,2
57197,Ernestviller,506,0,6915,6915,13.7
57398,Leyviller,506,0,8640,8640,17.1
57578,Rezonville-Vionville,506,0,3021,3021,6
63459,Villeneuve-les-Cerfs,506,0,2068,2068,4.1
64145,Bourdettes,506,0,5411,5411,10.7
70353,Montagney,506,0,342,342,0.7
71258,Leynes,506,330,12925,13255,26.2
78096,Bourdonné,506,0,5073,5073,10
81203,Paulinet,506,0,6365,6365,12.6
89119,Coulanges-sur-Yonne,506,2009,10587,12596,24.9
1357,Saint-Germain-de-Joux,505,0,6081,6081,12
7184,Pranles,505,0,1685,1685,3.3
24070,Busserolles,505,500,3384,3884,7.7
31566,Vallègue,505,0,2463,2463,4.9
33008,Porte-de-Benauge,505,0,5015,5015,9.9
34097,Félines-Minervois,505,0,1912,1912,3.8
39124,Chaumergy,505,0,13422,13422,26.6
45014,Aulnay-la-Rivière,505,0,3827,3827,7.6
57338,Hottviller,505,0,11639,11639,23
60021,Appilly,505,0,0,0,0
60076,Blargies,505,0,2478,2478,4.9
64106,Béhasque-Lapiste,505,0,13123,13123,26
67436,Saulxures,505,1593,36546,38139,75.5
70390,Noroy-le-Bourg,505,0,1868,1868,3.7
72237,Pirmil,505,0,4589,4589,9.1
77287,Meilleray,505,0,8316,8316,16.5
77368,Poigny,505,0,1821,1821,3.6
80078,Bellancourt,505,0,1541,1541,3.1
80328,Fontaine-sur-Somme,505,0,1541,1541,3.1
95348,Longuesse,505,0,23203,23203,45.9
2768,Vauxaillon,504,0,499,499,1
3072,Chazemais,504,0,2051,2051,4.1
8202,Gué-d'Hossus,504,0,7846,7846,15.6
19105,Lanteuil,504,0,2541,2541,5
22348,Trédias,504,4581,6083,10664,21.2
35052,Champeaux,504,0,7572,7572,15
47022,Bazens,504,0,4842,4842,9.6
51102,Cauroy-lès-Hermonville,504,0,8957,8957,17.8
51293,Heutrégiville,504,0,8957,8957,17.8
57111,Bronvaux,504,0,126,126,0.2
57253,Gondrexange,504,0,3281,3281,6.5
59223,Le Favril,504,0,1422,1422,2.8
60220,Espaubourg,504,2667,4132,6799,13.5
60435,Morvillers,504,0,2473,2473,4.9
63061,Bussières-et-Pruns,504,0,2060,2060,4.1
64091,Baliros,504,0,5390,5390,10.7
68306,Seppois-le-Haut,504,0,7177,7177,14.2
76004,Ambrumesnil,504,7230,4067,11297,22.4
76186,Conteville,504,0,9,9,0
77115,Chevry-en-Sereine,504,0,356,356,0.7
84115,Saint-Pierre-de-Vassols,504,0,16457,16457,32.7
88464,Tendon,504,0,3937,3937,7.8
8212,Harcy,503,0,7831,7831,15.6
10074,Chamoy,503,0,9364,9364,18.6
10299,Pouan-les-Vallées,503,0,428,428,0.9
15029,Cassaniouze,503,11310,4410,15720,31.3
17304,Rouffiac,503,0,15942,15942,31.7
17428,Sonnac,503,0,14011,14011,27.9
21531,Rouvray,503,0,1443,1443,2.9
28180,Gilles,503,0,673,673,1.3
2A330,Ucciani,503,0,6866,6866,13.7
2B223,Pietralba,503,0,7059,7059,14
35102,Drouges,503,0,7557,7557,15
36047,La Châtre-Langlin,503,7059,10144,17203,34.2
41063,Couffy,503,675,9243,9918,19.7
51264,Le Gault-Soigny,503,0,16161,16161,32.1
53057,La Chapelle-au-Riboul,503,0,18692,18692,37.2
54312,Lesménils,503,0,5496,5496,10.9
60242,Fontaine-Lavaganne,503,0,2468,2468,4.9
62897,Wismes,503,0,1088,1088,2.2
63463,Viscomtat,503,0,11662,11662,23.2
71535,Tavernay,503,0,11254,11254,22.4
72324,Saint-Vincent-des-Prés,503,0,9327,9327,18.5
80722,Saint-Vaast-en-Chaussée,503,0,32248,32248,64.1
4226,Uvernet-Fours,502,45093,149920,195013,388.5
9050,Benagues,502,0,2260,2260,4.5
10332,Ruvigny,502,0,7169,7169,14.3
12203,Roquefort-sur-Soulzon,502,0,1052,1052,2.1
14016,Annebault,502,0,8068,8068,16.1
24292,Montpeyroux,502,0,1749,1749,3.5
24494,Saint-Rémy,502,1650,1749,3399,6.8
27533,Saint-Denis-le-Ferment,502,0,409,409,0.8
28281,Nogent-sur-Eure,502,0,14628,14628,29.1
34017,Aumes,502,4450,5576,10026,20
37260,La Tour-Saint-Gelin,502,0,13621,13621,27.1
44058,Fercé,502,0,8420,8420,16.8
45037,Boisseaux,502,0,1826,1826,3.6
53208,Saint-Cyr-en-Pail,502,0,4465,4465,8.9
55385,Nixéville-Blercourt,502,0,3195,3195,6.4
63438,Trézioux,502,0,4815,4815,9.6
65150,Clarens,502,0,1499,1499,3
73138,Jarrier,502,0,13481,13481,26.9
76518,Raffetot,502,0,3826,3826,7.6
88322,La Neuveville-devant-Lépanges,502,0,658,658,1.3
88497,Vaxoncourt,502,0,12624,12624,25.1
95253,Frémainville,502,5000,23065,28065,55.9
16261,Les Pins,501,3655,10308,13963,27.9
17325,Saint-Dizant-du-Gua,501,0,5916,5916,11.8
21339,Lantenay,501,0,2818,2818,5.6
23087,Fresselines,501,0,14957,14957,29.9
24228,Lanquais,501,1930,1820,3750,7.5
30292,Saint-Pons-la-Calm,501,0,7311,7311,14.6
32448,Touget,501,0,1891,1891,3.8
33166,Le Fieu,501,0,9773,9773,19.5
47242,Saint-Front-sur-Lémance,501,0,2886,2886,5.8
54010,Allamps,501,0,16611,16611,33.2
57695,Varize-Vaudoncourt,501,0,3017,3017,6
59259,Ghissignies,501,0,1414,1414,2.8
64214,Espès-Undurein,501,0,13019,13019,26
67120,Eichhoffen,501,7910,15494,23404,46.7
70079,Bougnon,501,0,2975,2975,5.9
76122,Callengeville,501,0,11703,11703,23.4
76573,Saint-Denis-le-Thiboult,501,0,342,342,0.7
83060,Fox-Amphoux,501,0,5139,5139,10.3
1434,Versailleux,500,0,104,104,0.2
5075,Manteyer,500,0,18711,18711,37.4
7216,Saint-Barthélemy-Grozon,500,5371,14315,19686,39.4
21127,Chaignay,500,0,7117,7117,14.2
25100,Bulle,500,0,7253,7253,14.5
38254,Monteynard,500,0,5235,5235,10.5
40249,Saint-Aubin,500,0,7830,7830,15.7
53026,Beaulieu-sur-Oudon,500,0,21760,21760,43.5
60662,Le Vauroux,500,5620,4099,9719,19.4
63386,Saint-Pierre-Roche,500,0,1565,1565,3.1
81285,Sérénac,500,0,15449,15449,30.9
3034,Boucé,499,0,8619,8619,17.3
21517,Quincey,499,0,2393,2393,4.8
21680,Vielverge,499,0,0,0,0
28240,Meaucé,499,0,355,355,0.7
32436,Solomiac,499,0,1883,1883,3.8
33502,Saugon,499,0,5107,5107,10.2
46172,Lhospitalet,499,0,12266,12266,24.6
50335,Montaigu-la-Brisette,499,0,15696,15696,31.5
50499,Saint-Laurent-de-Cuves,499,0,12278,12278,24.6
54585,Virecourt,499,0,2062,2062,4.1
59048,Bantigny,499,0,6486,6486,13
60253,Francastel,499,0,19567,19567,39.2
68169,Kœstlach,499,0,13386,13386,26.8
72007,Ardenay-sur-Mérize,499,0,9328,9328,18.7
72321,Saint-Symphorien,499,0,9735,9735,19.5
76489,Oudalle,499,0,4501,4501,9
80519,Matigny,499,0,9511,9511,19.1
88176,Fontenoy-le-Château,499,0,12549,12549,25.1
10396,Vauchassis,498,0,7111,7111,14.3
21609,Soirans,498,0,0,0,0
31330,Mauressac,498,0,2619,2619,5.3
33462,Saint-Philippe-du-Seignal,498,0,3759,3759,7.5
39042,Baverans,498,0,10107,10107,20.3
41068,Courmemin,498,2839,10494,13333,26.8
45099,Coinces,498,0,702,702,1.4
45275,Saint-Firmin-des-Bois,498,0,1510,1510,3
47237,Sainte-Colombe-de-Villeneuve,498,0,3816,3816,7.7
50198,Geffosses,498,0,10406,10406,20.9
51598,Vauclerc,498,0,2922,2922,5.9
54288,Lagney,498,0,1039,1039,2.1
61124,La Coulonche,498,3082,13338,16420,33
72317,Saint-Rémy-du-Val,498,0,9235,9235,18.5
74222,Reyvroz,498,5300,34798,40098,80.5
76460,Nesle-Normandeuse,498,6500,9,6509,13.1
77178,Faÿ-lès-Nemours,498,0,255,255,0.5
77306,Montereau-sur-le-Jard,498,0,6939,6939,13.9
78349,Longvilliers,498,0,970,970,1.9
80004,Acheux-en-Vimeu,498,0,3311,3311,6.6
2160,Chaourse,497,0,5476,5476,11
7250,Saint-Jeure-d'Ay,497,1410,1405,2815,5.7
11126,Escales,497,0,6734,6734,13.5
24410,Saint-Front-la-Rivière,497,2520,3330,5850,11.8
25033,Autechaux-Roide,497,0,31462,31462,63.3
25214,Écot,497,0,31462,31462,63.3
27393,Martainville,497,0,7654,7654,15.4
34118,Guzargues,497,0,9260,9260,18.6
36169,Pruniers,497,5360,10095,15455,31.1
57684,Vahl-Ebersing,497,0,8486,8486,17.1
58180,Montsauche-les-Settons,497,3455,5856,9311,18.7
62332,Ficheux,497,0,13979,13979,28.1
68150,Husseren-les-Châteaux,497,0,48798,48798,98.2
71097,La Chapelle-Thècle,497,0,2897,2897,5.8
71552,Uxeau,497,0,2555,2555,5.1
80094,Berteaucourt-lès-Thennes,497,0,3053,3053,6.1
2572,Orainville,496,0,1335,1335,2.7
2617,Pouilly-sur-Serre,496,0,2499,2499,5
3184,Montilly,496,0,6677,6677,13.5
5126,Rosans,496,0,14787,14787,29.8
9229,Le Peyrat,496,0,10274,10274,20.7
16012,Angeac-Champagne,496,4475,18558,23033,46.4
16258,Pérignac,496,2090,26522,28612,57.7
17033,La Barde,496,0,5857,5857,11.8
18216,Saint-Hilaire-en-Lignières,496,0,1330,1330,2.7
24388,Saint-Chamassy,496,6050,6885,12935,26.1
25149,Chenecey-Buillon,496,0,3614,3614,7.3
28378,Souancé-au-Perche,496,0,193,193,0.4
31101,Cambernard,496,0,17370,17370,35
41028,Busloup,496,0,2519,2519,5.1
41099,Gy-en-Sologne,496,0,9114,9114,18.4
51422,Pargny-lès-Reims,496,0,8815,8815,17.8
53117,Houssay,496,0,22267,22267,44.9
53213,Saint-Ellier-du-Maine,496,0,6540,6540,13.2
62644,Ouve-Wirquin,496,0,1073,1073,2.2
69104,Jullié,496,0,0,0,0
71092,La Chapelle-Naude,496,0,2042,2042,4.1
71303,Montagny-près-Louhans,496,0,2042,2042,4.1
79286,Saint-Paul-en-Gâtine,496,0,14110,14110,28.4
80122,Bouquemaison,496,0,1933,1933,3.9
14240,Épaney,495,0,7754,7754,15.7
16160,Guimps,495,0,26468,26468,53.5
23143,Noth,495,0,9368,9368,18.9
24129,Condat-sur-Trincou,495,410,6974,7384,14.9
24272,Minzac,495,0,1725,1725,3.5
25611,La Vèze,495,0,8722,8722,17.6
28046,Boissy-lès-Perche,495,0,8836,8836,17.9
33405,Saint-Genès-de-Blaye,495,0,5066,5066,10.2
53022,La Bazouge-de-Chemeré,495,0,2974,2974,6
53053,Champgenéteux,495,0,3541,3541,7.2
57314,Héming,495,0,3223,3223,6.5
60425,Montreuil-sur-Brêche,495,0,11163,11163,22.6
63199,Ludesse,495,0,3218,3218,6.5
63222,Meilhaud,495,0,3218,3218,6.5
68353,Wahlbach,495,0,9621,9621,19.4
71024,Baugy,495,0,11091,11091,22.4
71591,Fleurville,495,0,11520,11520,23.3
77391,Rouilly,495,0,1785,1785,3.6
88430,Saint-Ouen-lès-Parey,495,0,174,174,0.4
11077,Castelnau-d'Aude,494,0,6693,6693,13.5
16416,Vitrac-Saint-Vincent,494,2570,10164,12734,25.8
17201,La Laigne,494,1500,7197,8697,17.6
21267,Flagey-Echézeaux,494,0,2369,2369,4.8
25400,Montgesoye,494,0,3600,3600,7.3
34080,Colombières-sur-Orb,494,9825,1870,11695,23.7
39047,Bellefontaine,494,99670,1889,101559,205.6
41285,Villeny,494,0,4122,4122,8.3
48148,Saint-Étienne-Vallée-Française,494,12087,26905,38992,78.9
50365,Muneville-sur-Mer,494,0,11956,11956,24.2
63109,Chidrac,494,0,3211,3211,6.5
65029,Arras-en-Lavedan,494,0,20229,20229,40.9
71227,Grury,494,0,2540,2540,5.1
81190,Mouzieys-Teulet,494,0,6214,6214,12.6
89237,Mailly-la-Ville,494,3325,67,3392,6.9
3319,Voussac,493,0,17613,17613,35.7
5156,Saint-Sauveur,493,0,39396,39396,79.9
11325,Rouffiac-d'Aude,493,0,3198,3198,6.5
11393,Tourouzelle,493,0,6680,6680,13.5
16293,Saint-Adjutory,493,3815,8792,12607,25.6
17082,Champagnac,493,0,5821,5821,11.8
22042,Coatréven,493,0,9794,9794,19.9
27633,Les Thilliers-en-Vexin,493,0,402,402,0.8
30098,Crespian,493,0,36674,36674,74.4
31448,Rebigue,493,0,8038,8038,16.3
31560,Trébons-sur-la-Grasse,493,0,2405,2405,4.9
34187,Olargues,493,0,1866,1866,3.8
39299,Longwy-sur-le-Doubs,493,2400,2920,5320,10.8
40214,Ossages,493,0,3669,3669,7.4
41203,Saint-Bohaire,493,0,18895,18895,38.3
59405,Mœuvres,493,0,6408,6408,13
64349,Loubieng,493,0,13275,13275,26.9
71332,Ormes,493,0,2874,2874,5.8
71388,Saint-Aubin-en-Charollais,493,0,1911,1911,3.9
73104,Dullin,493,0,25256,25256,51.2
81159,Massac-Séran,493,0,1610,1610,3.3
86104,Genouillé,493,0,11102,11102,22.5
91247,La Forêt-le-Roi,493,0,2866,2866,5.8
8264,Machault,492,0,11904,11904,24.2
29295,Trémaouézan,492,1850,3813,5663,11.5
31238,Huos,492,0,4710,4710,9.6
37005,Antogny-le-Tillac,492,0,13350,13350,27.1
37234,Saint-Quentin-sur-Indrois,492,0,8540,8540,17.4
54131,Clémery,492,0,2911,2911,5.9
59537,Saint-Martin-sur-Écaillon,492,0,124,124,0.3
63090,Chaptuzat,492,0,2011,2011,4.1
64064,Asasp-Arros,492,0,10595,10595,21.5
67147,Frœschwiller,492,1070,11904,12974,26.4
71392,Saint-Boil,492,0,7546,7546,15.3
76064,Beaurepaire,492,0,4438,4438,9
77262,Louan-Villegruis-Fontaine,492,0,1774,1774,3.6
85077,Curzon,492,0,9878,9878,20.1
86080,Cloué,492,0,29313,29313,59.6
88340,Padoux,492,0,12372,12372,25.1
14552,Ryes,491,0,18924,18924,38.5
17027,Avy,491,0,5798,5798,11.8
18117,Jars,491,0,8846,8846,18
27568,Sainte-Marthe,491,0,4368,4368,8.9
30109,Euzet,491,0,15347,15347,31.3
33239,Lerm-et-Musset,491,0,163,163,0.3
36172,Rivarennes,491,0,2699,2699,5.5
38456,Châtel-en-Trièves,491,0,13755,13755,28
48089,Le Malzieu-Forain,491,0,5044,5044,10.3
51227,Écury-sur-Coole,491,0,820,820,1.7
62212,Capelle-lès-Hesdin,491,0,7774,7774,15.8
66082,Formiguères,491,0,0,0,0
67215,Huttendorf,491,1830,5970,7800,15.9
67255,Lalaye,491,0,77880,77880,158.6
70255,Fresne-Saint-Mamès,491,0,2220,2220,4.5
88341,Pair-et-Grandrupt,491,0,4774,4774,9.7
2721,Sissy,490,0,0,0,0
8001,Acy-Romance,490,0,9371,9371,19.1
10173,Isle-Aumont,490,0,6997,6997,14.3
18049,La Chapelle-Montlinard,490,0,27655,27655,56.4
21227,Darois,490,0,0,0,0
22286,Saint-Denoual,490,32744,5914,38658,78.9
27123,Caillouet-Orgeville,490,0,2575,2575,5.3
39194,Desnes,490,1170,13024,14194,29
40240,Renung,490,0,15339,15339,31.3
41287,Villerable,490,0,6061,6061,12.4
50467,Saint-Floxel,490,0,15413,15413,31.5
53031,La Bigottière,490,0,2227,2227,4.5
54008,Allain,490,0,16246,16246,33.2
62463,Hucqueliers,490,0,28996,28996,59.2
64241,Géronce,490,0,10552,10552,21.5
67361,Olwisheim,490,0,5958,5958,12.2
72111,Cures,490,0,9559,9559,19.5
73262,Saint-Nicolas-la-Chapelle,490,0,11559,11559,23.6
74223,La Rivière-Enverse,490,3882,94143,98025,200.1
76449,Montreuil-en-Caux,490,0,3954,3954,8.1
77408,Saint-Fiacre,490,0,6682,6682,13.6
82030,Castelferrus,490,0,6293,6293,12.8
90014,Boron,490,0,2914,2914,5.9
1116,Contrevoz,489,0,5450,5450,11.1
10070,Celles-sur-Ource,489,0,8536,8536,17.5
12290,Vaureilles,489,0,8399,8399,17.2
17250,Mosnac,489,0,5774,5774,11.8
24460,Saint-Méard-de-Drône,489,1170,3713,4883,10
27076,Boisset-les-Prévanches,489,0,2569,2569,5.3
27101,Bouquelon,489,0,11046,11046,22.6
27623,Surtauville,489,0,14502,14502,29.7
37039,Bridoré,489,4790,8488,13278,27.2
37149,Marray,489,0,5427,5427,11.1
47045,Calignac,489,0,2371,2371,4.8
51399,La Neuville-au-Pont,489,0,7261,7261,14.8
59568,Sercus,489,0,2988,2988,6.1
60070,Bienville,489,0,4404,4404,9
70528,Velesmes-Échevanne,489,0,2468,2468,5
71396,Saint-Bonnet-en-Bresse,489,3650,60,3710,7.6
71530,Sully,489,0,10941,10941,22.4
84041,Crillon-le-Brave,489,0,15967,15967,32.7
87151,Saint-Jean-Ligoure,489,1750,6628,8378,17.1
87160,Saint-Léger-Magnazeix,489,3150,8323,11473,23.5
88243,Housseras,489,0,2440,2440,5
89229,Lixy,489,2400,1735,4135,8.5
89319,Quenne,489,3200,9566,12766,26.1
89388,Sépeaux-Saint Romain,489,1750,3833,5583,11.4
1355,Saint-Genis-sur-Menthon,488,0,1976,1976,4
2191,Chivy-lès-Étouvelles,488,0,18637,18637,38.2
16323,Saint-Germain-de-Montbron,488,6108,8702,14810,30.3
18008,Arçay,488,409,9347,9756,20
19079,Eyburie,488,0,0,0,0
27307,Guiseniers,488,0,2564,2564,5.3
28161,Frazé,488,0,347,347,0.7
31316,Marignac,488,0,4671,4671,9.6
46317,Thégra,488,0,15921,15921,32.6
56245,Silfiac,488,0,3398,3398,7
60180,Crillon,488,0,2394,2394,4.9
61098,La Chapelle-près-Sées,488,11145,3062,14207,29.1
62837,Vaudringhem,488,0,1056,1056,2.2
63353,Saint-Germain-l'Herm,488,6793,4410,11203,23
64220,Estos,488,0,10509,10509,21.5
65464,Vielle-Adour,488,0,4662,4662,9.6
68307,Sewen,488,0,10239,10239,21
73273,Saint-Pierre-de-Curtille,488,0,2700,2700,5.5
80411,Le Hamel,488,0,64,64,0.1
81075,Cuq,488,0,7299,7299,15
88246,Hymont,488,0,7013,7013,14.4
4163,Revest-du-Bion,487,0,1283,1283,2.6
11359,Saint-Michel-de-Lanès,487,0,4279,4279,8.8
16198,Magnac-Lavalette-Villars,487,4016,22900,26916,55.3
19024,Beyssac,487,0,4683,4683,9.6
24336,Prats-de-Carlux,487,1924,1863,3787,7.8
25091,Les Bréseux,487,0,3393,3393,7
27389,Marbeuf,487,0,2094,2094,4.3
33309,Ordonnac,487,0,4282,4282,8.8
36215,Ségry,487,0,11499,11499,23.6
37144,Marçay,487,0,26731,26731,54.9
38387,Saint-Geoirs,487,0,5313,5313,10.9
43203,Saint-Julien-du-Pinet,487,0,11416,11416,23.4
46189,Mayrinhac-Lentour,487,0,15889,15889,32.6
57479,Montenach,487,0,7010,7010,14.4
57648,Servigny-lès-Raville,487,0,1186,1186,2.4
59372,Malincourt,487,0,3346,3346,6.9
60669,Verderonne,487,0,204,204,0.4
61269,Ménil-Hubert-sur-Orne,487,3700,13043,16743,34.4
62113,Berles-Monchel,487,0,4047,4047,8.3
73216,Rognaix,487,0,11488,11488,23.6
73235,Saint François Longchamp,487,0,69772,69772,143.3
76676,Sigy-en-Bray,487,0,9200,9200,18.9
77281,Mauperthuis,487,0,1897,1897,3.9
79310,Secondigné-sur-Belle,487,0,14065,14065,28.9
95676,Villers-en-Arthies,487,0,3079,3079,6.3
8113,Chaumont-Porcien,486,0,10660,10660,21.9
19234,Saint-Pardoux-l'Ortigier,486,8189,7756,15945,32.8
27106,Bournainville-Faverolles,486,0,7484,7484,15.4
27309,L'Habit,486,0,5716,5716,11.8
40097,Eugénie-les-Bains,486,0,15214,15214,31.3
41246,Seur,486,0,18626,18626,38.3
46293,Saint-Sozy,486,0,15856,15856,32.6
47005,Allemans-du-Dropt,486,0,9051,9051,18.6
55042,Belleray,486,0,30123,30123,62
57244,Garrebourg,486,0,975,975,2
57700,Vaudreching,486,0,6996,6996,14.4
61126,Coulonges-sur-Sarthe,486,3436,171,3607,7.4
61405,Saint-Hilaire-sur-Erre,486,3848,5643,9491,19.5
63246,Murat-le-Quaire,486,0,3548,3548,7.3
70250,Franchevelle,486,0,1798,1798,3.7
74232,Saint-Eustache,486,0,3754,3754,7.7
81211,Poulan-Pouzols,486,0,10139,10139,20.9
19220,Saint-Martial-de-Gimel,485,0,9203,9203,19
21349,Liernais,485,0,14960,14960,30.8
21475,Pagny-le-Château,485,0,3637,3637,7.5
24448,Saint-Martial-d'Albarède,485,3477,6098,9575,19.7
25605,Vernierfontaine,485,0,5729,5729,11.8
26035,Beaufort-sur-Gervanne,485,0,5875,5875,12.1
46165,Lavergne,485,0,15823,15823,32.6
51447,Prosnes,485,0,8619,8619,17.8
57309,Heining-lès-Bouzonville,485,0,6982,6982,14.4
60122,Campeaux,485,0,2379,2379,4.9
62140,Bléquin,485,0,1049,1049,2.2
62451,Heuchin,485,0,10478,10478,21.6
63249,Néronde-sur-Dore,485,0,11245,11245,23.2
87133,Saint-Amand-Magnazeix,485,0,14720,14720,30.4
2469,Marly-Gomont,484,0,2668,2668,5.5
7194,Rochessauve,484,0,1615,1615,3.3
11175,Issel,484,0,4253,4253,8.8
17130,Coux,484,0,5715,5715,11.8
21162,Chaux,484,0,2321,2321,4.8
28354,Saint-Maurice-Saint-Germain,484,0,345,345,0.7
34219,Prémian,484,0,1832,1832,3.8
38417,Sainte-Marie-d'Alloix,484,2960,8993,11953,24.7
39349,Montain,484,500,12864,13364,27.6
42210,Sainte-Croix-en-Jarez,484,0,11340,11340,23.4
43043,Céaux-d'Allègre,484,2610,20139,22749,47
53195,Sacé,484,0,17986,17986,37.2
57312,Helstroff,484,0,2915,2915,6
60315,Hodenc-en-Bray,484,0,3968,3968,8.2
61189,Giel-Courteilles,484,0,2762,2762,5.7
62285,Écoust-Saint-Mein,484,0,2406,2406,5
62611,Neuville-Vitasse,484,0,13613,13613,28.1
64462,Ramous,484,0,13032,13032,26.9
68199,Malmerspach,484,0,5029,5029,10.4
70055,Baudoncourt,484,0,465,465,1
70136,Charmoille,484,0,25037,25037,51.7
71460,Saint-Maurice-de-Satonnay,484,426,12363,12789,26.4
72163,Ligron,484,0,3509,3509,7.2
79190,Neuvy-Bouin,484,0,13768,13768,28.4
85101,Le Givre,484,0,9717,9717,20.1
88190,Frizon,484,0,12171,12171,25.1
91602,Souzy-la-Briche,484,0,3278,3278,6.8
3273,Seuillet,483,0,13232,13232,27.4
5173,Upaix,483,0,14399,14399,29.8
9164,Lescure,483,0,58530,58530,121.2
17141,Dompierre-sur-Charente,483,0,15308,15308,31.7
33546,Vignonet,483,0,18765,18765,38.9
39364,Montrond,483,3910,4890,8800,18.2
42001,Aboën,483,0,11317,11317,23.4
47278,Saint-Sernin,483,0,23793,23793,49.3
50580,Sotteville,483,0,15193,15193,31.5
51428,Les Petites-Loges,483,0,8584,8584,17.8
51605,Venteuil,483,0,699,699,1.4
61457,Saint-Symphorien-des-Bruyères,483,11373,4979,16352,33.9
68037,Biltzheim,483,100,3812,3912,8.1
80305,Ferrières,483,0,30966,30966,64.1
81298,Teulat,483,0,1578,1578,3.3
85116,La Jonchère,483,0,9697,9697,20.1
11021,Axat,482,0,5295,5295,11
17145,Échebrune,482,0,5691,5691,11.8
21522,Renève,482,0,2099,2099,4.4
24417,Saint-Germain-des-Prés,482,90,6060,6150,12.8
24486,Saint-Pierre-de-Frugie,482,590,1590,2180,4.5
25515,Sainte-Colombe,482,0,13777,13777,28.6
27384,Manneville-la-Raoult,482,0,3601,3601,7.5
30072,Castelnau-Valence,482,0,15066,15066,31.3
40188,Momuy,482,0,11136,11136,23.1
42154,Néronde,482,4095,8737,12832,26.6
47289,La Sauvetat-de-Savères,482,0,11034,11034,22.9
58258,Saint-Ouen-sur-Loire,482,0,1243,1243,2.6
71191,Essertenne,482,0,7745,7745,16.1
72112,Dangeul,482,0,8938,8938,18.5
73116,Fontcouverte-la-Toussuire,482,0,12944,12944,26.9
77011,Aufferville,482,0,508,508,1.1
80144,Brouchy,482,0,9187,9187,19.1
89015,Arcy-sur-Cure,482,1250,1045,2295,4.8
1040,Béréziat,481,0,9299,9299,19.3
5084,Montgardin,481,0,4291,4291,8.9
16007,Alloue,481,12465,9896,22361,46.5
16123,Échallat,481,2230,33345,35575,74
18189,Quantilly,481,0,3645,3645,7.6
24217,Journiac,481,730,6677,7407,15.4
25071,Bondeval,481,0,30449,30449,63.3
28426,Ymonville,481,0,2526,2526,5.3
31501,Saint-Marcel-Paulel,481,0,5395,5395,11.2
49107,Cornillé-les-Caves,481,0,3680,3680,7.7
51036,Barbonne-Fayel,481,0,6276,6276,13
60386,Marquéglise,481,0,4205,4205,8.7
63270,Parentignat,481,0,3127,3127,6.5
67139,Flexbourg,481,2200,26124,28324,58.9
68259,Raedersdorf,481,0,12903,12903,26.8
69098,Les Halles,481,950,24109,25059,52.1
71193,Étrigny,481,0,5827,5827,12.1
77353,Paley,481,0,1673,1673,3.5
87092,Marval,481,0,212,212,0.4
88086,Champ-le-Duc,481,0,631,631,1.3
89405,Les Hauts de Forterre,481,3550,21719,25269,52.5
4084,Estoublon,480,0,20119,20119,41.9
12252,Salles-Courbatiès,480,0,1400,1400,2.9
15085,Labrousse,480,3880,16263,20143,42
19192,Saint-Chamant,480,0,1425,1425,3
23048,Champagnat,480,0,6302,6302,13.1
25452,Pierrefontaine-lès-Blamont,480,2123,30386,32509,67.7
26287,Roynac,480,6356,4625,10981,22.9
31339,Mérenvielle,480,0,147,147,0.3
37019,Barrou,480,0,8332,8332,17.4
37086,Courcelles-de-Touraine,480,0,4453,4453,9.3
57025,Anzeling,480,0,6910,6910,14.4
59506,Romeries,480,0,121,121,0.3
60622,Sommereux,480,0,2355,2355,4.9
66198,Sournia,480,0,11736,11736,24.4
70162,Colombe-lès-Vesoul,480,0,1776,1776,3.7
71477,Saint-Romain-sous-Gourdon,480,0,7713,7713,16.1
76332,Grumesnil,480,0,9068,9068,18.9
84146,Villedieu,480,0,561,561,1.2
88375,Raves,480,0,4667,4667,9.7
89351,Sainte-Magnance,480,1872,1041,2913,6.1
5063,La Grave,479,0,34170,34170,71.3
8469,Vendresse,479,0,10506,10506,21.9
17187,Guitinières,479,0,5656,5656,11.8
19236,Saint-Priest-de-Gimel,479,1500,9089,10589,22.1
31051,Beaufort,479,0,16774,16774,35
31159,Le Cuing,479,0,9922,9922,20.7
33358,Romagne,479,0,4757,4757,9.9
42090,Essertines-en-Donzy,479,0,8682,8682,18.1
42153,Neaux,479,3480,13579,17059,35.6
54378,Montigny-sur-Chiers,479,0,6081,6081,12.7
57322,Hestroff,479,0,6895,6895,14.4
57365,Kirschnaumen,479,0,6895,6895,14.4
58064,Châteauneuf-Val-de-Bargis,479,0,9550,9550,19.9
59607,Vendegies-au-Bois,479,0,1352,1352,2.8
60039,Bacouël,479,0,10802,10802,22.6
60136,Cempuis,479,0,2350,2350,4.9
60288,Grémévillers,479,0,2350,2350,4.9
62248,Courcelles-le-Comte,479,0,2382,2382,5
64310,Lanne-en-Barétous,479,0,10315,10315,21.5
70306,Lomont,479,0,21056,21056,44
71061,Brienne,479,0,2792,2792,5.8
76166,Le Caule-Sainte-Beuve,479,0,9,9,0
76388,Lintot,479,0,3650,3650,7.6
76598,Saint-Léger-aux-Bois,479,0,9,9,0
77414,Saint-Hilliers,479,0,1727,1727,3.6
79175,Melleran,479,0,13834,13834,28.9
87017,Blanzac,479,0,8152,8152,17
5054,La Fare-en-Champsaur,478,0,31803,31803,66.5
12111,Goutrens,478,0,1028,1028,2.2
14286,Fourneville,478,0,3572,3572,7.5
19057,Collonges-la-Rouge,478,0,2410,2410,5
19152,Nonards,478,0,2410,2410,5
27396,Ménesqueville,478,0,3145,3145,6.6
30181,Montmirat,478,0,35558,35558,74.4
39232,Fort-du-Plasne,478,1869,3404,5273,11
41200,Sainte-Anne,478,0,5912,5912,12.4
41250,Sougé,478,0,5912,5912,12.4
59204,Escarmain,478,0,120,120,0.3
72012,Assé-le-Riboul,478,0,22500,22500,47.1
80695,Sailly-Saillisel,478,0,3425,3425,7.2
86047,Cernay,478,0,10879,10879,22.8
1112,Condamine,477,0,18044,18044,37.8
7020,Aubignas,477,0,10213,10213,21.4
21334,Lacanche,477,0,14713,14713,30.8
23100,Jarnages,477,0,7170,7170,15
25097,Brognard,477,1300,30196,31496,66
26276,Roche-Saint-Secret-Béconne,477,0,16629,16629,34.9
30065,Canaules-et-Argentières,477,2450,991,3441,7.2
43164,Roche-en-Régnier,477,1892,19848,21740,45.6
48155,Saint-Germain-de-Calberte,477,0,25979,25979,54.5
53071,Colombiers-du-Plessis,477,0,6289,6289,13.2
54125,Chenevières,477,0,2107,2107,4.4
64156,Buziet,477,1580,10272,11852,24.8
68350,Vœgtlinshoffen,477,0,46835,46835,98.2
69161,Propières,477,0,0,0,0
73173,Montricher-Albanne,477,122955,12809,135764,284.6
76477,Notre-Dame-du-Bec,477,2800,4302,7102,14.9
80500,Maisnières,477,0,9,9,0
87121,Rancon,477,0,14477,14477,30.4
3309,Le Veurdre,476,0,6407,6407,13.5
9056,Bézac,476,0,2143,2143,4.5
11011,Aragon,476,0,3087,3087,6.5
16200,Maine-de-Boixe,476,0,5984,5984,12.6
18137,Mareuil-sur-Arnon,476,300,1327,1627,3.4
18245,Saulzais-le-Potier,476,1700,1276,2976,6.3
27620,Selles,476,0,10752,10752,22.6
29131,Locmélar,476,0,3515,3515,7.4
31317,Marignac-Lasclares,476,0,16669,16669,35
45312,Solterre,476,0,6413,6413,13.5
47003,Agnac,476,0,8864,8864,18.6
59583,Taisnières-en-Thiérache,476,0,3771,3771,7.9
60123,Campremy,476,0,10734,10734,22.6
63288,Prompsat,476,0,3140,3140,6.6
70059,Beaumotte-Aubertans,476,0,1523,1523,3.2
70539,Vellexon-Queutrey-et-Vaudey,476,0,2443,2443,5.1
72028,Beaumont-Pied-de-Bœuf,476,0,26842,26842,56.4
76132,Bourdainville,476,4060,1049,5109,10.7
83038,Châteaudouble,476,0,5929,5929,12.5
7300,Saint-Thomé,475,0,10170,10170,21.4
12079,Coubisou,475,0,2352,2352,5
33532,Tizac-de-Lapouyade,475,0,9265,9265,19.5
37013,Avrillé-les-Ponceaux,475,0,4406,4406,9.3
45339,Villemoutiers,475,0,4870,4870,10.3
50447,Saint-Aubin-des-Préaux,475,0,11496,11496,24.2
53251,Saint-Quentin-les-Anges,475,0,3144,3144,6.6
57376,Lambach,475,0,10947,10947,23
60145,Chelles,475,0,3217,3217,6.8
60452,Neuville-Bosc,475,0,1528,1528,3.2
62115,Berneville,475,0,3947,3947,8.3
62308,Escœuilles,475,0,1028,1028,2.2
70152,Choye,475,0,2148,2148,4.5
71220,Gilly-sur-Loire,475,0,2442,2442,5.1
71241,Jambles,475,0,13060,13060,27.5
76500,Pierrecourt,475,2520,9,2529,5.3
76605,Sainte-Marguerite-sur-Mer,475,0,5773,5773,12.2
80571,Morisel,475,0,2918,2918,6.1
89088,Chassy,475,2206,11234,13440,28.3
14682,Surville,474,0,7618,7618,16.1
15004,Andelat,474,0,10484,10484,22.1
23164,Rougnat,474,0,6223,6223,13.1
28379,Soulaires,474,0,2751,2751,5.8
36062,Cuzion,474,0,3480,3480,7.3
41107,Lancé,474,0,5863,5863,12.4
47235,Saint-Colomb-de-Lauzun,474,0,8827,8827,18.6
47325,Villeton,474,0,4904,4904,10.3
51513,Saint-Remy-en-Bouzemont-Saint-Genest-et-Isson,474,0,2945,2945,6.2
51545,Sommesous,474,0,24092,24092,50.8
54426,Pierre-la-Treiche,474,0,989,989,2.1
63031,Beaulieu,474,0,3081,3081,6.5
63094,Charensat,474,0,736,736,1.6
63318,Saint-Angel,474,0,3127,3127,6.6
67075,Climbach,474,0,52227,52227,110.2
70491,Seveux-Motey,474,0,2433,2433,5.1
72294,Saint-Léonard-des-Bois,474,0,22311,22311,47.1
76188,Cottévrard,474,0,324,324,0.7
77361,Pierre-Levée,474,0,1846,1846,3.9
86049,Chalais,474,0,2421,2421,5.1
86187,Paizay-le-Sec,474,0,19171,19171,40.4
2094,Blesmes,473,0,10933,10933,23.1
5124,La Rochette,473,0,4219,4219,8.9
7095,Gilhoc-sur-Ormèze,473,0,13542,13542,28.6
12283,Trémouilles,473,0,8526,8526,18
17063,Breuil-la-Réorte,473,0,19571,19571,41.4
18186,Preuilly,473,0,6418,6418,13.6
18237,Sainte-Thorette,473,2400,6418,8818,18.6
27388,Marais-Vernier,473,0,10684,10684,22.6
30144,Lecques,473,0,35186,35186,74.4
30196,Le Pin,473,0,6902,6902,14.6
36066,Douadic,473,0,2600,2600,5.5
43188,Saint-Georges-d'Aurac,473,2460,4307,6767,14.3
49100,Cizay-la-Madeleine,473,759,4608,5367,11.3
57694,Vany,473,0,23452,23452,49.6
58213,Pougny,473,0,9430,9430,19.9
59542,Saint-Remy-Chaussée,473,0,16872,16872,35.7
62144,Boiry-Becquerelle,473,0,13304,13304,28.1
62336,Fléchin,473,0,42097,42097,89
62631,Nuncq-Hautecôte,473,0,10218,10218,21.6
64247,Gotein-Libarrenx,473,0,12291,12291,26
71038,Les Bizots,473,0,7600,7600,16.1
80809,Vismes,473,0,9,9,0
86107,Gouex,473,4658,19131,23789,50.3
88173,Florémont,473,0,11895,11895,25.1
9061,Les Bordes-sur-Arize,472,0,8395,8395,17.8
25262,Fuans,472,0,5576,5576,11.8
25609,Verrières-de-Joux,472,0,13491,13491,28.6
26100,Combovin,472,0,9568,9568,20.3
27002,Acon,472,0,5551,5551,11.8
27353,Irreville,472,0,5551,5551,11.8
34007,Aigues-Vives,472,0,1787,1787,3.8
37133,Loché-sur-Indrois,472,2525,8193,10718,22.7
39310,Mantry,472,1550,12545,14095,29.9
57252,Gomelange,472,0,2843,2843,6
57640,Schwerdorff,472,0,6794,6794,14.4
58096,Devay,472,0,1218,1218,2.6
60081,Bonlier,472,0,18509,18509,39.2
60554,Rouvres-en-Multien,472,0,1848,1848,3.9
63205,Manglieu,472,0,8461,8461,17.9
66095,Latour-de-Carol,472,0,0,0,0
67076,Colroy-la-Roche,472,4874,34157,39031,82.7
69212,Saint-Jean-des-Vignes,472,0,4254,4254,9
91544,Saint-Cyr-la-Rivière,472,0,1189,1189,2.5
5107,Puy-Saint-André,471,0,33600,33600,71.3
7036,Bogy,471,1369,2427,3796,8.1
10096,Chennegy,471,0,8217,8217,17.4
17365,Saint-Martin-d'Ary,471,0,5561,5561,11.8
25126,Charnay,471,0,3432,3432,7.3
29243,Saint-Coulitz,471,0,7423,7423,15.8
2A198,Ota,471,0,2170,2170,4.6
33500,Samonac,471,0,4821,4821,10.2
39537,Trenal,471,3260,14843,18103,38.4
40101,Gaas,471,0,3505,3505,7.4
59270,Grand-Fayt,471,0,3731,3731,7.9
63037,Bertignat,471,3850,4256,8106,17.2
67003,Albé,471,0,74708,74708,158.6
67413,Rosteig,471,1875,12692,14567,30.9
71077,Chambilly,471,0,10553,10553,22.4
76071,Bellengreville,471,2520,2979,5499,11.7
77150,Cuisy,471,0,358,358,0.8
77387,Remauville,471,0,1638,1638,3.5
81253,Saint-Grégoire,471,0,14553,14553,30.9
87062,Eybouleuf,471,0,1938,1938,4.1
88175,Fontenay,471,0,618,618,1.3
89432,Vaudeurs,471,3242,913,4155,8.8
91560,Saint-Jean-de-Beauregard,471,0,2173,2173,4.6
95055,Bellefontaine,471,0,2723,2723,5.8
2326,Fontenoy,470,0,452,452,1
3205,Périgny,470,0,945,945,2
8119,Cheveuges,470,0,10796,10796,23
10240,Messon,470,0,6712,6712,14.3
12104,Foissac,470,0,1371,1371,2.9
14172,Commes,470,0,18115,18115,38.5
15147,Parlan,470,0,4121,4121,8.8
17034,Barzan,470,2500,7402,9902,21.1
17446,Thors,470,0,13092,13092,27.9
27606,Saint-Symphorien,470,0,10617,10617,22.6
28100,Cintray,470,0,13695,13695,29.1
33147,Daignac,470,0,9168,9168,19.5
43257,Vergezac,470,39373,19556,58929,125.4
47112,Grateloup-Saint-Gayrand,470,0,4863,4863,10.3
50321,Le Mesnil-Rouxelin,470,0,6951,6951,14.8
54272,Jaillon,470,0,980,980,2.1
55015,Aulnois-en-Perthois,470,0,9187,9187,19.5
55520,Troussey,470,0,1897,1897,4
57434,Maizières-lès-Vic,470,0,1555,1555,3.3
59213,Estourmel,470,0,3229,3229,6.9
59274,La Groise,470,0,3229,3229,6.9
60228,Fay-les-Étangs,470,2180,10321,12501,26.6
60681,Villers-Saint-Barthélemy,470,1150,3853,5003,10.6
62813,La Thieuloye,470,0,10153,10153,21.6
67123,Engwiller,470,0,5715,5715,12.2
76333,Guerville,470,0,9,9,0
76603,Saint-Maclou-la-Brière,470,0,5566,5566,11.8
81010,Ambialet,470,0,5912,5912,12.6
86025,Béthines,470,0,19009,19009,40.4
88231,Haréville,470,0,165,165,0.4
3183,Le Montet,469,0,7204,7204,15.4
8156,Éteignières,469,0,12261,12261,26.1
9258,Saint-Félix-de-Rieutord,469,0,12606,12606,26.9
10263,Neuville-sur-Vanne,469,0,8183,8183,17.4
12150,Monteils,469,0,1368,1368,2.9
18105,Gron,469,0,2161,2161,4.6
28322,Rueil-la-Gadelière,469,0,627,627,1.3
36239,Vigoux,469,0,2578,2578,5.5
59200,Eringhem,469,995,9033,10028,21.4
68087,Feldbach,469,0,12581,12581,26.8
80366,Fricourt,469,0,524,524,1.1
2109,La Bouteille,468,0,8346,8346,17.8
25469,Présentevillers,468,529,29626,30155,64.4
31097,Le Cabanial,468,0,2283,2283,4.9
35063,La Chapelle-Saint-Aubert,468,0,5730,5730,12.2
37061,Charnizay,468,8242,8124,16366,35
38203,Laffrey,468,441,4900,5341,11.4
38273,Nantes-en-Ratier,468,5460,4900,10360,22.1
50196,Gatteville-le-Phare,468,2790,14721,17511,37.4
50624,La Vendelée,468,0,13541,13541,28.9
56210,Saint-Caradec-Trégomel,468,0,14959,14959,32
59374,Marbaix,468,0,3707,3707,7.9
59448,Oost-Cappel,468,0,9014,9014,19.3
62651,Penin,468,0,3889,3889,8.3
64202,Domezain-Berraute,468,0,12161,12161,26
64302,Lagos,468,0,5005,5005,10.7
67273,Lohr,468,2356,12611,14967,32
67415,Rothbach,468,1553,17139,18692,39.9
71433,Saint-Julien-de-Civry,468,0,1815,1815,3.9
73186,Notre-Dame-de-Bellecombe,468,0,11040,11040,23.6
81177,Montfa,468,0,4372,4372,9.3
81228,Roquemaure,468,0,25713,25713,54.9
86296,Voulon,468,0,10539,10539,22.5
1319,Relevant,467,0,97,97,0.2
2527,Morsain,467,0,449,449,1
2788,Versigny,467,0,8391,8391,18
5115,Remollon,467,0,4166,4166,8.9
11150,Fontiers-Cabardès,467,0,6032,6032,12.9
14563,Saint-Benoît-d'Hébertot,467,0,7506,7506,16.1
25615,Villars-lès-Blamont,467,1420,29563,30983,66.3
28120,Crucey-Villages,467,0,625,625,1.3
28370,Saumeray,467,0,859,859,1.8
31109,Cassagnabère-Tournas,467,0,9673,9673,20.7
31215,Gauré,467,0,5238,5238,11.2
33537,Uzeste,467,0,4776,4776,10.2
37082,Continvoir,467,0,4332,4332,9.3
37269,Verneuil-sur-Indre,467,3880,8106,11986,25.7
38443,Saint-Pierre-de-Chérennes,467,0,7547,7547,16.2
46101,Felzins,467,0,13791,13791,29.5
57649,Servigny-lès-Sainte-Barbe,467,0,1137,1137,2.4
58189,Narcy,467,0,26357,26357,56.4
60308,Hémévillers,467,150,437,587,1.3
61224,Larré,467,0,13801,13801,29.6
63240,Montpensier,467,0,1909,1909,4.1
67416,Rott,467,0,51455,51455,110.2
68358,Wasserbourg,467,0,18746,18746,40.1
73180,Motz,467,8605,2584,11189,24
77472,La Trétoire,467,0,7690,7690,16.5
86159,Millac,467,6588,18888,25476,54.6
95166,Cléry-en-Vexin,467,0,21457,21457,45.9
2201,Cœuvres-et-Valsery,466,0,448,448,1
2653,Romeny-sur-Marne,466,0,254,254,0.5
11308,Raissac-sur-Lampy,466,0,3023,3023,6.5
18226,Saint-Michel-de-Volangis,466,2070,8926,10996,23.6
27026,Authevernes,466,0,380,380,0.8
27454,Perruel,466,0,3066,3066,6.6
31024,Auragne,466,0,2451,2451,5.3
31372,Montespan,466,0,25045,25045,53.7
38228,Merlas,466,0,7917,7917,17
41273,Vievy-le-Rayé,466,0,1403,1403,3
53111,La Haie-Traversaine,466,0,17317,17317,37.2
60093,Boulogne-la-Grasse,466,0,4074,4074,8.7
60637,Thury-en-Valois,466,0,1825,1825,3.9
62029,Amettes,466,0,7690,7690,16.5
64018,Amendeuix-Oneix,466,0,12109,12109,26
67521,Weinbourg,466,642,12557,13199,28.3
73145,Lépin-le-Lac,466,0,23873,23873,51.2
74196,Nancy-sur-Cluses,466,0,4240,4240,9.1
76264,Flamanville,466,0,1027,1027,2.2
80050,Bacouel-sur-Selle,466,0,643,643,1.4
3117,Franchesse,465,0,7143,7143,15.4
5068,Jarjayes,465,0,659,659,1.4
22115,Lanrivain,465,0,42821,42821,92.1
27216,Émalleville,465,0,5469,5469,11.8
33285,Mombrier,465,0,2626,2626,5.6
35007,Aubigné,465,0,9989,9989,21.5
36184,Saint-Chartier,465,0,10214,10214,22
38452,Saint-Romain-de-Surieu,465,0,11887,11887,25.6
42018,Bessey,465,0,14269,14269,30.7
54156,Diarville,465,0,0,0,0
55296,L'Isle-en-Rigault,465,0,9089,9089,19.5
62120,Beugin,465,0,7674,7674,16.5
62317,Étaing,465,0,579,579,1.2
63411,Sauvagnat-Sainte-Marthe,465,0,3023,3023,6.5
64006,Accous,465,0,10014,10014,21.5
74049,Brizon,465,0,14081,14081,30.3
90046,Florimont,465,0,2766,2766,5.9
91547,Saint-Escobille,465,0,1171,1171,2.5
2833,Wimy,464,0,9108,9108,19.6
7211,Saint-André-de-Cruzières,464,0,11354,11354,24.5
10170,Gyé-sur-Seine,464,0,8100,8100,17.5
21131,Chamblanc,464,0,3479,3479,7.5
21561,Saint-Martin-du-Mont,464,0,0,0,0
24582,Villars,464,2130,6537,8667,18.7
31234,Le Grès,464,0,3881,3881,8.4
32237,Marsan,464,0,5894,5894,12.7
40255,Saint-Cricq-Villeneuve,464,0,4433,4433,9.6
46313,Tauriac,464,0,15138,15138,32.6
53063,Châtelain,464,0,20831,20831,44.9
53190,Le Ribay,464,0,17243,17243,37.2
59140,Caullery,464,0,3188,3188,6.9
67403,Ringendorf,464,100,12504,12604,27.2
68336,Traubach-le-Bas,464,0,6607,6607,14.2
71079,Champagnat,464,0,1910,1910,4.1
76063,Beauval-en-Caux,464,0,3744,3744,8.1
77091,Les Chapelles-Bourbon,464,0,2358,2358,5.1
77500,Villebéon,464,0,489,489,1.1
80795,Ville-le-Marclet,464,0,798,798,1.7
89446,Vézelay,464,10000,1006,11006,23.7
16039,Bernac,463,1600,10135,11735,25.3
18144,Menetou-Râtel,463,0,8341,8341,18
22149,Merléac,463,0,0,0,0
24371,Saint-Aquilin,463,0,2524,2524,5.5
25308,Les Hôpitaux-Vieux,463,0,27574,27574,59.6
28190,Guillonville,463,0,2432,2432,5.3
28343,Saint-Laurent-la-Gâtine,463,0,2687,2687,5.8
36131,Mosnay,463,0,3399,3399,7.3
50266,Lengronne,463,0,13396,13396,28.9
57619,Saint-Louis-lès-Bitche,463,0,10671,10671,23
58251,Saint-Loup-des-Bois,463,0,9231,9231,19.9
62257,Créquy,463,0,27398,27398,59.2
63347,Saint-Genès-du-Retz,463,0,1892,1892,4.1
65056,Ayzac-Ost,463,0,18959,18959,40.9
66033,Camélas,463,0,6206,6206,13.4
68281,Roggenhouse,463,2000,8036,10036,21.7
74259,Le Sappey,463,9250,8324,17574,38
76654,Saint-Vaast-du-Val,463,952,3736,4688,10.1
77274,Marcilly,463,0,6798,6798,14.7
86189,Payroux,463,0,10427,10427,22.5
87087,Lussac-les-Églises,463,5115,7880,12995,28.1
88108,Le Clerjus,463,0,11643,11643,25.1
89471,Villiers-Louis,463,3454,3077,6531,14.1
1139,Curciat-Dongalon,462,0,8932,8932,19.3
10179,Jeugny,462,0,6597,6597,14.3
12065,Centrès,462,0,14140,14140,30.6
16387,Triac-Lautrait,462,1058,17286,18344,39.7
21508,Prenois,462,0,0,0,0
27618,Sébécourt,462,0,4110,4110,8.9
34064,Le Caylar,462,0,5189,5189,11.2
34308,Taussac-la-Billière,462,0,4301,4301,9.3
37075,Cigogné,462,0,10396,10396,22.5
37162,Mouzay,462,0,8020,8020,17.4
37199,Rilly-sur-Vienne,462,0,12536,12536,27.1
38525,Vasselin,462,0,2385,2385,5.2
50238,Héauville,462,5750,14532,20282,43.9
50243,Heugueville-sur-Sienne,462,0,13368,13368,28.9
50506,Saint-Malo-de-la-Lande,462,0,13368,13368,28.9
50542,Saint-Pois,462,0,7806,7806,16.9
51656,Vraux,462,0,23482,23482,50.8
57069,Berviller-en-Moselle,462,0,2783,2783,6
62415,Haute-Avesnes,462,0,3839,3839,8.3
65425,Siarrouy,462,0,10436,10436,22.6
67071,Bust,462,1205,5792,6997,15.1
73202,Plancherine,462,0,10898,10898,23.6
76060,Beaubec-la-Rosière,462,0,8728,8728,18.9
80385,Grand-Laviers,462,0,1409,1409,3
81067,Cestayrols,462,0,25384,25384,54.9
89173,Fontaines,462,2946,20861,23807,51.5
11303,Puivert,461,0,5065,5065,11
14336,Hottot-les-Bagues,461,0,5652,5652,12.3
14646,Saint-Pierre-Canivet,461,0,7222,7222,15.7
15228,Siran,461,12500,4042,16542,35.9
21641,Touillon,461,0,8980,8980,19.5
24080,Capdrot,461,5170,1675,6845,14.8
24501,Saint-Seurin-de-Prats,461,3490,1606,5096,11.1
27331,Heubécourt-Haricourt,461,0,2422,2422,5.3
28401,Vaupillon,461,0,328,328,0.7
39489,Saint-Lothain,461,800,10196,10996,23.9
52327,Moëslains,461,0,4175,4175,9.1
53091,Désertines,461,0,6078,6078,13.2
54154,Deneuvre,461,0,2037,2037,4.4
67048,Bitschhoffen,461,0,5605,5605,12.2
71509,La Celle-en-Morvan,461,0,10314,10314,22.4
76492,Ouville-la-Rivière,461,0,3720,3720,8.1
80481,Lihons,461,0,8343,8343,18.1
84077,Modène,461,0,15053,15053,32.7
4113,Marcoux,460,1850,19281,21131,45.9
10210,Luyères,460,0,1711,1711,3.7
16104,Condac,460,1502,10069,11571,25.2
19043,La Chapelle-aux-Brocs,460,0,7342,7342,16
21542,Saint-Bernard,460,0,2206,2206,4.8
22316,Saint-Mayeux,460,0,0,0,0
24566,Varennes,460,2253,1671,3924,8.5
27202,Daubeuf-près-Vatteville,460,0,2417,2417,5.3
27379,Mainneville,460,0,375,375,0.8
27446,Ormes,460,0,4092,4092,8.9
27646,Le Torpt,460,0,7084,7084,15.4
28301,Poisvilliers,460,0,13404,13404,29.1
31076,Bordes-de-Rivière,460,0,9528,9528,20.7
39096,Champagney,460,2480,9336,11816,25.7
42140,Marols,460,0,4121,4121,9
45121,Dammarie-sur-Loing,460,0,4717,4717,10.3
57389,Lelling,460,0,7854,7854,17.1
61130,Courgeoût,460,3200,1615,4815,10.5
68033,Bettendorf,460,1250,12340,13590,29.5
68073,Dolleren,460,0,9652,9652,21
71143,Condal,460,0,1894,1894,4.1
72087,Conflans-sur-Anille,460,0,6219,6219,13.5
72105,Courgenard,460,0,2806,2806,6.1
80806,Villers-sur-Authie,460,0,11391,11391,24.8
86037,Brigueil-le-Chantre,460,38694,18605,57299,124.6
88273,Longchamp,460,0,11568,11568,25.1
89180,Fouchères,460,4750,1632,6382,13.9
1016,Arbigny,459,0,6304,6304,13.7
2139,Caillouël-Crépigny,459,0,8247,8247,18
2569,Oisy,459,0,2530,2530,5.5
5085,Montgenèvre,459,36150,32744,68894,150.1
11284,Peyrens,459,4860,4033,8893,19.4
14353,Landes-sur-Ajon,459,0,17021,17021,37.1
17366,Saint-Martin-de-Coux,459,0,5420,5420,11.8
21469,Orgeux,459,0,11,11,0
25079,Boujailles,459,0,6659,6659,14.5
27206,Droisy,459,0,5398,5398,11.8
30248,Saint-Dézéry,459,0,3527,3527,7.7
31071,Bois-de-la-Pierre,459,0,789,789,1.7
36094,Lignac,459,0,9257,9257,20.2
38163,Le Haut-Bréda,459,0,8529,8529,18.6
47249,Saint-Laurent,459,0,4410,4410,9.6
49370,Verrie,459,4174,4472,8646,18.8
52306,Manois,459,0,7062,7062,15.4
61202,Hauterive,459,2293,162,2455,5.3
62125,Beuvrequen,459,0,1826,1826,4
62701,Rely,459,0,7575,7575,16.5
64231,Garindein,459,0,11927,11927,26
76298,Ganzeville,459,0,2978,2978,6.5
88401,Rouvres-la-Chétive,459,0,5128,5128,11.2
2126,Brunehamel,458,0,5046,5046,11
7087,Fabras,458,3370,1882,5252,11.5
9082,Castelnau-Durban,458,0,55500,55500,121.2
15244,Ussel,458,5210,10130,15340,33.5
19196,Saint-Cyr-la-Roche,458,2435,7310,9745,21.3
27295,Grand-Camp,458,0,1974,1974,4.3
27394,Martot,458,0,13582,13582,29.7
2A212,Piana,458,0,2110,2110,4.6
34263,Saint-Hilaire-de-Beauvoir,458,0,8534,8534,18.6
46046,Calamane,458,0,3867,3867,8.4
50568,Saussey,458,0,13252,13252,28.9
53120,Izé,458,0,3276,3276,7.2
55013,Arrancy-sur-Crusnes,458,0,8371,8371,18.3
57352,Jussy,458,0,22708,22708,49.6
62405,Hamblain-les-Prés,458,0,570,570,1.2
62564,Mazinghem,458,0,7558,7558,16.5
64058,Arthez-d'Asson,458,0,4898,4898,10.7
81217,Puycelsi,458,0,25164,25164,54.9
89137,Dannemoine,458,2500,1064,3564,7.8
11408,Verzeille,457,0,2964,2964,6.5
15036,Chalvignac,457,42660,8644,51304,112.3
18253,Soulangis,457,1475,3463,4938,10.8
27156,Chéronvilliers,457,0,12853,12853,28.1
29082,Île-de-Batz,457,14357,868,15225,33.3
35248,Sains,457,0,3886,3886,8.5
40175,Maurrin,457,0,2135,2135,4.7
42217,Saint-Didier-sur-Rochefort,457,0,4095,4095,9
51557,Soulanges,457,0,7209,7209,15.8
57062,Berg-sur-Moselle,457,0,11126,11126,24.3
58103,Dornecy,457,0,9562,9562,20.9
59059,Beaumont-en-Cambrésis,457,0,3140,3140,6.9
60146,Chepoix,457,0,10306,10306,22.6
60331,Labosse,457,1789,3746,5535,12.1
65236,Julos,457,0,4366,4366,9.6
68335,Thannenkirch,457,0,1093,1093,2.4
70309,Loulans-Verchamp,457,0,1463,1463,3.2
73057,Brides-les-Bains,457,39605,2736,42341,92.6
74027,La Balme-de-Thuy,457,13844,23214,37058,81.1
76535,Roncherolles-en-Bray,457,0,8633,8633,18.9
77062,Carnetin,457,0,1130,1130,2.5
80110,Boismont,457,0,1394,1394,3.1
80227,Croixrault,457,0,631,631,1.4
80814,Vrély,457,0,8271,8271,18.1
85139,Le Mazeau,457,0,7162,7162,15.7
22305,Saint-Jouan-de-l'Isle,456,0,12148,12148,26.6
24155,Douville,456,5650,21835,27485,60.3
25486,Remoray-Boujeons,456,0,27157,27157,59.6
26052,Bonlieu-sur-Roubion,456,3060,4394,7454,16.3
27203,Douains,456,0,2396,2396,5.3
27557,Saint-Léger-de-Rôtes,456,0,1966,1966,4.3
33331,Pondaurat,456,730,3713,4443,9.7
38166,La Flachère,456,968,8473,9441,20.7
51149,Chepy,456,0,761,761,1.7
53212,Saint-Denis-du-Maine,456,0,2740,2740,6
58094,Dampierre-sous-Bouhy,456,0,20590,20590,45.2
59513,Roucourt,456,0,6354,6354,13.9
64178,Castetnau-Camblong,456,0,9532,9532,20.9
64557,Vignes,456,0,7140,7140,15.7
67133,Eschbourg,456,655,12288,12943,28.4
68228,Munwiller,456,0,3599,3599,7.9
76344,Haudricourt,456,0,9,9,0
76508,La Poterie-Cap-d'Antifer,456,0,4113,4113,9
79071,La Chapelle-Bertrand,456,0,11955,11955,26.2
79084,Chenay,456,0,13169,13169,28.9
87139,Saint-Bonnet-de-Bellac,456,6020,7761,13781,30.2
88120,La Croix-aux-Mines,456,0,4433,4433,9.7
88267,Lerrain,456,0,3545,3545,7.8
2020,Any-Martin-Rieux,455,0,8932,8932,19.6
2781,Verdilly,455,0,10517,10517,23.1
12210,Saint-André-de-Najac,455,0,1327,1327,2.9
14062,Bény-sur-Mer,455,0,5578,5578,12.3
24319,Paussac-et-Saint-Vivien,455,3640,3455,7095,15.6
25425,Noël-Cerneux,455,0,7641,7641,16.8
26251,Portes-en-Valdaine,455,800,4384,5184,11.4
31391,Montsaunès,455,0,24454,24454,53.7
33034,Bayas,455,0,8875,8875,19.5
41020,Bonneveau,455,0,5628,5628,12.4
41189,Rilly-sur-Loire,455,0,17438,17438,38.3
42315,Unias,455,0,4077,4077,9
43246,Tiranges,455,5197,41089,46286,101.7
51112,Chamery,455,0,8086,8086,17.8
53061,Charchigné,455,0,16908,16908,37.2
56230,Saint-Nicolas-du-Tertre,455,0,5535,5535,12.2
57530,Ottonville,455,0,2740,2740,6
61028,Bazoches-au-Houlme,455,0,2597,2597,5.7
66072,Estavar,455,0,0,0,0
82140,Piquecos,455,0,2320,2320,5.1
84046,Flassan,455,0,14857,14857,32.7
87104,Nedde,455,0,6480,6480,14.2
89060,Bussy-le-Repos,455,320,1614,1934,4.3
2608,Plomion,454,0,8096,8096,17.8
17125,Courcelles,454,0,12646,12646,27.9
24189,Fougueyrolles,454,3828,1582,5410,11.9
24338,Pressignac-Vicq,454,1515,1650,3165,7
27336,La Heunière,454,0,2385,2385,5.3
31304,Loubens-Lauragais,454,0,2214,2214,4.9
33197,Guillos,454,0,13921,13921,30.7
38266,La Motte-Saint-Martin,454,2082,4754,6836,15.1
39290,Valzin en Petite Montagne,454,3190,13213,16403,36.1
40090,Donzacq,454,0,1233,1233,2.7
40218,Parleboscq,454,0,5185,5185,11.4
51194,Courville,454,0,8068,8068,17.8
60576,Saint-Germain-la-Poterie,454,0,17803,17803,39.2
62660,Plouvain,454,2910,565,3475,7.7
70236,Fleurey-lès-Faverney,454,0,2696,2696,5.9
70318,Magny-Danigon,454,0,19957,19957,44
70331,Mantoche,454,0,2291,2291,5
71244,Jouvençon,454,0,2646,2646,5.8
73293,Thoiry,454,0,5771,5771,12.7
76699,Le Torp-Mesnil,454,959,1001,1960,4.3
78147,Chaufour-lès-Bonnières,454,0,2321,2321,5.1
80303,Favières,454,0,11242,11242,24.8
84045,Faucon,454,0,531,531,1.2
1146,Dompierre-sur-Chalaronne,453,0,94,94,0.2
8214,Hargnies,453,0,2908,2908,6.4
14648,Saint-Pierre-des-Ifs,453,0,5042,5042,11.1
16066,Brossac,453,4020,24223,28243,62.3
16067,Bunzac,453,1370,8078,9448,20.9
18019,Azy,453,0,3433,3433,7.6
21269,Flammerans,453,0,0,0,0
23180,Saint-Amand,453,0,17132,17132,37.8
34286,Saint-Privat,453,0,5088,5088,11.2
43170,Saint-Beauzire,453,1980,22200,24180,53.4
45111,Courcy-aux-Loges,453,0,563,563,1.2
45314,Sully-la-Chapelle,453,0,881,881,1.9
50199,Genêts,453,0,11146,11146,24.6
51088,Brimont,453,0,8051,8051,17.8
53012,Athée,453,0,2999,2999,6.6
62538,Maintenay,453,0,7172,7172,15.8
63385,Saint-Pierre-le-Chastel,453,0,15318,15318,33.8
67537,Wingen,453,0,10961,10961,24.2
76120,Bosc-Bordel,453,0,310,310,0.7
77507,Villenauxe-la-Petite,453,1305,6415,7720,17
84058,Lacoste,453,0,9234,9234,20.4
84075,Méthamis,453,9200,7349,16549,36.5
86127,Leigné-sur-Usseau,453,0,10310,10310,22.8
86241,Saint-Rémy-sur-Creuse,453,0,10310,10310,22.8
12049,Campuac,452,0,2238,2238,5
17188,Haimps,452,0,12590,12590,27.9
23033,La Brionne,452,0,7382,7382,16.3
25191,Dampierre-sur-le-Doubs,452,0,28613,28613,63.3
26032,La Baume-Cornillane,452,22572,9162,31734,70.2
31219,Gensac-sur-Garonne,452,0,777,777,1.7
42226,Saint-Georges-de-Baroille,452,590,3731,4321,9.6
50232,Hauteville-la-Guichard,452,1345,13078,14423,31.9
51450,Puisieulx,452,0,8033,8033,17.8
54597,Xirocourt,452,0,0,0,0
59518,Ruesnes,452,0,1276,1276,2.8
60620,Silly-Tillard,452,0,1877,1877,4.2
63044,Bongheat,452,2855,4335,7190,15.9
69124,Marchampt,452,0,0,0,0
79105,Les Châteliers,452,0,11851,11851,26.2
4203,Selonnet,451,0,18904,18904,41.9
12091,Drulhe,451,0,7747,7747,17.2
14364,Lingèvres,451,0,5529,5529,12.3
18248,Senneçay,451,2760,4201,6961,15.4
19242,Saint-Solve,451,0,7198,7198,16
21013,Ancey,451,0,2536,2536,5.6
36050,Chezelles,451,0,715,715,1.6
36143,Nohant-Vic,451,0,9907,9907,22
51272,Givry-en-Argonne,451,0,6697,6697,14.8
54096,Bréhain-la-Ville,451,0,1987,1987,4.4
55476,Savonnières-devant-Bar,451,0,5437,5437,12.1
57305,Havange,451,0,4740,4740,10.5
60231,Feigneux,451,0,1766,1766,3.9
60558,Roye-sur-Matz,451,0,3943,3943,8.7
76033,Auberville-la-Renault,451,0,5341,5341,11.8
81295,Teillet,451,0,5673,5673,12.6
89150,Égleny,451,1300,20364,21664,48
89380,Savigny-sur-Clairis,451,0,1600,1600,3.5
2481,Mesnil-Saint-Laurent,450,0,64315,64315,142.9
12050,Canet-de-Salars,450,0,3191,3191,7.1
14111,Bucéels,450,0,5517,5517,12.3
14555,Saint-André-d'Hébertot,450,0,7232,7232,16.1
26368,Vercheny,450,5430,12232,17662,39.2
27650,Tournedos-Bois-Hubert,450,0,1935,1935,4.3
33060,Bommes,450,0,4602,4602,10.2
33421,Saint-Jean-de-Blaignac,450,0,3140,3140,7
38235,Miribel-Lanchâtre,450,0,17384,17384,38.6
39448,Rahon,450,0,2665,2665,5.9
43030,Blanzac,450,1900,18724,20624,45.8
49009,Antoigné,450,2357,4384,6741,15
57714,Haute-Vigneulles,450,0,20882,20882,46.4
59001,Abancourt,450,0,5849,5849,13
59102,Boussières-en-Cambrésis,450,0,3092,3092,6.9
63110,Cisternes-la-Forêt,450,0,15217,15217,33.8
67235,Kesseldorf,450,0,51603,51603,114.7
67312,Mutzenhouse,450,400,15123,15523,34.5
71580,Vincelles,450,0,1852,1852,4.1
72281,Saint-Georges-du-Rosay,450,0,8345,8345,18.5
77144,Crèvecœur-en-Brie,450,0,2287,2287,5.1
77247,Lescherolles,450,0,7410,7410,16.5
5142,Saint-Firmin,449,0,29873,29873,66.5
15216,Saint-Urcize,449,6710,9931,16641,37.1
15243,Trizac,449,11070,6924,17994,40.1
24019,Azerat,449,3230,7853,11083,24.7
24086,Castelnaud-la-Chapelle,449,21400,769,22169,49.4
25008,Aibre,449,0,2932,2932,6.5
27040,Barquet,449,0,1936,1936,4.3
28304,Prasville,449,0,2358,2358,5.3
30111,Foissac,449,0,3450,3450,7.7
33055,Blaignan-Prignac,449,0,3948,3948,8.8
39028,Aumont,449,0,9931,9931,22.1
43071,Chomelix,449,3510,18683,22193,49.4
47171,Monbalen,449,0,3441,3441,7.7
57734,Voyer,449,0,2923,2923,6.5
72229,Parennes,449,0,8759,8759,19.5
74078,Clermont,449,0,10845,10845,24.2
76021,Annouville-Vilmesnil,449,0,5317,5317,11.8
78245,Fontenay-Mauvoisin,449,0,4179,4179,9.3
80458,Lahoussoye,449,0,59,59,0.1
85023,Bessay,449,0,9489,9489,21.1
23077,Faux-la-Montagne,448,0,16943,16943,37.8
27285,Giverny,448,0,2354,2354,5.3
30071,Cassagnoles,448,0,931,931,2.1
36126,Montchevrier,448,0,1302,1302,2.9
39404,Pannessières,448,1300,14118,15418,34.4
42039,Chalmazel-Jeansagnière,448,0,4014,4014,9
42335,Viricelles,448,600,22455,23055,51.5
43026,Bellevue-la-Montagne,448,4450,18641,23091,51.5
43028,Bessamorel,448,0,10501,10501,23.4
46193,Miers,448,0,14616,14616,32.6
47309,Tombebœuf,448,0,3615,3615,8.1
48050,Bédouès-Cocurès,448,2950,10988,13938,31.1
59341,Lesdain,448,0,5823,5823,13
70216,Esboz-Brest,448,0,431,431,1
70283,Haut-du-Them-Château-Lambert,448,0,5153,5153,11.5
76209,Dampierre-en-Bray,448,0,8463,8463,18.9
76665,Sauchay,448,1200,2834,4034,9
78559,Saint-Illiers-le-Bois,448,0,2290,2290,5.1
78561,Saint-Lambert,448,19405,565,19970,44.6
79047,Boussais,448,0,11457,11457,25.6
81149,Loupiac,448,0,24614,24614,54.9
8494,Wadelincourt,447,0,10268,10268,23
10031,Barbuise,447,0,2762,2762,6.2
14173,Condé-sur-Ifs,447,0,3598,3598,8
17042,Bercloux,447,0,12451,12451,27.9
18089,Épineuil-le-Fleuriel,447,0,1198,1198,2.7
22319,Saint-Michel-en-Grève,447,0,8880,8880,19.9
22359,Trégrom,447,0,8880,8880,19.9
24040,Beynac-et-Cazenac,447,8700,2816,11516,25.8
26257,Puygiron,447,1500,4307,5807,13
29018,Brennilis,447,660,23239,23899,53.5
30329,Thoiras,447,0,13972,13972,31.3
35089,La Couyère,447,4032,6505,10537,23.6
36211,Sassierges-Saint-Germain,447,0,16567,16567,37.1
38257,Montrevel,447,0,3920,3920,8.8
45022,Batilly-en-Gâtinais,447,0,3388,3388,7.6
48194,Vialas,447,29780,24346,54126,121.1
50389,Ouville,447,0,12934,12934,28.9
64444,Pardies-Piétat,447,0,4780,4780,10.7
69138,Montromant,447,2535,22404,24939,55.8
72330,Savigné-sous-le-Lude,447,0,2241,2241,5
73223,Saint-André,447,11146,7898,19044,42.6
76110,Bois-Himont,447,0,827,827,1.9
76210,Dampierre-Saint-Nicolas,447,2100,2827,4927,11
76325,Grémonville,447,3284,985,4269,9.6
80342,Framerville-Rainecourt,447,0,8090,8090,18.1
81200,Palleville,447,0,9088,9088,20.3
85287,Tallud-Sainte-Gemme,447,0,12149,12149,27.2
17239,Mons,446,0,12423,12423,27.9
19130,Maussac,446,0,6114,6114,13.7
27210,Écardenville-la-Campagne,446,0,1923,1923,4.3
32094,Caupenne-d'Armagnac,446,0,297,297,0.7
33319,Pessac-sur-Dordogne,446,0,3112,3112,7
51529,Selles,446,0,7926,7926,17.8
55279,Laneuville-sur-Meuse,446,0,16127,16127,36.2
60232,Ferrières,446,0,2471,2471,5.5
64314,Larceveau-Arros-Cibits,446,0,11590,11590,26
70227,Faucogney-et-la-Mer,446,0,5130,5130,11.5
72193,Melleray,446,0,2721,2721,6.1
76075,Belmesnil,446,0,3599,3599,8.1
76230,Elbeuf-sur-Andelle,446,0,305,305,0.7
76261,La Ferté-Saint-Samson,446,0,8425,8425,18.9
81258,Saint-Julien-du-Puy,446,0,6671,6671,15
89199,Gy-l'Évêque,446,0,8725,8725,19.6
89341,Saint-Cyr-les-Colons,446,140,61,201,0.5
90051,Froidefontaine,446,0,2653,2653,5.9
2423,Leuilly-sous-Coucy,445,0,441,441,1
15055,Coren,445,4160,9843,14003,31.5
17148,Écurat,445,4838,14103,18941,42.6
18286,Villequiers,445,0,2051,2051,4.6
22205,Plorec-sur-Arguenon,445,0,11855,11855,26.6
24246,Lunas,445,1100,9907,11007,24.7
28123,Dampierre-sous-Brou,445,0,24316,24316,54.6
28409,Vieuvicq,445,0,1646,1646,3.7
30024,Aulas,445,0,7178,7178,16.1
39099,Champdivers,445,1440,9032,10472,23.5
39535,Tourmont,445,1638,9843,11481,25.8
45277,Saint-Florent,445,0,2606,2606,5.9
46053,Camburat,445,0,13141,13141,29.5
62781,Sauchy-Lestrée,445,0,554,554,1.2
65363,Pinas,445,0,1329,1329,3
70180,Courchaton,445,0,141,141,0.3
70498,Ternuay-Melay-et-Saint-Hilaire,445,0,5119,5119,11.5
73122,Gerbaix,445,0,22797,22797,51.2
76480,Ocqueville,445,0,2882,2882,6.5
77298,Mons-en-Montois,445,2300,6302,8602,19.3
78548,Saint-Forget,445,0,561,561,1.3
79102,Coulonges-Thouarsais,445,0,6924,6924,15.6
80609,Oneux,445,0,11019,11019,24.8
88412,Saint-Benoît-la-Chipotte,445,0,2220,2220,5
88418,Sainte-Hélène,445,0,2220,2220,5
89007,Andryes,445,6058,20093,26151,58.8
7307,Sanilhac,444,1170,6995,8165,18.4
11336,Sainte-Colombe-sur-l'Hers,444,10501,4878,15379,34.6
14231,Beaufour-Druval,444,0,5640,5640,12.7
21492,Pommard,444,0,1931,1931,4.3
23052,La Chapelle-Taillefert,444,0,7251,7251,16.3
26001,Solaure en Diois,444,850,24686,25536,57.5
26193,Montbrun-les-Bains,444,0,22815,22815,51.4
27012,Amfreville-les-Champs,444,4650,2921,7571,17.1
27224,Épreville-près-le-Neubourg,444,0,1909,1909,4.3
29142,Lothey,444,0,6998,6998,15.8
30232,Saint-André-d'Olérargues,444,0,6479,6479,14.6
32120,Encausse,444,0,1675,1675,3.8
39453,Ravilloles,444,24464,1635,26099,58.8
40254,Saint-Cricq-du-Gave,444,0,3304,3304,7.4
51334,Luxémont-et-Villotte,444,0,2758,2758,6.2
60664,Vendeuil-Caply,444,0,10013,10013,22.6
62586,Montenescourt,444,0,3689,3689,8.3
62759,Saint-Martin-Choquel,444,0,1282,1282,2.9
64365,Malaussanne,444,0,6952,6952,15.7
64488,Saint-Laurent-Bretagne,444,0,4635,4635,10.4
89034,Beine,444,0,61,61,0.1
2220,Coulonges-Cohan,443,0,10240,10240,23.1
2673,Saint-Christophe-à-Berry,443,0,426,426,1
7282,Saint-Pierre-de-Colombier,443,3923,1820,5743,13
24361,Saint-Agne,443,3270,1610,4880,11
24549,Thénac,443,5100,9862,14962,33.8
27135,Cesseville,443,0,1905,1905,4.3
27261,Fouqueville,443,0,1905,1905,4.3
31473,Saint-Cézert,443,0,3706,3706,8.4
33025,Baigneaux,443,0,4399,4399,9.9
34060,Causse-de-la-Selle,443,11034,8254,19288,43.5
50112,La Chaise-Baudouin,443,0,10900,10900,24.6
55461,Saint-Laurent-sur-Othain,443,0,8096,8096,18.3
57188,Éguelshardt,443,0,10210,10210,23
57329,Holling,443,0,6377,6377,14.4
57492,Moyeuvre-Petite,443,0,111,111,0.3
59049,Bantouzelle,443,0,5758,5758,13
61240,Macé,443,2700,2779,5479,12.4
62145,Boiry-Notre-Dame,443,0,551,551,1.2
63465,Viverols,443,1450,4003,5453,12.3
64476,Saint-Esteben,443,3414,11512,14926,33.7
70313,Lyoffans,443,0,19473,19473,44
71042,Bonnay-Saint-Ythaire,443,0,3079,3079,7
76154,Campneuseville,443,7530,8,7538,17
76527,Richemont,443,0,8,8,0
81109,Jonquières,443,0,6626,6626,15
87067,Folles,443,0,718,718,1.6
12129,Lestrade-et-Thouels,442,0,7939,7939,18
14649,Saint-Pierre-du-Bû,442,0,6924,6924,15.7
17124,Courant,442,0,12312,12312,27.9
17134,Crazannes,442,600,11259,11859,26.8
22096,Landébia,442,0,11775,11775,26.6
24094,Chalagnac,442,1225,2469,3694,8.4
24280,Monpazier,442,0,1606,1606,3.6
25323,Laissey,442,0,22032,22032,49.8
28256,Moléans,442,0,24152,24152,54.6
32239,Marsolan,442,0,251,251,0.6
32389,Saint-Martin,442,0,978,978,2.2
49121,Dénezé-sous-Doué,442,11582,4306,15888,35.9
49302,Saint-Macaire-du-Bois,442,0,4306,4306,9.7
50046,Bérigny,442,0,6537,6537,14.8
54020,Anthelupt,442,0,6628,6628,15
86072,Chenevelles,442,0,10060,10060,22.8
88084,Chamagne,442,0,11115,11115,25.1
10379,Torcy-le-Grand,441,0,375,375,0.9
21089,Bonnencontre,441,0,3307,3307,7.5
21294,Gerland,441,0,2115,2115,4.8
24193,Gageac-et-Rouillac,441,1710,9818,11528,26.1
25085,Bouverans,441,0,6397,6397,14.5
30013,Argilliers,441,0,3389,3389,7.7
39251,Gevingey,441,2100,13898,15998,36.3
40270,Saint-Loubouer,441,0,13805,13805,31.3
63043,Blot-l'Église,441,0,2909,2909,6.6
64280,Izeste,441,0,5598,5598,12.7
65005,Allier,441,0,4213,4213,9.6
70376,Nantilly,441,0,2226,2226,5
70383,Neuvelle-lès-Cromary,441,0,3694,3694,8.4
71086,Changy,441,0,1710,1710,3.9
73201,Planay,441,0,2640,2640,6
87188,Saint-Yrieix-sous-Aixe,441,2590,205,2795,6.3
16060,Bréville,440,687,16463,17150,39
16182,Lesterps,440,3480,9053,12533,28.5
18234,Saint-Saturnin,440,3150,1179,4329,9.8
27483,Quatremare,440,0,13048,13048,29.7
29063,Goulien,440,0,31492,31492,71.6
31126,Caubiac,440,0,3681,3681,8.4
41036,Chaon,440,0,3613,3613,8.2
53237,Saint-Mars-sur-Colmont,440,0,5801,5801,13.2
59468,Potelle,440,0,1242,1242,2.8
60257,Fresne-Léguillon,440,2678,9662,12340,28
61386,Saint-Evroult-Notre-Dame-du-Bois,440,0,4536,4536,10.3
62866,Waben,440,0,4681,4681,10.6
65185,Gardères,440,0,4204,4204,9.6
67307,Mulhausen,440,2130,11857,13987,31.8
71423,Saint-Gervais-en-Vallière,440,0,5077,5077,11.5
76734,Vergetot,440,0,3969,3969,9
77473,Treuzy-Levelay,440,0,1530,1530,3.5
80426,Heilly,440,0,58,58,0.1
80782,Vaux-en-Amiénois,440,0,28209,28209,64.1
8209,Hannogne-Saint-Martin,439,0,10084,10084,23
8281,Matton-et-Clémency,439,0,15542,15542,35.4
18012,Argenvières,439,0,1515,1515,3.5
22342,Trébédan,439,0,11695,11695,26.6
24355,La Roque-Gageac,439,16320,2766,19086,43.5
27608,Saint-Victor-de-Chrétienville,439,0,1893,1893,4.3
29064,Goulven,439,0,11062,11062,25.2
30192,Orthoux-Sérignac-Quilhan,439,0,912,912,2.1
31567,Vallesvilles,439,0,2141,2141,4.9
38063,Burcin,439,0,2350,2350,5.4
39328,Meussia,439,1907,12776,14683,33.4
43045,Ceyssac,439,530,18266,18796,42.8
58168,Millay,439,0,22644,22644,51.6
60295,Halloy,439,0,2154,2154,4.9
60634,Thieux,439,0,9900,9900,22.6
65243,Lafitole,439,0,9916,9916,22.6
70472,Saint-Rémy-en-Comté,439,4914,2607,7521,17.1
73020,Arith,439,0,5580,5580,12.7
81040,Brousse,439,0,6566,6566,15
90095,Suarce,439,0,2611,2611,5.9
2282,Eppes,438,0,16727,16727,38.2
2313,Flavigny-le-Grand-et-Beaurain,438,0,2414,2414,5.5
7332,Valvignères,438,0,9378,9378,21.4
10238,Mesnil-Saint-Père,438,0,6255,6255,14.3
12004,Almont-les-Junies,438,0,4401,4401,10
14367,Lison,438,0,3032,3032,6.9
17289,Préguillac,438,1830,13882,15712,35.9
18243,Santranges,438,0,7891,7891,18
28395,Trizay-Coutretot-Saint-Serge,438,0,171,171,0.4
30158,Martignargues,438,0,13691,13691,31.3
31262,Lagarde,438,0,2136,2136,4.9
33367,Saint-André-du-Bois,438,0,4479,4479,10.2
34315,Usclas-d'Hérault,438,0,499,499,1.1
38567,Chamrousse,438,120450,8138,128588,293.6
39246,Gendrey,438,2620,6912,9532,21.8
50008,Anctoville-sur-Boscq,438,0,10600,10600,24.2
50038,Beauchamps,438,0,10600,10600,24.2
50130,Chérencé-le-Héron,438,0,7401,7401,16.9
54469,Saint-Ail,438,0,4067,4067,9.3
60507,Pontoise-lès-Noyon,438,0,0,0,0
70163,Colombier,438,0,22658,22658,51.7
72323,Saint-Victeur,438,0,20617,20617,47.1
88285,Mandres-sur-Vair,438,0,154,154,0.4
89230,Looze,438,600,3433,4033,9.2
7083,Dunière-sur-Eyrieux,437,280,1458,1738,4
11214,Malras,437,0,5752,5752,13.2
12047,Campagnac,437,0,41388,41388,94.7
24211,Issac,437,6425,20925,27350,62.6
25557,Tallenay,437,700,7700,8400,19.2
27601,Saint-Samson-de-la-Roque,437,0,9871,9871,22.6
31280,Latrape,437,0,752,752,1.7
36068,Dun-le-Poëlier,437,0,442,442,1
36152,Paudy,437,0,10318,10318,23.6
37259,Tournon-Saint-Pierre,437,0,7586,7586,17.4
39429,Pleure,437,2800,2588,5388,12.3
44121,Petit-Auverné,437,0,7329,7329,16.8
51093,Brugny-Vaudancourt,437,0,8684,8684,19.9
60177,Cressonsacq,437,0,2421,2421,5.5
63365,Saint-Jean-des-Ollières,437,0,4192,4192,9.6
65392,Saint-Martin,437,0,4175,4175,9.6
67391,Reinhardsmunster,437,2545,30823,33368,76.4
68344,Urbès,437,0,4541,4541,10.4
76316,Grainville-sur-Ry,437,0,299,299,0.7
88250,Jarménil,437,0,10989,10989,25.1
89035,Bellechaume,437,4850,2824,7674,17.6
1104,Chézery-Forens,436,0,5612,5612,12.9
2140,Camelin,436,0,432,432,1
11386,Talairan,436,0,5907,5907,13.5
26315,Saint-Martin-en-Vercors,436,5488,27307,32795,75.2
33016,Asques,436,0,6562,6562,15.1
33189,Gornac,436,0,4330,4330,9.9
39051,Biarne,436,666,8849,9515,21.8
40109,Gaujacq,436,0,1184,1184,2.7
50078,Bretteville-sur-Ay,436,0,9110,9110,20.9
51298,Igny-Comblizy,436,0,631,631,1.4
54006,Agincourt,436,0,2580,2580,5.9
54593,Waville,436,0,2603,2603,6
61141,Cuissai,436,0,12885,12885,29.6
72077,Chenu,436,0,2186,2186,5
73315,Villard-Léger,436,0,7797,7797,17.9
78188,Cravent,436,0,2229,2229,5.1
88313,Moriville,436,0,10964,10964,25.1
12135,Lunac,435,0,1269,1269,2.9
12153,Montjaux,435,0,7814,7814,18
15089,Ladinhac,435,6750,3814,10564,24.3
18209,Saint-Georges-de-Poisieux,435,0,1166,1166,2.7
19214,Saint-Julien-aux-Bois,435,0,1291,1291,3
21190,Corcelles-les-Arts,435,0,1892,1892,4.3
24038,Bertric-Burée,435,2030,3303,5333,12.3
34297,Sauteyrargues,435,2220,8105,10325,23.7
36157,La Pérouille,435,0,2391,2391,5.5
38083,Charette,435,0,2246,2246,5.2
45176,Juranville,435,0,3297,3297,7.6
50042,Beauvoir,435,0,10703,10703,24.6
50093,Cametours,435,0,12586,12586,28.9
51289,Heiltz-le-Maurupt,435,0,2552,2552,5.9
60595,Saint-Remy-en-l'Eau,435,0,2410,2410,5.5
61365,Saint-Aubin-d'Appenai,435,1975,153,2128,4.9
62052,Audembert,435,0,1731,1731,4
62081,Baralle,435,0,541,541,1.2
64051,Arraute-Charritte,435,0,11304,11304,26
65280,Loubajac,435,0,4156,4156,9.6
66085,Fuilla,435,0,13028,13028,29.9
67186,Hegeney,435,0,10525,10525,24.2
84049,Gigondas,435,47998,14204,62202,143
88386,Remomeix,435,0,4229,4229,9.7
89053,Branches,435,0,8510,8510,19.6
89335,Saint-Aubin-sur-Yonne,435,2050,3410,5460,12.6
2070,Bernot,434,0,2392,2392,5.5
2492,Monceau-lès-Leups,434,0,7798,7798,18
15148,Paulhac,434,7900,9600,17500,40.3
31296,Lestelle-de-Saint-Martory,434,0,23325,23325,53.7
31425,Le Plan,434,0,15198,15198,35
40085,Commensacq,434,0,3415,3415,7.9
43108,Jullianges,434,3960,18058,22018,50.7
51580,Trépail,434,0,7713,7713,17.8
54523,Thuilley-aux-Groseilles,434,0,14390,14390,33.2
62124,Beutin,434,0,4617,4617,10.6
65390,Saint-Lézer,434,0,9803,9803,22.6
71101,Charette-Varennes,434,0,53,53,0.1
71414,Saint-Forgeot,434,0,9710,9710,22.4
72034,Bérus,434,0,20429,20429,47.1
73207,Presle,434,2000,7761,9761,22.5
76311,Goupillières,434,3919,1449,5368,12.4
89105,Chichery,434,2281,15168,17449,40.2
9085,Castillon-en-Couserans,433,0,52471,52471,121.2
10066,Bucey-en-Othe,433,0,6183,6183,14.3
23070,Crozant,433,0,12927,12927,29.9
23140,Moutier-Rozeille,433,0,16376,16376,37.8
28128,Dangers,433,0,12617,12617,29.1
2A324,Tavera,433,0,5911,5911,13.7
31070,Blajan,433,0,8969,8969,20.7
33257,Lugaignac,433,0,3021,3021,7
42027,Bully,433,2068,3574,5642,13
49209,Montigné-lès-Rairies,433,0,3313,3313,7.7
50569,Savigny,433,0,12528,12528,28.9
53067,Chémeré-le-Roi,433,0,2602,2602,6
57079,Bibiche,433,0,6233,6233,14.4
59232,La Flamengrie,433,0,1222,1222,2.8
60105,Brétigny,433,0,0,0,0
65482,Cantaous,433,0,2833,2833,6.5
67113,Eberbach-Seltz,433,7400,49653,57053,131.8
68275,Rimbach-près-Masevaux,433,0,9085,9085,21
68380,Wolschwiller,433,0,11615,11615,26.8
70393,Oiselay-et-Grachaux,433,0,3627,3627,8.4
70493,Sorans-lès-Breurey,433,0,3627,3627,8.4
70517,Vallerois-Lorioz,433,0,1386,1386,3.2
79254,Saint-Georges-de-Rex,433,0,5836,5836,13.5
86171,Moussac,433,0,17513,17513,40.4
88142,Domèvre-sur-Avière,433,0,10889,10889,25.1
89472,Villiers-Saint-Benoît,433,1152,19552,20704,47.8
6132,Saorge,432,0,2425,2425,5.6
16121,Douzat,432,3870,29948,33818,78.3
28068,Challet,432,0,12588,12588,29.1
31436,Pouy-de-Touges,432,0,15128,15128,35
34075,Cesseras,432,0,1635,1635,3.8
35291,Saint-Marcan,432,0,3674,3674,8.5
38093,Châtenay,432,0,4713,4713,10.9
39008,Amange,432,6865,8768,15633,36.2
39218,Étrepigney,432,5800,6817,12617,29.2
46296,Saint-Vincent-Rive-d'Olt,432,0,15707,15707,36.4
51446,Pringy,432,0,6814,6814,15.8
52497,Troisfontaines-la-Ville,432,0,3912,3912,9.1
55111,Chauvoncourt,432,0,6366,6366,14.7
59652,Wavrechain-sous-Faulx,432,0,16252,16252,37.6
61221,Landigou,432,1580,11570,13150,30.4
62220,Cavron-Saint-Martin,432,0,6840,6840,15.8
63443,Varennes-sur-Morge,432,0,3267,3267,7.6
70024,Apremont,432,0,2180,2180,5
70107,Bussières,432,0,3618,3618,8.4
71095,La Chapelle-sous-Dun,432,0,8385,8385,19.4
71514,Sens-sur-Seille,432,0,808,808,1.9
72333,Semur-en-Vallon,432,0,5840,5840,13.5
73289,La Table,432,0,7726,7726,17.9
74290,Vallorcine,432,0,191366,191366,443
77038,Boissettes,432,0,6019,6019,13.9
77194,Forges,432,0,305,305,0.7
1372,Saint-Martin-de-Bavel,431,0,4804,4804,11.1
2257,Dallon,431,0,61600,61600,142.9
3208,Le Pin,431,0,7444,7444,17.3
3223,Saint-Christophe-en-Bourbonnais,431,0,867,867,2
7131,Lanas,431,0,26318,26318,61.1
14021,Arromanches-les-Bains,431,0,16612,16612,38.5
16144,Fouqueure,431,2435,5418,7853,18.2
19161,Perpezac-le-Blanc,431,0,6879,6879,16
21487,Pluvet,431,0,10,10,0
22112,Lannebert,431,0,8729,8729,20.3
25032,Autechaux,431,0,21484,21484,49.8
28282,Nonvilliers-Grandhoux,431,0,307,307,0.7
54045,Barbonville,431,0,1781,1781,4.1
54296,Laneuvelotte,431,0,2550,2550,5.9
56191,Réminiac,431,0,5243,5243,12.2
60090,Bouconvillers,431,2285,9464,11749,27.3
60413,Montagny-Sainte-Félicité,431,0,1688,1688,3.9
72044,Bousse,431,0,3124,3124,7.2
73061,Césarches,431,0,10167,10167,23.6
73099,Détrier,431,0,7708,7708,17.9
84101,La Roque-sur-Pernes,431,0,14073,14073,32.7
89205,Jaulges,431,1860,2785,4645,10.8
3091,Créchy,430,0,7427,7427,17.3
7270,Saint-Martin-sur-Lavezon,430,0,9206,9206,21.4
9125,Fougax-et-Barrineuf,430,0,3819,3819,8.9
14391,Maisons,430,0,2977,2977,6.9
18076,Coust,430,2300,1895,4195,9.8
19145,Moustier-Ventadour,430,0,5517,5517,12.8
24241,Limeyrat,430,4640,7520,12160,28.3
24443,Saint-Léon-sur-Vézère,430,4470,5969,10439,24.3
28031,Beaumont-les-Autels,430,0,167,167,0.4
31489,Saint-Jean-Lherm,430,0,4823,4823,11.2
31558,Toutens,430,0,2097,2097,4.9
35103,Eancé,430,0,8371,8371,19.5
50060,La Bloutière,430,0,7266,7266,16.9
57110,Brettnach,430,0,6190,6190,14.4
64207,Escou,430,0,9260,9260,21.5
67493,Triembach-au-Val,430,2200,68204,70404,163.7
68049,Bouxwiller,430,0,11535,11535,26.8
71571,Verosvres,430,0,5843,5843,13.6
76142,Brémontier-Merval,430,0,8123,8123,18.9
76669,Sausseuzemare-en-Caux,430,0,5092,5092,11.8
87108,Nouic,430,1100,7318,8418,19.6
89313,Précy-sur-Vrin,430,2000,3370,5370,12.5
90090,Saint-Dizier-l'Évêque,430,0,2557,2557,5.9
2347,Gland,429,0,9916,9916,23.1
3225,Saint-Désiré,429,0,1745,1745,4.1
7061,Chauzon,429,0,26196,26196,61.1
10222,Maraye-en-Othe,429,0,7485,7485,17.4
16317,Saint-Fraigne,429,10631,5393,16024,37.4
21189,Corberon,429,0,1866,1866,4.3
21342,Laperrière-sur-Saône,429,0,3217,3217,7.5
22068,Grâce-Uzel,429,0,0,0,0
22091,Kermoroc'h,429,0,7682,7682,17.9
27436,Nogent-le-Sec,429,0,3817,3817,8.9
27522,Saint-Christophe-sur-Condé,429,0,6606,6606,15.4
27529,Saint-Cyr-la-Campagne,429,0,12722,12722,29.7
27577,Sainte-Opportune-la-Mare,429,0,1758,1758,4.1
2B354,Vivario,429,0,7411,7411,17.3
31515,Saint-Rustice,429,0,862,862,2
32305,Panjas,429,0,0,0,0
37004,Anché,429,0,23547,23547,54.9
38086,Chasselay,429,0,6933,6933,16.2
38153,Engins,429,0,50786,50786,118.4
41006,Autainville,429,0,1292,1292,3
45255,Préfontaines,429,0,4208,4208,9.8
46160,Latronquière,429,0,12669,12669,29.5
62104,Bellebrune,429,0,1239,1239,2.9
62676,Quernes,429,0,7079,7079,16.5
63073,Chadeleuf,429,0,2789,2789,6.5
68102,Geishouse,429,0,4458,4458,10.4
73004,Aillon-le-Jeune,429,0,5453,5453,12.7
79009,Amuré,429,0,5782,5782,13.5
80701,Saint-Christ-Briost,429,0,8177,8177,19.1
87012,Berneuil,429,2550,7301,9851,23
90080,Phaffans,429,0,14967,14967,34.9
91098,Boutervilliers,429,0,1080,1080,2.5
3049,Cesset,428,0,8754,8754,20.5
8137,Damouzy,428,0,9832,9832,23
10336,Saint-Benoît-sur-Seine,428,0,6112,6112,14.3
14394,Maizières,428,0,6705,6705,15.7
15053,Coltines,428,4938,9467,14405,33.7
17364,Saint-Martial-sur-Né,428,0,5054,5054,11.8
21001,Agencourt,428,0,2053,2053,4.8
22217,Plougras,428,0,8503,8503,19.9
24485,Saint-Pierre-de-Côle,428,5610,1412,7022,16.4
27239,Ferrières-Saint-Hilaire,428,0,1845,1845,4.3
29014,Botsorhel,428,0,25662,25662,60
32335,Puycasquier,428,0,15081,15081,35.2
37078,Ciran,428,0,7429,7429,17.4
48056,Esclanèdes,428,390,15198,15588,36.4
50036,Baupte,428,0,2319,2319,5.4
50538,Saint-Pierre-de-Semilly,428,0,6330,6330,14.8
56216,Saint-Gorgon,428,0,6106,6106,14.3
57239,Freybouse,428,0,7308,7308,17.1
61448,Saint-Pierre-la-Bruyère,428,0,5015,5015,11.7
62909,Ytres,428,0,2128,2128,5
63382,Saint-Pardoux,428,0,2824,2824,6.6
64286,Laà-Mondrans,428,0,11524,11524,26.9
71326,Mouthier-en-Bresse,428,0,53,53,0.1
76251,Étalleville,428,0,943,943,2.2
80615,Ovillers-la-Boisselle,428,0,479,479,1.1
88526,Wisembach,428,0,4161,4161,9.7
1335,Saint-André-le-Bouchoux,427,0,89,89,0.2
11146,Floure,427,0,2770,2770,6.5
12238,Saint-Léons,427,0,3028,3028,7.1
14620,Saint-Martin-aux-Chartrains,427,0,6863,6863,16.1
16380,Le Tâtre,427,6450,22832,29282,68.6
17160,Floirac,427,3500,6725,10225,23.9
17191,La Jard,427,0,13533,13533,31.7
17305,Rouffignac,427,0,5042,5042,11.8
22016,Île-de-Bréhat,427,0,0,0,0
22328,Saint-Servais,427,0,7646,7646,17.9
23211,Saint-Marc-à-Frongier,427,0,16149,16149,37.8
28385,Le Thieulin,427,0,1580,1580,3.7
33468,Sainte-Radegonde,427,0,2979,2979,7
35071,Le Châtellier,427,0,13089,13089,30.7
38460,Saint-Sulpice-des-Rivoires,427,0,7254,7254,17
45064,Cernoy-en-Berry,427,0,4970,4970,11.6
58036,Bouhy,427,0,19281,19281,45.2
58122,Garchy,427,0,8513,8513,19.9
61044,Berjou,427,0,11436,11436,26.8
63451,Vernines,427,0,1337,1337,3.1
85235,Saint-Juire-Champgillon,427,0,9024,9024,21.1
89395,Les Sièges,427,6089,828,6917,16.2
3237,Saint-Germain-de-Salles,426,0,8713,8713,20.5
12226,Saint-Hippolyte,426,0,2110,2110,5
12298,Villecomtal,426,0,2110,2110,5
24158,Dussac,426,1168,5356,6524,15.3
27130,Capelle-les-Grands,426,0,1837,1837,4.3
40105,Garein,426,0,3352,3352,7.9
42151,Mornand-en-Forez,426,0,3817,3817,9
46058,Carennac,426,0,13899,13899,32.6
46217,Pern,426,0,0,0,0
55272,Laimont,426,0,9455,9455,22.2
55498,Souilly,426,0,2711,2711,6.4
59304,Herrin,426,0,7270,7270,17.1
63325,Saint-Bonnet-lès-Allier,426,0,4086,4086,9.6
64209,Escout,426,0,9174,9174,21.5
71408,Saint-Edmond,426,0,8268,8268,19.4
73327,Vions,426,0,2357,2357,5.5
76113,Boissay,426,0,291,291,0.7
76133,Le Bourg-Dun,426,0,2759,2759,6.5
79126,Les Fosses,426,0,12303,12303,28.9
80766,Toutencourt,426,0,476,476,1.1
89416,Thury,426,1400,19236,20636,48.4
95061,Béthemont-la-Forêt,426,0,2770,2770,6.5
2081,Béthancourt-en-Vaux,425,0,7636,7636,18
9299,Soueix-Rogalle,425,0,51501,51501,121.2
11439,Villespy,425,0,1258,1258,3
18079,Crézancy-en-Sancerre,425,0,7657,7657,18
21643,Tréclun,425,0,0,0,0
26298,Saint-Christophe-et-le-Laris,425,2400,8615,11015,25.9
40151,Lesgor,425,0,9997,9997,23.5
41260,Thoury,425,2060,2978,5038,11.9
42016,La Bénisson-Dieu,425,0,11026,11026,25.9
46062,Castelfranc,425,0,15453,15453,36.4
47262,Saint-Nicolas-de-la-Balerme,425,0,9729,9729,22.9
53240,Saint-Martin-du-Limet,425,0,2813,2813,6.6
55012,Apremont-la-Forêt,425,0,5051,5051,11.9
57462,Metting,425,0,853,853,2
60091,Bouillancy,425,0,1664,1664,3.9
62829,Le Transloy,425,0,2113,2113,5
65455,Tuzaguet,425,0,2781,2781,6.5
70045,Avrigney-Virey,425,0,287,287,0.7
90070,Montbouton,425,0,2528,2528,5.9
95102,Bréançon,425,0,19527,19527,45.9
12268,Sénergues,424,0,17495,17495,41.3
30215,Rivières,424,0,17209,17209,40.6
32231,Marambat,424,0,3083,3083,7.3
33390,Sainte-Colombe,424,0,2958,2958,7
37046,Céré-la-Ronde,424,0,9541,9541,22.5
37165,Neuil,424,0,11505,11505,27.1
38128,Corps,424,0,4439,4439,10.5
38364,Saint-Barthélemy-de-Séchilienne,424,0,16379,16379,38.6
39006,Aiglepierre,424,280,9378,9658,22.8
40069,Castaignos-Souslens,424,0,1151,1151,2.7
41066,Courbouzon,424,0,1277,1277,3
42006,Apinac,424,0,3799,3799,9
45084,Châtenoy,424,0,4348,4348,10.3
48025,Les Bessons,424,0,4355,4355,10.3
60365,Lihus,424,0,2080,2080,4.9
64208,Escoubès,424,0,4426,4426,10.4
65296,Madiran,424,0,9578,9578,22.6
67337,Nothalten,424,0,13112,13112,30.9
74199,Nernier,424,0,18460,18460,43.5
74285,Usinens,424,0,10241,10241,24.2
76759,Yville-sur-Seine,424,0,12111,12111,28.6
78300,Hargeville,424,0,3946,3946,9.3
79316,Soudan,424,905,2357,3262,7.7
85269,Saint-Sigismond,424,0,6645,6645,15.7
88241,Houécourt,424,0,149,149,0.4
1141,Cuzieu,423,0,4714,4714,11.1
1358,Saint-Germain-les-Paroisses,423,0,4714,4714,11.1
2541,Neufchâtel-sur-Aisne,423,0,1138,1138,2.7
3251,Saint-Plaisir,423,0,6498,6498,15.4
6028,Caille,423,0,10800,10800,25.5
8097,Challerange,423,0,10235,10235,24.2
18156,Morogues,423,1760,3206,4966,11.7
24519,Sarlande,423,3100,5318,8418,19.9
27231,Fains,423,0,2223,2223,5.3
28118,Croisilles,423,2500,2455,4955,11.7
28219,Luigny,423,0,165,165,0.4
33163,Faleyras,423,0,4201,4201,9.9
39011,Annoire,423,0,2505,2505,5.9
39093,Chamblay,423,608,4096,4704,11.1
40076,Cauna,423,0,9773,9773,23.1
43123,Lorlanges,423,7215,20730,27945,66.1
45239,Oussoy-en-Gâtinais,423,0,4337,4337,10.3
53098,Fontaine-Couverte,423,0,2800,2800,6.6
59406,Monceau-Saint-Waast,423,0,15089,15089,35.7
62432,Herbinghen,423,0,2589,2589,6.1
64112,Bérenx,423,0,8842,8842,20.9
67341,Oberdorf-Spachbach,423,0,10235,10235,24.2
68192,Valdieu-Lutran,423,0,6023,6023,14.2
71011,Anzy-le-Duc,423,0,9478,9478,22.4
71589,Vitry-sur-Loire,423,0,2175,2175,5.1
73276,Saint-Pierre-de-Soucy,423,0,7565,7565,17.9
76174,Cideville,423,2069,932,3001,7.1
76317,Grainville-Ymauville,423,0,5009,5009,11.8
79258,Saint-Jacques-de-Thouars,423,0,6582,6582,15.6
80248,Dompierre-sur-Authie,423,0,10475,10475,24.8
81326,Sainte-Croix,423,0,9677,9677,22.9
95523,La Roche-Guyon,423,0,2674,2674,6.3
6036,Castillon,422,0,2368,2368,5.6
8055,Beaumont-en-Argonne,422,0,14941,14941,35.4
23151,Peyrat-la-Nonière,422,0,5540,5540,13.1
25030,Audeux,422,1080,7435,8515,20.2
26016,Aubres,422,0,21684,21684,51.4
41072,Crucheray,422,0,5220,5220,12.4
42192,Rozier-Côtes-d'Aurec,422,0,9888,9888,23.4
47152,Lougratte,422,0,10776,10776,25.5
50491,Saint-Jean-de-Savigny,422,0,6242,6242,14.8
55165,Doulcon,422,0,15259,15259,36.2
57627,Sanry-sur-Nied,422,0,1028,1028,2.4
62192,Cagnicourt,422,0,525,525,1.2
63177,Isserteaux,422,0,4048,4048,9.6
63274,Perpezat,422,0,1321,1321,3.1
64524,Simacourbe,422,0,4405,4405,10.4
65292,Luquet,422,0,4032,4032,9.6
71538,Thurey,422,0,789,789,1.9
90005,Auxelles-Bas,422,0,12570,12570,29.8
2470,Martigny,421,0,8264,8264,19.6
4206,Sigonce,421,0,8550,8550,20.3
19041,Chanac-les-Mines,421,6000,7989,13989,33.2
22128,Locarn,421,0,38769,38769,92.1
25477,Rancenay,421,0,7418,7418,17.6
30067,La Capelle-et-Masmolène,421,0,3235,3235,7.7
32045,Berdoues,421,0,932,932,2.2
38354,Saint-Albin-de-Vaulserre,421,0,3692,3692,8.8
39348,Montaigu,421,50,13268,13318,31.6
40251,Saint-Barthélemy,421,0,11958,11958,28.4
50590,Le Tanu,421,0,7114,7114,16.9
57357,Kappelkinger,421,0,5754,5754,13.7
60011,Amy,421,0,3681,3681,8.7
62782,Saudemont,421,0,524,524,1.2
63082,Champs,421,0,2777,2777,6.6
67117,Eckartswiller,421,870,29694,30564,72.6
67203,Hochstett,421,0,5119,5119,12.2
72066,La Chapelle-Saint-Fray,421,0,8213,8213,19.5
74195,Musièges,421,0,10169,10169,24.2
76300,Gerville,421,0,2732,2732,6.5
80518,Martainneville,421,0,8,8,0
80655,Quesnoy-sur-Airaines,421,0,581,581,1.4
85248,Saint-Martin-Lars-en-Sainte-Hermine,421,0,8898,8898,21.1
88184,Fremifontaine,421,0,552,552,1.3
1017,Argis,420,0,7168,7168,17.1
12282,Tournemire,420,0,880,880,2.1
17406,Saint-Sornin,420,0,9651,9651,23
21409,Meuilley,420,0,2014,2014,4.8
22146,Mellionnec,420,0,38677,38677,92.1
25075,Bonnevaux,420,0,6093,6093,14.5
27354,Iville,420,1490,1806,3296,7.8
34335,Villemagne-l'Argentière,420,0,3910,3910,9.3
36148,Oulches,420,0,2309,2309,5.5
40070,Castandet,420,0,1962,1962,4.7
41281,Villefrancœur,420,0,16097,16097,38.3
45157,Givraines,420,0,522,522,1.2
54091,Bouxières-sous-Froidmont,420,0,4589,4589,10.9
57114,Brouviller,420,0,843,843,2
59538,Saint-Momelin,420,0,8089,8089,19.3
60675,Vignemont,420,0,3672,3672,8.7
61501,Verrières,420,1000,4922,5922,14.1
70460,Saint-Bresson,420,0,404,404,1
76124,Bosc-Hyons,420,0,7934,7934,18.9
76370,Hugleville-en-Caux,420,1780,926,2706,6.4
76406,Maniquerville,420,0,2725,2725,6.5
81096,Le Fraysse,420,0,5283,5283,12.6
81150,Lugan,420,0,1372,1372,3.3
89353,Saint-Martin-d'Ordon,420,3656,3292,6948,16.5
2631,Quierzy,419,0,7528,7528,18
2815,Villers-Saint-Christophe,419,0,59884,59884,142.9
10037,Bercenay-en-Othe,419,0,7310,7310,17.4
10372,Soulaines-Dhuys,419,0,2494,2494,6
11181,Labécède-Lauragais,419,0,3682,3682,8.8
12292,Versols-et-Lapeyre,419,0,878,878,2.1
14149,Cesny-aux-Vignes,419,0,3372,3372,8
17085,Champdolent,419,0,11671,11671,27.9
17430,Soubran,419,0,4947,4947,11.8
27317,La Haye-Aubrée,419,0,1717,1717,4.1
27553,Saint-Julien-de-la-Liègue,419,0,12426,12426,29.7
28365,Sandarville,419,0,12209,12209,29.1
33475,Saint-Seurin-de-Bourg,419,0,4288,4288,10.2
37009,Autrèche,419,0,1839,1839,4.4
38413,Saint-Laurent-en-Beaumont,419,0,4387,4387,10.5
39398,Ougney,419,3910,6612,10522,25.1
45047,Bouzonville-aux-Bois,419,0,521,521,1.2
47017,Auradou,419,0,2414,2414,5.8
51478,Saint-Eulien,419,0,3795,3795,9.1
53010,Assé-le-Bérenger,419,0,2997,2997,7.2
54235,Goviller,419,0,0,0,0
54583,Villey-le-Sec,419,0,874,874,2.1
57190,Elvange,419,0,19443,19443,46.4
57431,Maizeroy,419,0,1020,1020,2.4
57570,Rémering,419,0,2524,2524,6
62086,Bavincourt,419,0,3482,3482,8.3
62653,Pernes-lès-Boulogne,419,0,14164,14164,33.8
67111,Durstel,419,0,5253,5253,12.5
67508,Vœllerdingen,419,890,5253,6143,14.7
70220,Essertenne-et-Cecey,419,0,2115,2115,5
76160,Carville-la-Folletière,419,0,775,775,1.8
80017,Allaines,419,0,3002,3002,7.2
80130,Bovelles,419,0,26863,26863,64.1
90063,Lebetain,419,0,2492,2492,5.9
5011,Avançon,418,0,3729,3729,8.9
7327,Uzer,418,3249,6586,9835,23.5
24076,Campagne,418,4630,5803,10433,25
31323,Martres-de-Rivière,418,0,4001,4001,9.6
32417,La Sauvetat,418,0,237,237,0.6
33087,Camiran,418,0,3403,3403,8.1
38137,Cras,418,0,6755,6755,16.2
40259,Saint-Gein,418,0,3993,3993,9.6
50478,Saint-Germain-de-Tournebut,418,0,13148,13148,31.5
54402,Norroy-le-Sec,418,0,3881,3881,9.3
55049,Beurey-sur-Saulx,418,0,5040,5040,12.1
56264,Kernascléden,418,0,13361,13361,32
57196,Erching,418,0,9633,9633,23
57527,Orny,418,0,16007,16007,38.3
58269,Saint-Sulpice,418,0,2095,2095,5
63154,Espirat,418,0,4009,4009,9.6
64253,Gurs,418,0,8738,8738,20.9
66064,Égat,418,0,0,0,0
71214,Genouilly,418,0,6411,6411,15.3
79269,Saint-Maixent-de-Beugné,418,0,3445,3445,8.2
84040,Crestet,418,0,489,489,1.2
8476,Villers-devant-le-Thour,417,0,7975,7975,19.1
10392,Vallant-Saint-Georges,417,0,429,429,1
14449,Monts-en-Bessin,417,0,15463,15463,37.1
17378,Saint-Palais-de-Négrignac,417,0,4924,4924,11.8
18155,Mornay-sur-Allier,417,0,6682,6682,16
19181,Saint-Augustin,417,5450,7913,13363,32
21413,Millery,417,0,8855,8855,21.2
2B167,Montegrosso,417,0,0,0,0
31491,Saint-Julia,417,0,8478,8478,20.3
51232,Époye,417,0,7411,7411,17.8
51238,Étoges,417,0,604,604,1.4
54037,Azelot,417,0,3318,3318,8
59567,Séranvillers-Forenville,417,0,5420,5420,13
60203,Duvy,417,0,1633,1633,3.9
60495,Plainval,417,0,2310,2310,5.5
63237,Montel-de-Gelat,417,0,14101,14101,33.8
63403,Saint-Vincent,417,0,2711,2711,6.5
65077,Beaucens,417,0,17076,17076,40.9
65168,Esquièze-Sère,417,0,17076,17076,40.9
70579,Vyans-le-Val,417,0,2723,2723,6.5
76469,Nolléval,417,0,7877,7877,18.9
76723,Vassonville,417,0,3365,3365,8.1
89468,Villevallier,417,6930,3269,10199,24.5
3288,Treignat,416,0,1693,1693,4.1
8232,Illy,416,0,9556,9556,23
9210,Montoulieu,416,0,11181,11181,26.9
16096,Cherves-Châtelars,416,4880,8559,13439,32.3
17320,Saint-Coutant-le-Grand,416,5287,6851,12138,29.2
22257,Quemperven,416,0,8264,8264,19.9
24379,Saint-Avit-Sénieur,416,4100,1511,5611,13.5
27661,La Trinité-de-Thouberville,416,0,1704,1704,4.1
40081,Cère,416,0,3273,3273,7.9
42280,Saint-Régis-du-Coin,416,0,8511,8511,20.5
46284,Saint-Michel-Loubéjou,416,0,13572,13572,32.6
49219,Montsoreau,416,0,4053,4053,9.7
54330,Lupcourt,416,0,3310,3310,8
59521,Sailly-lez-Cambrai,416,0,5407,5407,13
61182,Gandelain,416,2760,12294,15054,36.2
61241,La Madeleine-Bouvet,416,4655,4875,9530,22.9
63005,Antoingt,416,0,2704,2704,6.5
64398,Montaner,416,0,9397,9397,22.6
69058,Chiroubles,416,0,0,0,0
7329,Valgorge,415,462,28936,29398,70.8
10314,Ramerupt,415,0,353,353,0.9
30337,Vallabrix,415,0,3189,3189,7.7
31216,Gémil,415,0,4655,4655,11.2
35305,Saint-Péran,415,0,7303,7303,17.6
36156,Pérassay,415,0,9116,9116,22
39137,Saint-Hymetière-sur-Valouse,415,2300,12078,14378,34.6
42227,Saint-Georges-en-Couzan,415,0,3718,3718,9
46065,Cavagnac,415,0,13540,13540,32.6
54380,Mont-le-Vignoble,415,0,13760,13760,33.2
55401,Les Paroches,415,0,6116,6116,14.7
57264,Guebenhouse,415,0,5672,5672,13.7
60226,Ève,415,0,1625,1625,3.9
64352,Lourenties,415,0,4332,4332,10.4
79070,La Chapelle-Bâton,415,0,3421,3421,8.2
80780,Vaudricourt,415,0,1266,1266,3.1
2329,Fourdrain,414,0,7439,7439,18
12170,Naussac,414,0,1207,1207,2.9
27205,Douville-sur-Andelle,414,0,2724,2724,6.6
28194,Houville-la-Branche,414,0,12063,12063,29.1
31099,Caignac,414,0,2019,2019,4.9
33515,Soulignac,414,0,4111,4111,9.9
35268,Saint-Ganton,414,0,5906,5906,14.3
37125,Lémeré,414,0,11233,11233,27.1
45038,Bondaroy,414,0,515,515,1.2
51199,Cuchery,414,0,599,599,1.4
54081,Boismont,414,0,5256,5256,12.7
54309,Lemainville,414,0,0,0,0
58126,Gimouille,414,0,22267,22267,53.8
62203,Campagne-lès-Guines,414,0,2534,2534,6.1
86265,Sossais,414,0,9422,9422,22.8
89030,Bazarnes,414,0,57,57,0.1
7063,Cheminas,413,3895,18172,22067,53.4
17129,Courpignac,413,0,4877,4877,11.8
19050,Chauffour-sur-Vell,413,0,2082,2082,5
19188,Saint-Bonnet-l'Enfantier,413,0,6591,6591,16
21130,Chambeire,413,0,9,9,0
21474,Pagny-la-Ville,413,0,3097,3097,7.5
22300,Saint-Hervé,413,0,0,0,0
27427,Neaufles-Auvergny,413,0,11615,11615,28.1
31153,Couladère,413,0,14463,14463,35
34068,Cazouls-d'Hérault,413,16780,4587,21367,51.7
42068,Combre,413,0,12187,12187,29.5
43186,Saint-Front,413,0,2291,2291,5.5
47062,Cauzac,413,0,9454,9454,22.9
50019,Aucey-la-Plaine,413,0,10162,10162,24.6
50108,Céaux,413,0,10162,10162,24.6
52076,Bricon,413,0,2265,2265,5.5
53059,La Chapelle-Rainsouin,413,0,2954,2954,7.2
54212,Fresnois-la-Montagne,413,0,5243,5243,12.7
57142,Chieulles,413,0,20477,20477,49.6
67446,Schillersdorf,413,4126,11129,15255,36.9
68046,Bourbach-le-Haut,413,0,6950,6950,16.8
76666,Saumont-la-Poterie,413,0,7802,7802,18.9
77278,Marolles-en-Brie,413,0,1608,1608,3.9
77331,Nanteuil-sur-Marne,413,0,1608,1608,3.9
78366,Mareil-le-Guyon,413,0,178,178,0.4
85207,Saint-Denis-du-Payré,413,0,8729,8729,21.1
2289,Essises,412,0,224,224,0.5
2416,Lemé,412,0,7347,7347,17.8
8125,Cliron,412,0,9464,9464,23
17220,Marignac,412,0,4865,4865,11.8
24523,Saussignac,412,3650,9172,12822,31.1
33356,La Rivière,412,0,6201,6201,15.1
36117,Le Menoux,412,0,3025,3025,7.3
39121,Châtenois,412,1807,8362,10169,24.7
41282,Villeherviers,412,0,8682,8682,21.1
42276,Saint-Priest-la-Prugne,412,12873,7729,20602,50
50454,Saint-Christophe-du-Foc,412,1890,12959,14849,36
57200,Les Étangs,412,0,1003,1003,2.4
60511,Porquéricourt,412,0,0,0,0
63118,Condat-en-Combraille,412,0,13932,13932,33.8
67456,Schopperten,412,146,5165,5311,12.9
71198,Flacey-en-Bresse,412,0,1696,1696,4.1
71483,Saint-Symphorien-des-Bois,412,0,7997,7997,19.4
72152,Juillé,412,0,19393,19393,47.1
86197,Pouant,412,0,2105,2105,5.1
2280,Épieds,411,0,9500,9500,23.1
3011,Aurouër,411,0,5532,5532,13.5
11089,Cenne-Monestiés,411,0,1217,1217,3
11195,Laurabuc,411,5380,3611,8991,21.9
14103,Le Breuil-en-Bessin,411,0,2845,2845,6.9
19056,Clergoux,411,3326,7799,11125,27.1
27004,Aigleville,411,0,2160,2160,5.3
27669,Valletot,411,0,1684,1684,4.1
33346,Puybarban,411,800,3346,4146,10.1
35044,Broualan,411,0,3495,3495,8.5
36134,Mouhet,411,9250,8289,17539,42.7
46271,Saint-Jean-Lespinasse,411,0,13409,13409,32.6
47320,Villefranche-du-Queyran,411,0,6936,6936,16.9
58309,Villapourçon,411,0,21200,21200,51.6
59111,Broxeele,411,0,7916,7916,19.3
60127,Canny-sur-Matz,411,0,3593,3593,8.7
61310,Nonant-le-Pin,411,1000,0,1000,2.4
61321,Pacé,411,5140,12146,17286,42.1
71369,Remigny,411,0,11300,11300,27.5
76019,Anneville-sur-Scie,411,0,3317,3317,8.1
76065,Beaussault,411,0,7764,7764,18.9
88076,Brouvelieures,411,0,539,539,1.3
89129,Crain,411,0,8599,8599,20.9
8242,Laifour,410,0,6383,6383,15.6
16031,Barro,410,890,8974,9864,24.1
18069,Colombiers,410,500,1807,2307,5.6
18090,Étréchy,410,0,1890,1890,4.6
18268,Uzay-le-Venon,410,0,7422,7422,18.1
21112,Broin,410,0,3074,3074,7.5
22057,Le Faouët,410,0,8303,8303,20.3
24021,Badefols-d'Ans,410,0,7170,7170,17.5
24168,Plaisance,410,3850,768,4618,11.3
25322,Laire,410,0,2678,2678,6.5
28351,Saint-Maixme-Hauterive,410,0,548,548,1.3
36198,Saint-Lactencin,410,0,650,650,1.6
38346,Royas,410,0,4473,4473,10.9
40018,Audon,410,0,9644,9644,23.5
40260,Saint-Geours-d'Auribat,410,0,6421,6421,15.7
41103,Huisseau-en-Beauce,410,0,5071,5071,12.4
49011,Artannes-sur-Thouet,410,7815,3995,11810,28.8
53139,Loupfougères,410,0,3646,3646,8.9
60019,Antheuil-Portes,410,0,3584,3584,8.7
61107,Ciral,410,0,12117,12117,29.6
62392,Guémappe,410,0,11532,11532,28.1
71293,Ménetreuil,410,0,2390,2390,5.8
76059,Bazinval,410,0,8,8,0
77328,Nanteau-sur-Essonne,410,0,210,210,0.5
78505,Prunay-le-Temple,410,0,4111,4111,10
80390,Grivesnes,410,0,2519,2519,6.1
2822,Vivières,409,0,394,394,1
4075,Entrepierres,409,0,12193,12193,29.8
19076,Espartignac,409,0,0,0,0
19279,Vars-sur-Roseix,409,0,6528,6528,16
21170,Chevigny-en-Valière,409,0,1779,1779,4.3
22023,Bulat-Pestivien,409,0,7324,7324,17.9
23114,Lussat,409,0,6148,6148,15
23240,Saint-Silvain-Bas-le-Roc,409,0,6148,6148,15
27189,La Croisille,409,0,3639,3639,8.9
27667,Valailles,409,0,1763,1763,4.3
28200,Jaudrais,409,0,7301,7301,17.9
41038,La Chapelle-Montmartin,409,0,8618,8618,21.1
41115,Lignières,409,0,2077,2077,5.1
42028,Burdignes,409,0,8368,8368,20.5
46073,Concots,409,0,2299,2299,5.6
47151,Loubès-Bernac,409,0,20148,20148,49.3
49064,Chambellay,409,0,11853,11853,29
52421,Riaucourt,409,0,44926,44926,109.8
54476,Saint-Jean-lès-Longuyon,409,0,5192,5192,12.7
60660,Le Vaumain,409,1860,3353,5213,12.7
62071,Bailleul-lès-Pernes,409,0,8836,8836,21.6
63290,Pulvérières,409,0,3093,3093,7.6
73237,Saint-Georges-d'Hurtières,409,0,15515,15515,37.9
76413,Martigny,409,0,4971,4971,12.2
2291,Estrées,408,0,3697,3697,9.1
3010,Audes,408,0,570,570,1.4
16218,Mesnac,408,3400,15266,18666,45.8
16421,Vouthon,408,4610,7276,11886,29.1
17260,Neuvicq,408,0,4818,4818,11.8
19078,Estivaux,408,0,6512,6512,16
21642,Toutry,408,0,8664,8664,21.2
22027,Le Cambout,408,0,0,0,0
28235,Marchezais,408,0,546,546,1.3
33551,Villeneuve,408,0,4176,4176,10.2
38272,Murinais,408,0,6594,6594,16.2
43056,Chanteuges,408,3000,3715,6715,16.5
51032,Bagneux,408,0,5324,5324,13
54160,Domèvre-en-Haye,408,0,851,851,2.1
59125,Cantaing-sur-Escaut,408,0,5303,5303,13
60429,Morangles,408,0,1695,1695,4.2
62089,Bazinghen,408,0,1623,1623,4
65315,Monléon-Magnoac,408,0,13217,13217,32.4
66132,Palau-de-Cerdagne,408,0,0,0,0
67086,Daubensand,408,0,7543,7543,18.5
68054,Brinckheim,408,0,7930,7930,19.4
68245,Obermorschwiller,408,0,10945,10945,26.8
70076,Bonnevent-Velloreille,408,0,3417,3417,8.4
76626,Saint-Nicolas-de-la-Haie,408,0,3109,3109,7.6
79106,Couture-d'Argenson,408,0,11783,11783,28.9
85149,Moreilles,408,0,8623,8623,21.1
89359,Saint-Maurice-aux-Riches-Hommes,408,0,791,791,1.9
2474,Mennessis,407,0,7313,7313,18
3135,Lalizolle,407,0,8325,8325,20.5
5113,Rambaud,407,0,3630,3630,8.9
7232,Saint-Étienne-de-Lugdarès,407,5946,3182,9128,22.4
16303,Saint-Bonnet,407,2772,21763,24535,60.3
17332,Saint-Georges-Antignac,407,0,4806,4806,11.8
21572,Saint-Seine-en-Bâche,407,0,3052,3052,7.5
24165,Eygurande-et-Gardedeuil,407,300,3093,3393,8.3
31371,Montégut-Lauragais,407,0,8274,8274,20.3
40263,Saint-Jean-de-Lier,407,0,6374,6374,15.7
51076,Boursault,407,0,589,589,1.4
52156,Curel,407,0,3686,3686,9.1
60278,Golancourt,407,0,0,0,0
63077,Chambon-sur-Lac,407,0,2971,2971,7.3
78475,Osmoy,407,0,4081,4081,10
79250,Sainte-Gemme,407,0,6333,6333,15.6
82152,Saint-Aignan,407,0,5227,5227,12.8
88281,Madonne-et-Lamerey,407,0,5849,5849,14.4
89440,Verlin,407,0,3190,3190,7.8
2133,Bucy-lès-Pierrepont,406,0,1092,1092,2.7
3149,Louchy-Montfand,406,0,8304,8304,20.5
7305,Les Salelles,406,900,9935,10835,26.7
12240,Saint-Parthem,406,0,4080,4080,10
14534,Reux,406,0,6525,6525,16.1
17342,Saint-Germain-du-Seudre,406,0,4794,4794,11.8
18176,Parassy,406,0,3077,3077,7.6
22072,Gurunhuel,406,0,7270,7270,17.9
22366,Trémel,406,0,8065,8065,19.9
27148,La Chapelle-Gauthier,406,0,1750,1750,4.3
29100,Lanarvily,406,0,10230,10230,25.2
2A323,Tavaco,406,0,4071,4071,10
43138,Monlet,406,1180,16893,18073,44.5
46024,Belmont-Bretenoux,406,0,13246,13246,32.6
51610,Verrières,406,0,6028,6028,14.8
52102,Champigny-lès-Langres,406,0,1863,1863,4.6
53169,Olivet,406,0,17669,17669,43.5
58293,Toury-Lurcy,406,0,1047,1047,2.6
60004,Achy,406,0,1992,1992,4.9
62439,Hermelinghen,406,0,2485,2485,6.1
67002,Adamswiller,406,6176,5090,11266,27.7
68050,Bréchaumont,406,0,5781,5781,14.2
68244,Obermorschwihr,406,0,39863,39863,98.2
82065,Gasques,406,0,43621,43621,107.4
82191,Verfeil,406,0,5742,5742,14.1
89145,Domecy-sur-Cure,406,3450,880,4330,10.7
2005,Aguilcourt,405,0,1090,1090,2.7
4124,Montagnac-Montpezat,405,0,4708,4708,11.6
7278,Saint-Michel-de-Chabrillanoux,405,4740,1351,6091,15
8436,Taillette,405,0,6305,6305,15.6
10148,Ferreux-Quincey,405,0,2503,2503,6.2
10249,Montiéramey,405,0,5783,5783,14.3
17108,Clam,405,0,4782,4782,11.8
19096,Ladignac-sur-Rondelles,405,1450,7685,9135,22.6
23073,Dontreix,405,0,5317,5317,13.1
24544,Tamniès,405,7994,2552,10546,26
28353,Saint-Maur-sur-le-Loir,405,0,745,745,1.8
32262,Monbrun,405,0,1528,1528,3.8
36089,Jeu-les-Bois,405,0,15011,15011,37.1
43036,Borne,405,4491,16852,21343,52.7
47067,Clermont-Soubiran,405,0,43514,43514,107.4
47092,Fals,405,0,9271,9271,22.9
50079,Breuville,405,850,12739,13589,33.6
51622,Ville-Dommange,405,0,7198,7198,17.8
54335,Maixe,405,0,6073,6073,15
59394,Maurois,405,0,2783,2783,6.9
60148,Chèvreville,405,0,1586,1586,3.9
60250,Fouquenies,405,0,15881,15881,39.2
60421,Mont-l'Évêque,405,0,0,0,0
63194,Lempty,405,0,1861,1861,4.6
64460,Précilhon,405,2650,8722,11372,28.1
68216,Mooslargue,405,0,5767,5767,14.2
71329,Navilly,405,0,4674,4674,11.5
76038,Authieux-Ratiéville,405,0,277,277,0.7
77093,La Chapelle-Moutils,405,0,6669,6669,16.5
80405,Hailles,405,0,2488,2488,6.1
1225,Lurcy,404,0,2085,2085,5.2
7230,Saint-Étienne-de-Boulogne,404,0,6896,6896,17.1
8230,Houldizy,404,0,9280,9280,23
8445,Thelonne,404,0,9280,9280,23
10423,La Villeneuve-au-Chêne,404,0,2405,2405,6
19187,Saint-Bonnet-la-Rivière,404,0,6448,6448,16
24095,Chalais,404,2691,1333,4024,10
24153,La Dornac,404,3000,7066,10066,24.9
27361,La Lande-Saint-Léger,404,0,6221,6221,15.4
27535,Saint-Élier,404,0,3594,3594,8.9
47314,Trémons,404,0,2327,2327,5.8
56099,Langoëlan,404,0,12914,12914,32
57125,Chailly-lès-Ennery,404,0,820,820,2
59469,Pradelles,404,0,2468,2468,6.1
62092,Beaufort-Blavincourt,404,0,3357,3357,8.3
70083,Bouligney,404,0,2567,2567,6.4
71285,Martigny-le-Comte,404,0,1566,1566,3.9
73274,Saint-Pierre-d'Entremont,404,0,27663,27663,68.5
74004,Allèves,404,0,3121,3121,7.7
76194,Criquebeuf-en-Caux,404,0,2621,2621,6.5
77360,Pézarches,404,0,1573,1573,3.9
80242,Domart-sur-la-Luce,404,0,2482,2482,6.1
81303,Trébas,404,0,12483,12483,30.9
2454,La Malmaison,403,0,1084,1084,2.7
2472,Mauregny-en-Haye,403,0,1084,1084,2.7
10342,Saint-Jean-de-Bonneval,403,0,5755,5755,14.3
15005,Anglards-de-Saint-Flour,403,1580,8914,10494,26
16116,Criteuil-la-Magdeleine,403,1200,15078,16278,40.4
18208,Sainte-Gemme-en-Sancerrois,403,0,7260,7260,18
18249,Sens-Beaujeu,403,1360,7260,8620,21.4
18285,Villeneuve-sur-Cher,403,0,1123,1123,2.8
21691,Villebichot,403,0,1933,1933,4.8
22037,La Chapelle-Neuve,403,4547,7216,11763,29.2
24012,Archignac,403,0,1542,1542,3.8
27310,Hacqueville,403,0,328,328,0.8
28230,Maisons,403,0,2339,2339,5.8
28397,Umpeau,403,0,11743,11743,29.1
29301,Trézilidé,403,0,2976,2976,7.4
33244,Lignan-de-Bazas,403,0,134,134,0.3
38360,Saint-Appolinard,403,0,6513,6513,16.2
45233,Ondreville-sur-Essonne,403,0,3054,3054,7.6
46108,Fons,403,0,11901,11901,29.5
47114,Grézet-Cavagnan,403,0,6801,6801,16.9
51468,Rosnay,403,0,7162,7162,17.8
60521,Quincampoix-Fleuzy,403,0,1977,1977,4.9
67505,La Vancelle,403,0,7753,7753,19.2
72100,Courcelles-la-Forêt,403,0,2921,2921,7.2
76461,Neufbosc,403,0,9414,9414,23.4
4022,Barrême,402,16400,14215,30615,76.2
15087,Lacapelle-del-Fraisse,402,8550,3525,12075,30
15252,Velzic,402,3900,13620,17520,43.6
18016,Aubinges,402,0,3046,3046,7.6
21667,Véronnes,402,0,278,278,0.7
22267,Rouillac,402,2743,4852,7595,18.9
26344,Soyans,402,5795,4870,10665,26.5
27120,Burey,402,0,3576,3576,8.9
27465,Le Plessis-Hébert,402,0,2112,2112,5.3
32105,Clermont-Savès,402,0,28597,28597,71.1
33116,Cazats,402,0,134,134,0.3
33491,Saint-Vivien-de-Monségur,402,0,3273,3273,8.1
40026,Bas-Mauco,402,0,9288,9288,23.1
40040,Beylongue,402,0,9456,9456,23.5
45027,Beauchamps-sur-Huillard,402,0,4122,4122,10.3
46335,Villesèque,402,0,14616,14616,36.4
50570,Savigny-le-Vieux,402,0,9891,9891,24.6
52308,Maranville,402,0,2204,2204,5.5
61102,Le Châtellier,402,2010,10767,12777,31.8
63028,Bagnols,402,0,1258,1258,3.1
70044,Auxon,402,0,2387,2387,5.9
91556,Saint-Hilaire,402,0,1012,1012,2.5
12045,Camboulazet,401,0,12273,12273,30.6
14084,Bonnemaison,401,0,14870,14870,37.1
25427,Noironte,401,0,7065,7065,17.6
39049,Bersaillin,401,3095,8869,11964,29.8
39129,Chaux-des-Crotenay,401,3150,4060,7210,18
40298,Serres-Gaston,401,0,9265,9265,23.1
42128,Machézal,401,2174,11368,13542,33.8
45342,Villereau,401,0,1236,1236,3.1
47274,Saint-Romain-le-Noble,401,0,9180,9180,22.9
50549,Saint-Sauveur-la-Pommeraye,401,0,9705,9705,24.2
50607,La Trinité,401,0,6776,6776,16.9
54376,Montenoy,401,0,3861,3861,9.6
55316,Mangiennes,401,0,7329,7329,18.3
55494,Sommelonne,401,0,7838,7838,19.5
57016,Alzing,401,0,5772,5772,14.4
57476,Monneren,401,0,2569,2569,6.4
60036,Avrigny,401,0,375,375,0.9
62500,Lespesses,401,0,6617,6617,16.5
71290,Mazille,401,0,2787,2787,7
76516,Quièvrecourt,401,0,9367,9367,23.4
82151,Roquecor,401,0,12555,12555,31.3
1296,Pirajoux,400,0,7733,7733,19.3
2621,Presles-et-Thierny,400,0,15276,15276,38.2
3047,La Celle,400,0,14290,14290,35.7
16360,Salles-de-Barbezieux,400,3960,21389,25349,63.4
21698,Villers-la-Faye,400,0,1918,1918,4.8
22111,Lanmodez,400,0,7946,7946,19.9
24018,Auriac-du-Périgord,400,2870,6996,9866,24.7
26215,La Motte-Chalancon,400,0,22239,22239,55.6
26284,Roussas,400,0,10769,10769,26.9
26322,Saint-Pantaléon-les-Vignes,400,0,10769,10769,26.9
27109,Bray,400,0,1724,1724,4.3
32064,Bretagne-d'Armagnac,400,0,0,0,0
36013,Baudres,400,6310,65,6375,15.9
37100,Épeigné-les-Bois,400,0,9001,9001,22.5
39503,Sapois,400,80,4050,4130,10.3
47178,Monségur,400,0,10214,10214,25.5
50270,Lieusaint,400,0,12582,12582,31.5
55477,Savonnières-en-Perthois,400,0,7818,7818,19.5
59116,Bry,400,0,1129,1129,2.8
62689,Ransart,400,0,11251,11251,28.1
70014,Amblans-et-Velotte,400,0,17583,17583,44
70315,Magnoncourt,400,0,2542,2542,6.4
85206,Saint-Cyr-en-Talmondais,400,0,8031,8031,20.1
1011,Apremont,399,0,15093,15093,37.8
2051,Barzy-sur-Marne,399,0,9223,9223,23.1
7314,Silhac,399,5080,1331,6411,16.1
8235,Issancourt-et-Rumel,399,0,9166,9166,23
22314,Saint-Maudan,399,0,0,0,0
24162,Escoire,399,2670,2228,4898,12.3
25390,Montbenoît,399,0,4370,4370,11
31124,Castillon-de-Saint-Martory,399,0,21444,21444,53.7
39220,Falletans,399,2910,8098,11008,27.6
42167,Pavezin,399,0,9349,9349,23.4
46074,Condat,399,0,13018,13018,32.6
47123,Lacapelle-Biron,399,0,2299,2299,5.8
50371,Le Neufbourg,399,0,9817,9817,24.6
53204,Saint-Calais-du-Désert,399,0,3549,3549,8.9
54266,Houdreville,399,0,0,0,0
57214,Fixem,399,0,9714,9714,24.3
58092,Crux-la-Ville,399,0,2000,2000,5
64362,Luxe-Sumberraute,399,0,10368,10368,26
66166,Sahorre,399,0,11950,11950,29.9
76386,Limpiville,399,0,2589,2589,6.5
77466,Tigeaux,399,0,1554,1554,3.9
80377,Gézaincourt,399,0,1555,1555,3.9
81100,Garrevaques,399,0,8112,8112,20.3
87042,Le Châtenet-en-Dognon,399,0,1642,1642,4.1
88147,Dommartin-aux-Bois,399,0,5734,5734,14.4
2022,Arcy-Sainte-Restitue,398,0,1329,1329,3.3
2453,Maizy,398,0,1071,1071,2.7
6041,Cipières,398,0,4823,4823,12.1
10166,Les Grandes-Chapelles,398,0,409,409,1
14528,Quetteville,398,0,2974,2974,7.5
16285,Rougnac,398,0,18715,18715,47
17026,Authon-Ébéon,398,0,11086,11086,27.9
18044,Cerbois,398,1210,5400,6610,16.6
23208,Saint-Léger-le-Guérétois,398,0,6500,6500,16.3
24077,Campsegret,398,0,19058,19058,47.9
33414,Saint-Germain-de-la-Rivière,398,0,5990,5990,15.1
35232,Princé,398,0,5980,5980,15
38552,Villard-Saint-Christophe,398,1695,4167,5862,14.7
45265,Rozoy-le-Vieil,398,0,3904,3904,9.8
46340,Saint-Pierre-Lafeuille,398,0,3361,3361,8.4
58298,Tronsanges,398,0,22462,22462,56.4
59575,Sommaing,398,0,100,100,0.3
71240,Jalogny,398,0,2766,2766,6.9
71546,Trambly,398,0,5408,5408,13.6
72356,Thoiré-sur-Dinan,398,0,22444,22444,56.4
74029,Bassy,398,0,9613,9613,24.2
74036,Bluffy,398,0,3074,3074,7.7
76228,Ectot-lès-Baons,398,0,877,877,2.2
76688,Thiergeville,398,0,2583,2583,6.5
78185,Courgent,398,0,3991,3991,10
80399,Guignemicourt,398,0,25516,25516,64.1
81055,Les Cammazes,398,0,8091,8091,20.3
88438,La Salle,398,0,3870,3870,9.7
89162,Évry,398,1730,73,1803,4.5
4073,Enchastrayes,397,29046,118562,147608,371.8
4126,Montclar,397,5984,16640,22624,57
8070,Blanzy-la-Salonnaise,397,0,7592,7592,19.1
9283,Savignac-les-Ormeaux,397,0,57175,57175,144
22045,Cohiniac,397,0,8040,8040,20.3
2A351,Villanova,397,0,3980,3980,10
40078,Caupenne,397,0,6217,6217,15.7
42112,Jarnosse,397,0,10300,10300,25.9
43206,Saint-Just-près-Brioude,397,0,19456,19456,49
43221,Saint-Privat-d'Allier,397,6160,16519,22679,57.1
46006,Anglars-Nozac,397,0,11881,11881,29.9
47033,Boudy-de-Beauregard,397,0,10137,10137,25.5
57071,Bettborn,397,0,2585,2585,6.5
60516,Puiseux-en-Bray,397,0,3254,3254,8.2
61418,Saint-Mard-de-Réno,397,3080,1394,4474,11.3
62692,Rebergues,397,0,859,859,2.2
68085,Eteimbes,397,0,5653,5653,14.2
69001,Affoux,397,0,4693,4693,11.8
76244,Esclavelles,397,0,9274,9274,23.4
76304,Gonfreville-Caillot,397,0,4701,4701,11.8
80044,Authieule,397,0,1548,1548,3.9
80290,Estrées-lès-Crécy,397,0,9831,9831,24.8
80474,Licourt,397,0,7567,7567,19.1
84063,Lamotte-du-Rhône,397,0,3652,3652,9.2
87198,Vaulry,397,0,643,643,1.6
3056,La Chapelle,396,0,10848,10848,27.4
8303,Monthois,396,0,9582,9582,24.2
10256,Montsuzain,396,0,5655,5655,14.3
24276,Monestier,396,0,8816,8816,22.3
27140,Chambray,396,0,2081,2081,5.3
27476,Les Préaux,396,0,8945,8945,22.6
29222,Port-Launay,396,0,6241,6241,15.8
39391,Nozeroy,396,11303,4009,15312,38.7
39525,Tassenières,396,1500,2345,3845,9.7
41245,Séris,396,0,1192,1192,3
50537,Saint-Pierre-de-Coutances,396,0,11458,11458,28.9
54466,Royaumeix,396,0,826,826,2.1
60418,Montiers,396,3000,2194,5194,13.1
61011,Aubusson,396,860,10606,11466,29
63473,Yssac-la-Tourette,396,0,2612,2612,6.6
66089,Joch,396,0,11860,11860,29.9
67319,Neuhaeusel,396,12500,4799,17299,43.7
68280,Rodern,396,0,947,947,2.4
76213,Daubeuf-Serville,396,0,4689,4689,11.8
81263,Saint-Martin-Laguépie,396,0,10076,10076,25.4
81293,Tauriac,396,0,21757,21757,54.9
86108,La Grimaudière,396,0,2023,2023,5.1
3234,Saint-Gérand-de-Vaux,395,0,6822,6822,17.3
16165,Houlette,395,1800,14779,16579,42
17011,Annepont,395,0,11002,11002,27.9
22274,Saint-André-des-Eaux,395,0,10523,10523,26.6
24159,Échourgnac,395,0,3002,3002,7.6
31513,Saint-Plancard,395,0,8182,8182,20.7
36221,Thevet-Saint-Julien,395,0,8676,8676,22
39271,Lac-des-Rouges-Truites,395,5120,2813,7933,20.1
39559,La Vieille-Loye,395,2980,3825,6805,17.2
47135,Laparade,395,0,3188,3188,8.1
50496,Saint-Jean-le-Thomas,395,0,9719,9719,24.6
51181,Courcelles-Sapicourt,395,0,7020,7020,17.8
57345,Inglange,395,0,2531,2531,6.4
64498,Saint-Vincent,395,0,4224,4224,10.7
76350,Hautot-sur-Seine,395,0,11283,11283,28.6
80119,Bougainville,395,0,545,545,1.4
2261,Dercy,394,0,1985,1985,5
3119,Gannay-sur-Loire,394,0,5304,5304,13.5
26261,Réauville,394,0,10607,10607,26.9
32110,Courrensan,394,0,0,0,0
33345,Le Puy,394,0,3913,3913,9.9
53172,Origné,394,0,17688,17688,44.9
53221,Saint-Georges-sur-Erve,394,0,2818,2818,7.2
56224,Saint-Laurent-sur-Oust,394,0,4793,4793,12.2
62179,Brunembert,394,0,1138,1138,2.9
62267,Dennebrœucq,394,0,35066,35066,89
67530,Wickersheim-Wilshausen,394,0,13241,13241,33.6
68107,Gommersdorf,394,0,5610,5610,14.2
73026,Avrieux,394,31950,6962,38912,98.8
76683,Sotteville-sur-Mer,394,0,2552,2552,6.5
77245,Laval-en-Brie,394,0,278,278,0.7
81175,Montdurausse,394,0,21647,21647,54.9
85056,La Chapelle-Thémer,394,0,8327,8327,21.1
85237,Saint-Laurent-de-la-Salle,394,0,2585,2585,6.6
86295,Voulême,394,0,8873,8873,22.5
89033,Beauvoir,394,825,17791,18616,47.2
3291,Trézelles,393,0,6788,6788,17.3
16208,Mareuil,393,1640,27244,28884,73.5
19195,Saint-Cyprien,393,0,6272,6272,16
21404,Ménétreux-le-Pitois,393,0,0,0,0
25440,Ouhans,393,0,4304,4304,11
27153,Chauvincourt-Provemont,393,0,320,320,0.8
2A040,Bocognano,393,0,5365,5365,13.7
38074,Chantesse,393,0,6351,6351,16.2
40022,Bahus-Soubiran,393,0,12303,12303,31.3
40190,Monségur,393,0,9080,9080,23.1
45301,Santeau,393,0,489,489,1.2
50120,Chanteloup,393,0,9511,9511,24.2
57085,Bionville-sur-Nied,393,0,2367,2367,6
60163,Cormeilles,393,0,8863,8863,22.6
62341,Foncquevillers,393,0,1954,1954,5
62363,Frévin-Capelle,393,0,3266,3266,8.3
65004,Agos-Vidalos,393,0,16093,16093,40.9
69035,Cenves,393,0,0,0,0
76229,Elbeuf-en-Bray,393,0,7424,7424,18.9
81077,Curvalle,393,0,4944,4944,12.6
88059,Biffontaine,393,0,3821,3821,9.7
89200,Hauterive,393,1680,2539,4219,10.7
3268,Saulzet,392,0,8018,8018,20.5
14088,Bons-Tassilly,392,0,6141,6141,15.7
14306,Gonneville-en-Auge,392,0,4980,4980,12.7
16170,Juignac,392,3760,18433,22193,56.6
17165,Fontenet,392,0,10919,10919,27.9
18261,Thaumiers,392,2901,3651,6552,16.7
30045,Bordezac,392,0,15910,15910,40.6
37248,Seuilly,392,0,21517,21517,54.9
42241,Saint-Jodard,392,0,7105,7105,18.1
51249,Festigny,392,0,568,568,1.4
51526,Saudoy,392,0,5115,5115,13
54046,Barisey-au-Plain,392,0,12997,12997,33.2
57741,Walschbronn,392,0,9034,9034,23
64046,Armendarits,392,0,10186,10186,26
65021,Arcizans-Avant,392,0,16052,16052,40.9
65078,Beaudéan,392,0,2942,2942,7.5
68288,Ruederbach,392,0,10516,10516,26.8
72286,Saint-Gervais-de-Vic,392,0,5300,5300,13.5
76290,Frichemesnil,392,0,268,268,0.7
80148,Buigny-lès-Gamaches,392,0,1127,1127,2.9
81034,Boissezon,392,0,4123,4123,10.5
89133,Cudot,392,7010,3073,10083,25.7
89159,Étaule,392,0,850,850,2.2
89256,Migé,392,400,17700,18100,46.2
1085,La Chapelle-du-Châtelard,391,0,81,81,0.2
2457,Marchais,391,0,1052,1052,2.7
2548,La Neuville-lès-Dorengt,391,0,6972,6972,17.8
9301,Soulan,391,0,47381,47381,121.2
10015,Aubeterre,391,0,5583,5583,14.3
14163,Cléville,391,2344,3147,5491,14
14182,Cormolain,391,0,2707,2707,6.9
14627,Saint-Martin-de-Mieux,391,0,6125,6125,15.7
14698,Touffréville,391,0,4967,4967,12.7
21614,Spoy,391,0,5565,5565,14.2
24285,Montagnac-la-Crempse,391,2115,18723,20838,53.3
30250,Saint-Étienne-de-l'Olm,391,0,12222,12222,31.3
32261,Monblanc,391,0,2440,2440,6.2
32297,Noilhan,391,0,2440,2440,6.2
32388,Sainte-Marie,391,0,4967,4967,12.7
37252,Souvigny-de-Touraine,391,1650,10613,12263,31.4
39126,La Chaumusse,391,7106,2784,9890,25.3
39561,Villards-d'Héria,391,750,11379,12129,31
45288,Saint-Loup-des-Vignes,391,0,2963,2963,7.6
46016,Baladou,391,0,12757,12757,32.6
50613,Valcanville,391,3153,12299,15452,39.5
52072,Brethenay,391,0,42949,42949,109.8
53250,Saint-Poix,391,0,2588,2588,6.6
64141,Boueilh-Boueilho-Lasque,391,0,6122,6122,15.7
64516,Sedzère,391,0,4081,4081,10.4
67149,Furchhausen,391,2880,27578,30458,77.9
67165,Grandfontaine,391,2650,28296,30946,79.1
67395,Reutenbourg,391,8000,27578,35578,91
76372,Illois,391,0,7,7,0
78653,Vicq,391,200300,169,200469,512.7
80400,Guillaucourt,391,0,7076,7076,18.1
81013,Andouque,391,0,12081,12081,30.9
89220,Lavau,391,4693,17655,22348,57.2
90067,Menoncourt,391,3841,13641,17482,44.7
1050,Boissey,390,0,5356,5356,13.7
1448,Villes,390,0,4697,4697,12
2709,Serain,390,0,3533,3533,9.1
14522,Prêtreville,390,0,4341,4341,11.1
15028,Carlat,390,7755,13214,20969,53.8
17329,Saint-Froult,390,0,6422,6422,16.5
21564,Saint-Nicolas-lès-Cîteaux,390,0,1870,1870,4.8
25229,Évillers,390,0,8815,8815,22.6
30240,Saint-Césaire-de-Gauzignan,390,0,12190,12190,31.3
33384,Saint-Christophe-des-Bardes,390,0,15152,15152,38.9
33408,Saint-Genès-de-Lombaud,390,0,38506,38506,98.7
39345,Monnières,390,2000,7915,9915,25.4
41166,Oisly,390,3007,7166,10173,26.1
42325,Vendranges,390,1616,11056,12672,32.5
50115,Le Grippon,390,0,9596,9596,24.6
51042,Baye,390,0,565,565,1.4
54035,Avricourt,390,0,1384,1384,3.5
57656,Sorbey,390,0,950,950,2.4
68030,Bergholtzzell,390,1281,9624,10905,28
68239,Oberbruck,390,5280,8183,13463,34.5
71274,Mancey,390,0,4724,4724,12.1
72251,René,390,0,7232,7232,18.5
73027,Ayn,390,0,19979,19979,51.2
77443,Sancy,390,0,1519,1519,3.9
78413,Mondreville,390,0,3910,3910,10
82077,Labarthe,390,0,1988,1988,5.1
84085,Murs,390,0,7950,7950,20.4
86242,Saint-Romain,390,0,8783,8783,22.5
95011,Ambleville,390,0,2465,2465,6.3
14059,Benerville-sur-Mer,389,0,30790,30790,79.2
17424,Semoussac,389,0,4593,4593,11.8
22293,Saint-Gilles-les-Bois,389,0,7878,7878,20.3
23069,Crocq,389,0,5107,5107,13.1
25479,Rang,389,0,897,897,2.3
26314,Saint-Martin-d'Août,389,0,6404,6404,16.5
27430,La Neuve-Grange,389,0,317,317,0.8
27677,Venon,389,0,1673,1673,4.3
28072,Champrond-en-Perchet,389,0,152,152,0.4
28106,Conie-Molitard,389,0,21256,21256,54.6
31401,Noueilles,389,0,6342,6342,16.3
33299,Mourens,389,0,3863,3863,9.9
39029,Aumur,389,10447,7895,18342,47.2
39088,Cesancey,389,1300,12259,13559,34.9
39528,Thervay,389,4250,6138,10388,26.7
46082,Cremps,389,0,2187,2187,5.6
46339,Saint-Jean-Lagineste,389,0,12691,12691,32.6
47230,Saint-Aubin,389,0,9933,9933,25.5
55504,Tannois,389,0,4690,4690,12.1
57726,Vittoncourt,389,0,18051,18051,46.4
59282,Hardifort,389,0,2377,2377,6.1
59625,Villers-Plouich,389,0,5056,5056,13
60008,Airion,389,0,2155,2155,5.5
60448,Neufchelles,389,0,1523,1523,3.9
62306,Ervillers,389,0,1934,1934,5
62585,Montcavrel,389,0,4138,4138,10.6
64261,Herrère,389,0,8377,8377,21.5
67217,Ichtratzheim,389,0,7192,7192,18.5
67352,Obersoultzbach,389,2001,10483,12484,32.1
71430,Saint-Jean-de-Vaux,389,900,10696,11596,29.8
76417,Maucomble,389,0,9087,9087,23.4
80332,Forest-Montiers,389,0,9633,9633,24.8
80710,Saint-Maxent,389,0,7,7,0
82022,Bourg-de-Visa,389,0,12179,12179,31.3
86089,Cuhon,389,0,20215,20215,52
3227,Saint-Didier-la-Forêt,388,0,7936,7936,20.5
3233,Saint-Genest,388,0,9133,9133,23.5
3281,Le Theil,388,0,7936,7936,20.5
4158,Quinson,388,17882,4510,22392,57.7
8048,Barby,388,0,7420,7420,19.1
10248,Montgueux,388,0,5541,5541,14.3
10328,Rouilly-Sacey,388,0,1443,1443,3.7
11372,Salsigne,388,0,5012,5012,12.9
16069,Cellettes,388,350,4878,5228,13.5
17313,Saint-Bris-des-Bois,388,0,12297,12297,31.7
17316,Saint-Ciers-Champagne,388,0,4581,4581,11.8
21094,Bourberain,388,0,1690,1690,4.4
22052,Duault,388,0,6948,6948,17.9
22322,Saint-Péver,388,0,7858,7858,20.3
27215,Ecquetot,388,4000,1669,5669,14.6
27539,Saint-Étienne-sous-Bailleul,388,0,11506,11506,29.7
2B121,Galéria,388,0,0,0,0
31220,Gibel,388,0,1892,1892,4.9
36022,Bouesse,388,0,2849,2849,7.3
39081,Buvilly,388,120,8582,8702,22.4
39185,Cuisia,388,3180,5916,9096,23.4
39241,Frébuans,388,2300,12228,14528,37.4
39481,Saint-Germain-en-Montagne,388,700,3928,4628,11.9
39577,Vincent-Froideville,388,5267,10313,15580,40.2
40100,Le Frêche,388,0,3707,3707,9.6
41289,Villermain,388,0,1599,1599,4.1
42063,Chirassimont,388,2440,10999,13439,34.6
45320,Thignonville,388,0,482,482,1.2
46032,Boissières,388,0,3276,3276,8.4
48030,Brenoux,388,5800,7863,13663,35.2
50426,Rauville-la-Place,388,0,12204,12204,31.5
51184,Courdemanges,388,0,6120,6120,15.8
54139,Courbesseaux,388,0,5819,5819,15
54155,Deuxville,388,0,5819,5819,15
60588,Saint-Maur,388,0,1904,1904,4.9
60683,Villers-Saint-Genest,388,0,1519,1519,3.9
63023,Auzelles,388,3704,3506,7210,18.6
63167,Gimeaux,388,0,2560,2560,6.6
63242,Moriat,388,0,2522,2522,6.5
67153,Geiswiller-Zœbersdorf,388,0,13039,13039,33.6
67272,Lochwiller,388,0,27367,27367,70.5
77163,Douy-la-Ramée,388,0,5697,5697,14.7
79121,Fomperron,388,0,10173,10173,26.2
87073,Gorre,388,2390,171,2561,6.6
91519,Richarville,388,0,2255,2255,5.8
2697,Samoussy,387,0,14779,14779,38.2
4025,Beauvezer,387,3356,13684,17040,44
4104,Limans,387,0,7860,7860,20.3
14055,Beaumont-en-Auge,387,0,6220,6220,16.1
17442,Thaims,387,0,6447,6447,16.7
27481,Pullay,387,7693,10884,18577,48
28222,Luplanté,387,0,1432,1432,3.7
45131,Échilleuses,387,0,2933,2933,7.6
51522,Sapignicourt,387,0,3505,3505,9.1
54588,Vitrimont,387,0,1710,1710,4.4
63390,Saint-Quintin-sur-Sioule,387,0,2553,2553,6.6
68092,Fislis,387,0,10381,10381,26.8
70506,Trémoins,387,0,2527,2527,6.5
73220,Saint-Alban-d'Hurtières,387,0,14681,14681,37.9
76585,Saint-Gilles-de-Crétot,387,950,2949,3899,10.1
79255,Saint-Germain-de-Longue-Chaume,387,0,10146,10146,26.2
81231,Rouairoux,387,12283,3341,15624,40.4
88238,Hennezel,387,0,3008,3008,7.8
89397,Sommecaise,387,2885,9153,12038,31.1
2013,Amifontaine,386,0,1039,1039,2.7
7169,Ozon,386,0,6354,6354,16.5
8013,Angecourt,386,0,13666,13666,35.4
10063,Brienne-la-Vieille,386,0,8149,8149,21.1
10345,Saint-Léger-sous-Brienne,386,0,8149,8149,21.1
11355,Saint-Martin-de-Villereglan,386,0,5081,5081,13.2
12276,Tauriac-de-Naucelle,386,0,11814,11814,30.6
19106,Lapleau,386,0,4952,4952,12.8
23022,Bétête,386,0,5802,5802,15
24107,La Chapelle-Faucher,386,2130,5438,7568,19.6
25114,Chamesol,386,0,2689,2689,7
32381,Saint-Jean-le-Comtal,386,0,4556,4556,11.8
40017,Audignon,386,0,8918,8918,23.1
42209,Sainte-Colombe-sur-Gand,386,0,6997,6997,18.1
42329,La Versanne,386,0,7898,7898,20.5
45184,Lion-en-Sullias,386,0,2261,2261,5.9
49291,Saint-Just-sur-Dive,386,1050,3761,4811,12.5
50094,Camprond,386,0,11169,11169,28.9
52380,Peigney,386,0,1771,1771,4.6
53260,Simplé,386,0,2555,2555,6.6
54066,Bettainvillers,386,0,3584,3584,9.3
54143,Crépey,386,0,12798,12798,33.2
57715,Vigny,386,0,14782,14782,38.3
60290,Guignecourt,386,0,15136,15136,39.2
61209,Joué-du-Bois,386,0,1736,1736,4.5
62147,Boiry-Sainte-Rictrude,386,0,10857,10857,28.1
62703,Rémy,386,0,480,480,1.2
65240,Labatut-Rivière,386,0,8719,8719,22.6
70041,Autrey-lès-Gray,386,0,1948,1948,5
78530,Rosay,386,550,3870,4420,11.5
79225,Reffannes,386,2555,10120,12675,32.8
80102,Biaches,386,0,2766,2766,7.2
80704,Saint-Gratien,386,0,1505,1505,3.9
89156,Esnon,386,4250,2494,6744,17.5
89327,Rousson,386,5240,2565,7805,20.2
89398,Sormery,386,2210,2494,4704,12.2
95341,Livilliers,386,0,10189,10189,26.4
3039,Bresnay,385,0,5182,5182,13.5
3059,Chareil-Cintrat,385,0,7875,7875,20.5
10187,Landreville,385,0,6721,6721,17.5
11064,Camplong-d'Aude,385,1180,5216,6396,16.6
14344,Janville,385,0,3099,3099,8
18048,La Chapelle-Hugon,385,0,122,122,0.3
18081,Crosses,385,0,1774,1774,4.6
19058,Combressol,385,0,5278,5278,13.7
24069,Bussac,385,150,5424,5574,14.5
25019,Appenans,385,0,888,888,2.3
25120,Chantrans,385,0,2806,2806,7.3
31471,Saint-Béat-Lez,385,0,3685,3685,9.6
31569,Vaudreuille,385,0,7827,7827,20.3
32292,Mouchan,385,0,1480,1480,3.8
32298,Nougaroulet,385,0,13565,13565,35.2
36086,Heugnes,385,0,4833,4833,12.6
39402,Pagney,385,3470,6075,9545,24.8
47293,Sauveterre-Saint-Denis,385,0,8813,8813,22.9
51409,Nuisement-sur-Coole,385,0,643,643,1.7
52163,Dampierre,385,0,1767,1767,4.6
54199,Flin,385,0,1701,1701,4.4
60089,Boubiers,385,10923,8454,19377,50.3
60375,Maimbeville,385,0,2042,2042,5.3
60693,Villeselve,385,0,0,0,0
62853,Vieil-Moutier,385,0,1112,1112,2.9
71508,Savigny-sur-Seille,385,0,2244,2244,5.8
76112,Le Bois-Robert,385,0,3107,3107,8.1
76493,Paluel,385,0,2493,2493,6.5
77024,Bassevelle,385,0,1499,1499,3.9
80484,Liomer,385,0,532,532,1.4
80623,Piennes-Onvillers,385,0,465,465,1.2
81254,Saint-Jean-de-Marcel,385,0,8808,8808,22.9
88161,Escles,385,0,2993,2993,7.8
89466,Villeroy,385,6250,1366,7616,19.8
1133,Cressin-Rochefort,384,0,4280,4280,11.1
1197,Journans,384,0,7424,7424,19.3
7315,La Souche,384,1670,1578,3248,8.5
8498,Warnécourt,384,0,8422,8422,21.9
11008,Alet-les-Bains,384,0,5055,5055,13.2
12221,Saint-Félix-de-Lunel,384,0,15845,15845,41.3
19059,Concèze,384,0,3693,3693,9.6
21132,Chambœuf,384,0,1841,1841,4.8
21433,Montigny-Mornay-Villeneuve-sur-Vingeanne,384,0,1673,1673,4.4
24005,Alles-sur-Dordogne,384,0,1395,1395,3.6
24346,Quinsac,384,400,5410,5810,15.1
24510,Saint-Vincent-de-Cosse,384,1900,2419,4319,11.2
39263,Grozon,384,1260,8493,9753,25.4
40334,Yzosse,384,0,3287,3287,8.6
41279,Villedieu-le-Château,384,2760,4750,7510,19.6
50626,Ver,384,0,11111,11111,28.9
56082,Helléan,384,0,5782,5782,15.1
57711,Vibersviller,384,0,1271,1271,3.3
59251,Frasnoy,384,0,1084,1084,2.8
61146,Dompierre,384,0,10285,10285,26.8
62094,Beaumerie-Saint-Martin,384,0,4085,4085,10.6
62632,Oblinghem,384,0,6337,6337,16.5
70039,Autoreille,384,0,1737,1737,4.5
71334,Oudry,384,0,1489,1489,3.9
72145,Le Grez,384,0,7491,7491,19.5
88122,Damas-et-Bettegney,384,0,5519,5519,14.4
2431,Liez,383,0,6882,6882,18
2824,Vorges,383,0,14627,14627,38.2
3210,Pouzy-Mésangy,383,0,5156,5156,13.5
7023,Balazuc,383,3465,23387,26852,70.1
7128,Lalouvesc,383,0,1083,1083,2.8
10262,Neuville-sur-Seine,383,0,6686,6686,17.5
16397,Verdille,383,4445,4815,9260,24.2
17454,Tugéras-Saint-Maurice,383,0,4522,4522,11.8
19230,Saint-Pardoux-Corbier,383,0,0,0,0
21230,Diénay,383,0,5451,5451,14.2
23101,Jouillat,383,0,6255,6255,16.3
24234,Les Lèches,383,0,18340,18340,47.9
25541,Septfontaines,383,0,8657,8657,22.6
27146,La Chapelle-Bayvel,383,0,5898,5898,15.4
27658,Le Tremblay-Omonville,383,0,1647,1647,4.3
2A284,Sollacaro,383,0,0,0,0
33461,Saint-Philippe-d'Aiguille,383,0,14880,14880,38.9
35153,Lillemer,383,0,9081,9081,23.7
36033,Celon,383,0,2812,2812,7.3
39288,Lavigny,383,600,10180,10780,28.1
45326,Tournoisis,383,0,540,540,1.4
47244,Sainte-Gemme-Martaillac,383,0,6463,6463,16.9
47260,Saint-Maurin,383,0,8768,8768,22.9
54520,Thiébauménil,383,0,1692,1692,4.4
57411,Lommerange,383,0,4025,4025,10.5
57526,Ormersviller,383,0,8827,8827,23
64026,Anhaux,383,0,9953,9953,26
64529,Sus,383,0,8006,8006,20.9
67058,Bossendorf,383,650,12871,13521,35.3
76387,Lindebeuf,383,0,844,844,2.2
77505,Villemareuil,383,0,5223,5223,13.6
80156,Bussy-lès-Daours,383,0,51,51,0.1
85125,Loge-Fougereuse,383,1050,8369,9419,24.6
3008,Arronnes,382,0,10465,10465,27.4
4081,Esparron-de-Verdon,382,41100,4440,45540,119.2
12230,Saint-Jean-Delnous,382,0,20845,20845,54.6
17205,Loire-les-Marais,382,1550,6291,7841,20.5
21291,Genay,382,0,8111,8111,21.2
27286,Giverville,382,0,5883,5883,15.4
2A308,Sainte-Lucie-de-Tallano,382,0,8908,8908,23.3
2B355,Volpajola,382,0,1769,1769,4.6
35205,Noyal-sous-Bazouges,382,0,11710,11710,30.7
43034,Boisset,382,21480,34497,55977,146.5
46214,Parnac,382,0,13889,13889,36.4
50263,Lapenty,382,0,9399,9399,24.6
65262,Larreule,382,0,8629,8629,22.6
70128,La Chapelle-lès-Luxeuil,382,0,367,367,1
73095,La Croix-de-la-Rochette,382,0,6831,6831,17.9
80198,Clairy-Saulchoix,382,0,24491,24491,64.1
80754,Thieulloy-l'Abbaye,382,0,527,527,1.4
81299,Teyssode,382,0,5713,5713,15
86286,Verrue,382,0,1951,1951,5.1
95429,Montreuil-sur-Epte,382,0,2415,2415,6.3
8089,Buzancy,381,0,9219,9219,24.2
14089,Bougy,381,0,674,674,1.8
14575,Saint-Étienne-la-Thillaye,381,0,6123,6123,16.1
17440,Ternant,381,0,10613,10613,27.9
19075,Espagnac,381,0,7230,7230,19
21193,Corgengoux,381,0,1657,1657,4.3
23263,Villard,381,0,11375,11375,29.9
35277,Saint-Gonlay,381,0,4377,4377,11.5
37044,La Celle-Guenand,381,1650,6614,8264,21.7
42273,Saint-Pierre-la-Noaille,381,0,9885,9885,25.9
43166,Saint-André-de-Chalencon,381,2580,34406,36986,97.1
52175,Donjeux,381,0,1411,1411,3.7
60633,Thieuloy-Saint-Antoine,381,0,1869,1869,4.9
62780,Sauchy-Cauchy,381,0,474,474,1.2
63157,Fayet-le-Château,381,0,3654,3654,9.6
64556,Vielleségure,381,0,10259,10259,26.9
66074,Eus,381,0,11411,11411,30
67467,Siewiller,381,2670,4776,7446,19.5
70277,Granges-le-Bourg,381,0,121,121,0.3
70577,Vouhenans,381,0,16748,16748,44
76299,Gerponville,381,7970,2472,10442,27.4
80202,Coisy,381,0,1485,1485,3.9
80341,Fourdrinoy,381,0,656,656,1.7
84011,Le Beaucet,381,0,12441,12441,32.7
86136,Lizant,381,0,8580,8580,22.5
87124,Rilhac-Lastours,381,3350,5164,8514,22.3
3099,Deux-Chaises,380,0,5837,5837,15.4
16316,Saint-Fort-sur-le-Né,380,1600,14218,15818,41.6
16375,Suaux,380,1945,7818,9763,25.7
18045,Chalivoy-Milon,380,0,3539,3539,9.3
2A062,Carbuccia,380,0,5187,5187,13.6
31556,Les Tourreilles,380,0,7871,7871,20.7
33375,Saint-Aubin-de-Branne,380,0,2651,2651,7
33418,Saint-Hilaire-de-la-Noaille,380,0,3094,3094,8.1
35230,Poilley,380,0,4653,4653,12.2
47305,Tayrac,380,0,8699,8699,22.9
51375,Montbré,380,0,6753,6753,17.8
57577,Reyersviller,380,0,8758,8758,23
62385,Grand-Rullecourt,380,0,3158,3158,8.3
67059,Bourg-Bruche,380,2999,27500,30499,80.3
68382,Zaessingue,380,0,7386,7386,19.4
70119,Chambornay-lès-Pin,380,0,257,257,0.7
73302,La Trinité,380,437,6796,7233,19
76155,Canehan,380,0,2404,2404,6.3
77525,Vinantes,380,0,289,289,0.8
79144,Juscorps,380,0,5121,5121,13.5
82054,Espalais,380,0,40828,40828,107.4
91131,Chalou-Moulineux,380,0,957,957,2.5
2063,Bellenglise,379,0,3434,3434,9.1
2179,Chéry-Chartreuve,379,0,747,747,2
2322,Fontaine-Notre-Dame,379,0,54168,54168,142.9
3203,Paray-le-Frésil,379,0,5102,5102,13.5
5001,Abriès-Ristolas,379,0,12322,12322,32.5
5147,Saint-Julien-en-Champsaur,379,0,25216,25216,66.5
11436,Villesèque-des-Corbières,379,0,583,583,1.5
14211,Culey-le-Patry,379,0,11458,11458,30.2
14218,Danestal,379,0,6091,6091,16.1
16263,Plassac-Rouffiac,379,0,9853,9853,26
16270,Pressignac,379,2894,7798,10692,28.2
21330,Labergement-Foigney,379,0,9,9,0
22073,La Harmoye,379,0,6011,6011,15.9
25070,Bolandoz,379,0,2762,2762,7.3
27079,Boissy-Lamberville,379,0,5836,5836,15.4
31314,Mancioux,379,0,20369,20369,53.7
32369,Sainte-Christie-d'Armagnac,379,0,252,252,0.7
39315,Marnoz,379,2715,8383,11098,29.3
45033,Boësses,379,0,2872,2872,7.6
46054,Caniac-du-Causse,379,0,2193,2193,5.8
51263,Fromentières,379,0,12177,12177,32.1
58231,Saint-Aubin-les-Forges,379,0,21390,21390,56.4
60293,Hadancourt-le-Haut-Clocher,379,2300,8323,10623,28
62639,Oppy,379,0,472,472,1.2
62878,Warlus,379,0,3149,3149,8.3
63020,Aurières,379,0,1186,1186,3.1
63297,Reignat,379,0,3635,3635,9.6
70275,Grandvelle-et-le-Perrenot,379,0,3174,3174,8.4
70439,Raze,379,0,974,974,2.6
71259,Ligny-en-Brionnais,379,0,10740,10740,28.3
73123,La Giettaz,379,0,8940,8940,23.6
76668,Saussay,379,0,835,835,2.2
82145,Puygaillard-de-Quercy,379,0,3076,3076,8.1
88091,Charmois-devant-Bruyères,379,0,497,497,1.3
91378,Mauchamps,379,0,2567,2567,6.8
2259,Dampleux,378,0,364,364,1
2799,Vierzy,378,0,1263,1263,3.3
25041,Bannans,378,0,5484,5484,14.5
27052,Le Bec-Hellouin,378,0,1630,1630,4.3
28167,Fruncé,378,0,1399,1399,3.7
29128,Loc-Eguiner,378,1140,2792,3932,10.4
36235,Veuil,378,0,4745,4745,12.6
37076,Cinais,378,0,20748,20748,54.9
38326,Prunières,378,0,3958,3958,10.5
47327,Xaintrailles,378,0,1833,1833,4.8
50473,Saint-Georges-d'Elle,378,0,5591,5591,14.8
53220,Saint-Georges-le-Fléchard,378,0,2704,2704,7.2
57167,Dalstein,378,0,5441,5441,14.4
57635,Schalbach,378,0,2461,2461,6.5
59500,Ribécourt-la-Tour,378,0,4913,4913,13
64440,Ozenx-Montestrucq,378,0,10178,10178,26.9
67398,Richtolsheim,378,0,7962,7962,21.1
68002,Altenach,378,0,5383,5383,14.2
71469,Saint-Pierre-le-Vieux,378,0,5137,5137,13.6
74228,Saint-Blaise,378,6928,6796,13724,36.3
76288,Freulleville,378,850,2391,3241,8.6
78391,Méricourt,378,0,3518,3518,9.3
80251,Doudelainville,378,0,1153,1153,3.1
80572,Morlancourt,378,0,423,423,1.1
88224,Hadigny-les-Verrières,378,0,9506,9506,25.1
2185,Chézy-en-Orxois,377,0,8714,8714,23.1
8355,Regniowez,377,0,9856,9856,26.1
9253,Sabarat,377,0,6705,6705,17.8
10373,Souligny,377,0,5384,5384,14.3
16009,Ambernac,377,2158,7756,9914,26.3
19047,Chartrier-Ferrière,377,2099,6017,8116,21.5
21596,Savouges,377,0,1808,1808,4.8
22330,Saint-Thélo,377,0,0,0,0
28208,Levainville,377,0,2188,2188,5.8
32054,Biran,377,0,13284,13284,35.2
35270,Saint-Georges-de-Gréhaigne,377,0,3206,3206,8.5
37112,Gizeux,377,0,3497,3497,9.3
38300,Penol,377,0,4113,4113,10.9
47053,Castella,377,0,2889,2889,7.7
47265,Saint-Pastour,377,0,3042,3042,8.1
49235,Parnay,377,0,3673,3673,9.7
50194,Fresville,377,0,11858,11858,31.5
50584,Subligny,377,0,9276,9276,24.6
51085,Le Breuil,377,0,546,546,1.4
51407,La Noue,377,0,4919,4919,13
53079,Couesmes-Vaucé,377,0,4971,4971,13.2
55031,Baudonvilliers,377,0,7369,7369,19.5
58256,Saint-Martin-sur-Nohain,377,0,7516,7516,19.9
59070,Bermeries,377,0,0,0,0
60378,Marest-sur-Matz,377,0,1916,1916,5.1
61482,Tessé-Froulay,377,32,4678,4710,12.5
62281,Echinghen,377,0,12744,12744,33.8
63136,Domaize,377,0,3407,3407,9
64127,Bielle,377,0,4785,4785,12.7
65121,Camalès,377,0,8516,8516,22.6
68083,Eschbach-au-Val,377,0,15133,15133,40.1
68211,Mitzach,377,0,3917,3917,10.4
71431,Saint-Jean-de-Trézy,377,0,8435,8435,22.4
76294,La Gaillarde,377,3544,2442,5986,15.9
76581,Saint-Germain-des-Essourts,377,0,258,258,0.7
76653,Saint-Vaast-Dieppedalle,377,4340,2442,6782,18
86257,Savigny-sous-Faye,377,0,8580,8580,22.8
91414,Monnerville,377,0,949,949,2.5
2098,Bonneil,376,0,8691,8691,23.1
3160,Marcenat,376,0,7691,7691,20.5
3287,Treban,376,0,5776,5776,15.4
3296,Valigny,376,0,5911,5911,15.7
18077,Couy,376,0,1298,1298,3.5
19001,Affieux,376,0,6547,6547,17.4
21574,Saint-Seine-sur-Vingeanne,376,0,1638,1638,4.4
24301,Nadaillac,376,3450,1439,4889,13
24489,Saint-Priest-les-Fougères,376,890,1241,2131,5.7
28245,Meslay-le-Grenet,376,0,10956,10956,29.1
33531,Tizac-de-Curton,376,0,7334,7334,19.5
40149,Lencouacq,376,0,4294,4294,11.4
40208,Onard,376,0,5889,5889,15.7
46010,Aujols,376,0,2114,2114,5.6
46011,Autoire,376,0,12267,12267,32.6
50013,Anneville-en-Saire,376,4529,11827,16356,43.5
50177,Étienville,376,0,2038,2038,5.4
52031,Autreville-sur-la-Renne,376,0,2062,2062,5.5
53259,Senonnes,376,0,2489,2489,6.6
54229,Glonville,376,0,1661,1661,4.4
55458,Saint-Jean-lès-Buzy,376,0,6792,6792,18.1
58077,Ciez,376,0,7496,7496,19.9
59097,Boursies,376,0,4887,4887,13
60198,Dives,376,0,3287,3287,8.7
60583,Saint-Léger-en-Bray,376,0,14744,14744,39.2
61151,Écorcei,376,4414,3876,8290,22
62800,Souastre,376,0,1869,1869,5
63243,Moureuille,376,0,584,584,1.6
64194,Coslédaà-Lube-Boast,376,0,3925,3925,10.4
64211,Eslourenties-Daban,376,0,3925,3925,10.4
68168,Knœringue,376,2259,7308,9567,25.4
71541,Torpes,376,0,46,46,0.1
77341,Noyen-sur-Seine,376,3500,5325,8825,23.5
77343,Ocquerre,376,0,5521,5521,14.7
80573,Morvillers-Saint-Saturnin,376,0,519,519,1.4
81024,Beauvais-sur-Tescou,376,0,20658,20658,54.9
87091,Maisonnais-sur-Tardoire,376,2971,165,3136,8.3
91069,Boigneville,376,0,13100,13100,34.8
2258,Dammard,375,0,361,361,1
2656,Roucy,375,0,1009,1009,2.7
9003,L'Aiguillon,375,0,3330,3330,8.9
9269,Saint-Martin-de-Caralp,375,0,10079,10079,26.9
11013,Argens-Minervois,375,0,5081,5081,13.5
18198,Saint-Ambroix,375,0,8854,8854,23.6
25111,Chalèze,375,1650,6607,8257,22
2B074,Casanova,375,0,6478,6478,17.3
40165,Luglon,375,0,2951,2951,7.9
46114,Frayssinet-le-Gélat,375,0,10606,10606,28.3
47150,Longueville,375,0,3880,3880,10.3
48126,Lachamp-Ribennes,375,1200,4417,5617,15
55501,Stainville,375,0,7330,7330,19.5
56238,Saint-Tugdual,375,0,11987,11987,32
63252,Neuville,375,0,3597,3597,9.6
67220,Ingenheim,375,350,12602,12952,34.5
71313,Monthelon,375,0,8390,8390,22.4
73210,Puygros,375,0,4767,4767,12.7
73217,Rotherens,375,300,6706,7006,18.7
76689,Thiétreville,375,0,2433,2433,6.5
77023,Barcy,375,0,5114,5114,13.6
80423,Havernas,375,0,645,645,1.7
89062,Carisey,375,1900,51,1951,5.2
90028,Courtelevant,375,0,2230,2230,5.9
3007,Arpheuilles-Saint-Priest,374,0,8803,8803,23.5
3061,Charmes,374,0,7650,7650,20.5
4097,La Javie,374,0,15676,15676,41.9
5003,Aiguilles,374,0,12159,12159,32.5
17432,Souméras,374,0,4416,4416,11.8
25490,Rigney,374,0,18642,18642,49.8
45002,Aillant-sur-Milleron,374,0,3835,3835,10.3
46140,Laburgade,374,0,2103,2103,5.6
53160,Montreuil-Poulay,374,0,13898,13898,37.2
55155,Dombasle-en-Argonne,374,0,3910,3910,10.5
59101,Bousignies-sur-Roc,374,0,13341,13341,35.7
59290,Haut-Lieu,374,0,2963,2963,7.9
60469,Novillers,374,0,1553,1553,4.2
62127,Bezinghem,374,0,22132,22132,59.2
62290,Écurie,374,0,10519,10519,28.1
67009,Altwiller,374,3714,4689,8403,22.5
73086,Cléry,374,0,8822,8822,23.6
76010,Ancretiéville-Saint-Victor,374,0,824,824,2.2
76327,Greuville,374,0,3018,3018,8.1
77026,Beauchery-Saint-Martin,374,0,1349,1349,3.6
80123,Bourdon,374,0,644,644,1.7
80663,Rambures,374,0,516,516,1.4
86091,Curzay-sur-Vonne,374,0,22283,22283,59.6
4106,Lurs,373,0,7575,7575,20.3
7272,Saint-Maurice-d'Ardèche,373,0,22777,22777,61.1
9038,La Bastide-de-Besplas,373,0,6634,6634,17.8
17023,Aujac,373,0,10390,10390,27.9
17139,Dœuil-sur-le-Mignon,373,0,10390,10390,27.9
24073,Calès,373,3455,1355,4810,12.9
24395,Saint-Cybranet,373,1149,639,1788,4.8
25253,Fourg,373,0,2718,2718,7.3
33269,Margueron,373,0,2816,2816,7.5
33549,Villenave-de-Rions,373,0,36828,36828,98.7
34043,Buzignargues,373,0,6950,6950,18.6
39205,Éclans-Nenon,373,1330,7570,8900,23.9
42298,Sauvain,373,0,3342,3342,9
47036,Bourlens,373,0,2149,2149,5.8
51059,Bignicourt-sur-Marne,373,0,5884,5884,15.8
51425,Passy-Grigny,373,0,540,540,1.4
54435,Prény,373,0,2227,2227,6
70529,Velet,373,0,1882,1882,5
71123,Chenay-le-Châtel,373,0,8358,8358,22.4
71175,Diconne,373,1976,697,2673,7.2
72235,Piacé,373,0,17557,17557,47.1
76328,Grigneuseville,373,0,255,255,0.7
79244,Saint-Cyr-la-Lande,373,0,5804,5804,15.6
80229,Crouy-Saint-Pierre,373,0,642,642,1.7
80288,Estrées-Deniécourt,373,0,6751,6751,18.1
87057,Dompierre-les-Églises,373,4150,6348,10498,28.1
89426,Val-de-Mercy,373,0,16842,16842,45.2
90011,Bermont,373,2300,13013,15313,41.1
16079,Chantillac,372,4550,19891,24441,65.7
21506,Premeaux-Prissey,372,0,1784,1784,4.8
22288,Saint-Étienne-du-Gué-de-l'Isle,372,0,0,0,0
23132,Montaigut-le-Blanc,372,0,6075,6075,16.3
24032,Beauronne,372,1758,2028,3786,10.2
24071,Bussière-Badil,372,3200,2493,5693,15.3
25387,Montandon,372,0,2591,2591,7
27415,Morainville-Jouveaux,372,0,5729,5729,15.4
28339,Saint-Germain-le-Gaillard,372,0,1376,1376,3.7
31013,Ardiège,372,0,3561,3561,9.6
31244,Juzet-de-Luchon,372,0,3561,3561,9.6
40049,Bordères-et-Lamensans,372,0,1738,1738,4.7
55426,Resson,372,0,4485,4485,12.1
62021,Alette,372,0,22013,22013,59.2
62333,Fiefs,372,0,8036,8036,21.6
63358,Saint-Hilaire-la-Croix,372,0,2454,2454,6.6
64389,Monassut-Audiracq,372,0,3883,3883,10.4
68124,Hausgauen,372,0,9979,9979,26.8
69182,Saint-Bonnet-des-Bruyères,372,0,0,0,0
79145,Lageon,372,0,9753,9753,26.2
89277,Nitry,372,318,51,369,1
89280,Nuits,372,500,864,1364,3.7
89360,Saint-Maurice-le-Vieil,372,2822,8798,11620,31.2
2192,Chouy,371,0,357,357,1
5071,Lardier-et-Valença,371,0,526,526,1.4
12219,Sainte-Eulalie-d'Olt,371,0,35137,35137,94.7
23026,Bord-Saint-Georges,371,0,5576,5576,15
23090,Gentioux-Pigerolles,371,0,14031,14031,37.8
23106,Lépaud,371,0,5576,5576,15
23162,Roches,371,0,998,998,2.7
27075,Bois-Normand-près-Lyre,371,0,10434,10434,28.1
2A312,Santa-Maria-Siché,371,0,278,278,0.7
30280,Saint-Laurent-le-Minier,371,0,5984,5984,16.1
34085,Coulobres,371,0,2149,2149,5.8
41102,Houssay,371,0,4589,4589,12.4
42173,Pommiers-en-Forez,371,1177,3063,4240,11.4
54496,Saulxures-lès-Vannes,371,0,12301,12301,33.2
57215,Flastroff,371,0,5341,5341,14.4
57444,Marange-Zondrange,371,0,17216,17216,46.4
60478,Ormoy-le-Davien,371,0,1453,1453,3.9
60687,Villers-sur-Auchy,371,0,3041,3041,8.2
62856,Villers-Brûlin,371,0,3083,3083,8.3
63461,Vinzelles,371,0,1704,1704,4.6
64134,Bonloc,371,38081,9641,47722,128.6
67426,Saint-Martin,371,3239,58846,62085,167.3
67454,Schœnbourg,371,2626,9997,12623,34
70154,Cirey,371,0,3107,3107,8.4
71339,Ozolles,371,0,1438,1438,3.9
71367,Ratte,371,0,1527,1527,4.1
71440,Saint-Léger-sous-Beuvray,371,0,8301,8301,22.4
76121,Bosc-Édeline,371,0,254,254,0.7
77052,Bréau,371,0,4776,4776,12.9
77412,Saint-Germain-sur-École,371,0,3089,3089,8.3
90021,Charmois,371,0,12943,12943,34.9
91035,Authon-la-Plaine,371,0,934,934,2.5
2042,Azy-sur-Marne,370,0,8552,8552,23.1
9262,Saint-Jean-d'Aigues-Vives,370,0,3286,3286,8.9
12110,Golinhac,370,0,1832,1832,5
23133,Montboucher,370,0,11601,11601,31.4
27613,Saint-Vincent-du-Boulay,370,0,5698,5698,15.4
30154,Mandagout,370,0,5968,5968,16.1
31502,Saint-Marcet,370,0,7664,7664,20.7
33178,Gajac,370,0,123,123,0.3
48081,Lanuéjols,370,7350,7498,14848,40.1
51471,Sacy,370,0,6576,6576,17.8
55433,Rigny-la-Salle,370,0,1493,1493,4
56139,Montertelot,370,0,5572,5572,15.1
60050,Bazicourt,370,0,541,541,1.5
60366,Litz,370,0,14509,14509,39.2
60515,Pronleroy,370,0,2050,2050,5.5
61300,Moutiers-au-Perche,370,860,4336,5196,14
64471,Saint-Boès,370,0,9963,9963,26.9
80601,Nurlu,370,0,2651,2651,7.2
83052,Esparron,370,0,3795,3795,10.3
86130,Leugny,370,0,8421,8421,22.8
95059,Berville,370,0,17000,17000,45.9
2464,Margival,369,0,728,728,2
3108,Échassières,369,0,7548,7548,20.5
5149,Saint-Léger-les-Mélèzes,369,0,24551,24551,66.5
9275,Saint-Quirc,369,0,1661,1661,4.5
10259,La Motte-Tilly,369,0,2280,2280,6.2
11028,Belcaire,369,0,4054,4054,11
17081,Chamouillac,369,0,4357,4357,11.8
33102,Casseuil,369,250,3004,3254,8.8
34218,Prades-sur-Vernazobre,369,0,2086,2086,5.7
38018,Auberives-en-Royans,369,0,5963,5963,16.2
39354,Montholier,369,1485,8162,9647,26.1
48064,Fournels,369,2400,13637,16037,43.5
50445,Saint-André-de-Bohon,369,0,2000,2000,5.4
51590,Vanault-les-Dames,369,0,2165,2165,5.9
52461,Sarrey,369,0,1693,1693,4.6
54213,Friauville,369,0,3426,3426,9.3
54277,Jeandelize,369,0,3426,3426,9.3
55144,Dammarie-sur-Saulx,369,0,7212,7212,19.5
55159,Dompcevrin,369,0,5438,5438,14.7
57051,Baronville,369,0,6301,6301,17.1
57282,Hagen,369,0,8984,8984,24.3
58270,Saint-Vérain,369,0,16662,16662,45.2
65073,Bazillac,369,0,8335,8335,22.6
67161,Gottenhouse,369,1700,26027,27727,75.1
71366,Ratenelle,369,0,2151,2151,5.8
72208,Montmirail,369,0,2251,2251,6.1
78163,Civry-la-Forêt,369,0,3700,3700,10
86234,Saint-Martin-l'Ars,369,0,14924,14924,40.4
88402,Roville-aux-Chênes,369,0,1841,1841,5
90018,Brebotte,369,0,2195,2195,5.9
3253,Saint-Pourçain-sur-Besbre,368,0,6356,6356,17.3
7096,Gluiras,368,560,1228,1788,4.9
9241,Rabat-les-Trois-Seigneurs,368,0,1421,1421,3.9
12030,Bouillac,368,0,3698,3698,10
14140,Castillon,368,0,2547,2547,6.9
16045,Birac,368,3085,13769,16854,45.8
16212,Massignac,368,1133,7571,8704,23.7
23238,Saint-Quentin-la-Chabanne,368,0,13918,13918,37.8
24505,Saint-Sulpice-d'Excideuil,368,3000,4627,7627,20.7
27498,Rouge-Perriers,368,0,1586,1586,4.3
27631,Thierville,368,0,8313,8313,22.6
2B010,Algajola,368,0,0,0,0
30201,Ponteils-et-Brésis,368,0,7458,7458,20.3
30204,Potelières,368,0,14936,14936,40.6
33364,Saillans,368,0,5539,5539,15.1
33486,Saint-Trojan,368,0,2078,2078,5.6
34208,Popian,368,0,1988,1988,5.4
38129,Corrençon-en-Vercors,368,0,43565,43565,118.4
39197,Digna,368,3125,5611,8736,23.7
45223,Nesploy,368,0,3773,3773,10.3
48105,Naussac-Fontanes,368,8330,3297,11627,31.6
51200,Cuis,368,0,7313,7313,19.9
51648,Vitry-la-Ville,368,0,614,614,1.7
52346,Mussey-sur-Marne,368,0,1363,1363,3.7
52440,Rouvroy-sur-Marne,368,0,1363,1363,3.7
54024,Arraye-et-Han,368,0,2178,2178,5.9
54202,Fontenoy-sur-Moselle,368,0,768,768,2.1
57014,Altrippe,368,0,6284,6284,17.1
58004,Alluy,368,0,18982,18982,51.6
59635,Wambaix,368,0,4783,4783,13
62485,Laires,368,0,32752,32752,89
62509,Liettres,368,0,6073,6073,16.5
63096,Chas,368,0,3530,3530,9.6
65303,Mascaras,368,0,2337,2337,6.4
65479,Visker,368,0,3516,3516,9.6
68214,Montreux-Jeune,368,0,5240,5240,14.2
76352,La Haye,368,0,6952,6952,18.9
79183,Montravers,368,0,10468,10468,28.4
80396,Gueschart,368,0,9113,9113,24.8
86118,Journet,368,0,14884,14884,40.4
86169,Morton,368,0,1880,1880,5.1
88324,La Neuveville-sous-Châtenois,368,0,4111,4111,11.2
89328,Rouvray,368,750,50,800,2.2
2154,Chacrise,367,0,1226,1226,3.3
3105,Droiturier,367,0,738,738,2
5153,Saint-Michel-de-Chaillol,367,0,24418,24418,66.5
8083,Brévilly,367,0,12993,12993,35.4
12108,Galgan,367,0,6304,6304,17.2
14270,Firfol,367,0,4085,4085,11.1
16412,Villejoubert,367,1290,4614,5904,16.1
19002,Aix,367,0,5031,5031,13.7
21398,Maxilly-sur-Saône,367,0,0,0,0
22271,Saint-Adrien,367,0,6572,6572,17.9
31090,Brignemont,367,0,3070,3070,8.4
33406,Saint-Genès-de-Castillon,367,0,14258,14258,38.9
38526,Vatilieu,367,0,5931,5931,16.2
40147,Laurède,367,0,5748,5748,15.7
45112,La Cour-Marigny,367,0,3763,3763,10.3
51384,Morangis,367,0,7293,7293,19.9
52178,Doulevant-le-Château,367,0,1359,1359,3.7
52189,Le Val-d'Esnoms,367,0,4545,4545,12.4
52470,Serqueux,367,0,7238,7238,19.7
54538,Uruffe,367,0,12168,12168,33.2
55014,Aubréville,367,5748,3837,9585,26.1
55060,Bonzée,367,0,4751,4751,12.9
55447,Rupt-aux-Nonains,367,0,7173,7173,19.5
57273,Guerstling,367,0,5283,5283,14.4
58032,Billy-sur-Oisy,367,0,7678,7678,20.9
60287,Grandrû,367,0,0,0,0
76193,La Crique,367,0,8573,8573,23.4
87170,Saint-Méard,367,532,171,703,1.9
2232,Coyolles,366,0,352,352,1
9236,Prayols,366,0,9837,9837,26.9
10203,Longchamp-sur-Aujon,366,0,0,0,0
10307,Prugny,366,0,5226,5226,14.3
11337,Saint-Couat-d'Aude,366,0,4959,4959,13.5
11438,Villesiscle,366,0,1084,1084,3
17013,Antezant-la-Chapelle,366,0,10195,10195,27.9
25431,Onans,366,0,844,844,2.3
25510,Ruffey-le-Château,366,0,247,247,0.7
36118,Méobecq,366,0,580,580,1.6
46237,Reyrevignes,366,0,10808,10808,29.5
47074,Couthures-sur-Garonne,366,0,3787,3787,10.3
50490,Saint-Jean-de-la-Rivière,366,5932,11512,17444,47.7
51417,Orconte,366,0,2274,2274,6.2
55348,Montiers-sur-Saulx,366,0,7154,7154,19.5
55382,Neuville-sur-Ornain,366,0,8123,8123,22.2
62172,Boyelles,366,0,10294,10294,28.1
64274,Irouléguy,366,0,9511,9511,26
65396,Saint-Savin,366,0,14987,14987,40.9
66218,Ur,366,0,0,0,0
67406,Rohr,366,0,6963,6963,19
68285,Rorschwihr,366,300,875,1175,3.2
70347,Mignavillers,366,0,116,116,0.3
73013,Albiez-Montrond,366,0,9829,9829,26.9
79271,Saint-Marc-la-Lande,366,6567,3017,9584,26.2
81045,Les Cabannes,366,0,9313,9313,25.4
88417,Saint-Gorgon,366,0,1826,1826,5
3250,Saint-Pierre-Laval,365,0,734,734,2
4220,Les Thuiles,365,0,109006,109006,298.6
6068,Gourdon,365,0,4423,4423,12.1
7001,Accons,365,4510,7804,12314,33.7
12165,Muret-le-Château,365,0,15061,15061,41.3
12178,Paulhe,365,0,3772,3772,10.3
15212,Saint-Santin-de-Maurs,365,2480,3200,5680,15.6
24425,Saint-Jean-de-Côle,365,2650,1204,3854,10.6
26290,Saint-Agnan-en-Vercors,365,0,22860,22860,62.6
27273,Gadencourt,365,0,1918,1918,5.3
28058,Bréchamps,365,0,2118,2118,5.8
28148,Le Favril,365,0,1350,1350,3.7
29282,Trébabu,365,3605,657,4262,11.7
31156,Cox,365,0,3053,3053,8.4
32204,Lavardens,365,0,12861,12861,35.2
33472,Saint-Sauveur-de-Puynormand,365,0,7120,7120,19.5
39572,Villette-lès-Arbois,365,100,8073,8173,22.4
41127,La Marolle-en-Sologne,365,0,3046,3046,8.3
41222,Saint-Loup,365,0,7691,7691,21.1
48010,Auroux,365,5000,3270,8270,22.7
53222,Saint-Germain-d'Anxure,365,0,13564,13564,37.2
54303,Laronxe,365,0,1613,1613,4.4
57298,Harreberg,365,0,2376,2376,6.5
60490,Pierrefitte-en-Beauvaisis,365,0,14313,14313,39.2
60655,Varesnes,365,0,0,0,0
63460,Villossanges,365,0,12343,12343,33.8
68077,Eglingen,365,0,5197,5197,14.2
68096,Franken,365,0,9791,9791,26.8
69054,Chénelette,365,0,4314,4314,11.8
70259,Froideterre,365,0,16045,16045,44
71109,Chassey-le-Camp,365,0,10036,10036,27.5
77454,Sognolles-en-Montois,365,3721,5169,8890,24.4
80427,Hem-Hardinval,365,0,1423,1423,3.9
2650,Rocquigny,364,0,6491,6491,17.8
3241,Saint-Léopardin-d'Augy,364,0,4900,4900,13.5
10019,Val-d'Auzon,364,0,1354,1354,3.7
12291,Verrières,364,0,6538,6538,18
13093,Saint-Estève-Janson,364,0,10231,10231,28.1
14393,Maizet,364,0,644,644,1.8
21347,Levernois,364,0,1583,1583,4.3
22261,Quintenic,364,1571,4393,5964,16.4
24522,Sarrazac,364,4995,4577,9572,26.3
25437,Osse,364,0,18144,18144,49.8
25553,Soye,364,0,840,840,2.3
28111,Coudray-au-Perche,364,0,142,142,0.4
30049,Bourdic,364,0,2797,2797,7.7
35262,Sainte-Colombe,364,0,7086,7086,19.5
39245,Gatey,364,2771,2156,4927,13.5
39474,Sainte-Agnès,364,700,0,700,1.9
40114,Gourbera,364,0,3116,3116,8.6
52037,Bannes,364,0,1670,1670,4.6
58225,Saincaize-Meauce,364,0,19578,19578,53.8
59031,Audignies,364,0,1027,1027,2.8
60274,Glaignes,364,0,1425,1425,3.9
61467,Semallé,364,2270,10757,13027,35.8
64344,Livron,364,0,3800,3800,10.4
76336,Gueutteville-les-Grès,364,0,2357,2357,6.5
76420,Mauquenchy,364,0,6876,6876,18.9
76677,Smermesnil,364,0,2687,2687,7.4
86105,Gizay,364,0,8317,8317,22.8
87194,Sussac,364,0,169,169,0.5
88212,Grand,364,0,4066,4066,11.2
89116,Cornant,364,150,1291,1441,4
2025,Artemps,363,0,51881,51881,142.9
2363,Guny,363,0,359,359,1
8451,Le Thour,363,0,6942,6942,19.1
9106,Dreuilhe,363,0,3224,3224,8.9
10227,Marolles-sous-Lignières,363,3045,6758,9803,27
11274,Pauligne,363,1425,4778,6203,17.1
17046,Bignay,363,0,10111,10111,27.9
24488,Saint-Pompon,363,1634,622,2256,6.2
25594,Velesmes-Essarts,363,0,6396,6396,17.6
26226,Le Pègue,363,0,9773,9773,26.9
33176,Gabarnac,363,0,11131,11131,30.7
37016,Azay-sur-Indre,363,0,6301,6301,17.4
43259,Vernassal,363,1590,15104,16694,46
47154,Lusignan-Petit,363,0,3487,3487,9.6
54206,Fraimbois,363,0,1604,1604,4.4
54491,Sancy,363,0,1599,1599,4.4
57187,Éblange,363,0,2186,2186,6
59443,Ochtezeele,363,0,2218,2218,6.1
62881,Beauvoir-Wavans,363,0,7842,7842,21.6
63370,Saint-Julien-Puy-Lavèze,363,0,1136,1136,3.1
63377,Saint-Maurice-près-Pionsat,363,0,563,563,1.6
67100,Donnenheim,363,0,4414,4414,12.2
67270,Lixhausen,363,3216,12199,15415,42.5
72314,Saint-Pierre-du-Lorouër,363,0,20470,20470,56.4
77013,Aulnoy,363,0,1414,1414,3.9
77098,Châteaubleau,363,0,4673,4673,12.9
80262,Eaucourt-sur-Somme,363,0,1107,1107,3
80588,Neufmoulin,363,0,1107,1107,3
1056,Boyeux-Saint-Jérôme,362,0,5187,5187,14.3
5008,Aspremont,362,0,13547,13547,37.4
9116,Escosse,362,0,1630,1630,4.5
11216,Malviès,362,3200,4765,7965,22
24199,Gout-Rossignol,362,3400,2749,6149,17
24453,Saint-Martin-de-Fressengeas,362,250,1194,1444,4
28375,Serville,362,0,484,484,1.3
39494,Saint-Pierre,362,2144,2578,4722,13
45102,Conflans-sur-Loing,362,0,4877,4877,13.5
52006,Allichamps,362,0,3279,3279,9.1
54236,Grand-Failly,362,0,4596,4596,12.7
55372,Nançois-sur-Ornain,362,0,4364,4364,12.1
57339,Hultehouse,362,0,726,726,2
58106,Dun-les-Places,362,0,4266,4266,11.8
62743,Sainte-Austreberthe,362,0,0,0,0
62804,Sus-Saint-Léger,362,0,3008,3008,8.3
70294,Lantenot,362,0,1339,1339,3.7
71470,Saint-Point,362,0,4919,4919,13.6
76093,Bézancourt,362,0,6838,6838,18.9
76590,Saint-Jacques-d'Aliermont,362,0,2290,2290,6.3
86004,Angles-sur-l'Anglin,362,0,8239,8239,22.8
88395,Romont,362,0,1806,1806,5
3028,Billezois,361,0,726,726,2
7014,Arlebosc,361,1935,15884,17819,49.4
12256,Salvagnac-Cajarc,361,0,10661,10661,29.5
17159,Fléac-sur-Seugne,361,0,4263,4263,11.8
21573,Saint-Seine-l'Abbaye,361,0,0,0,0
23197,Saint-Georges-la-Pouge,361,0,11319,11319,31.4
27171,Le Cormier,361,0,1897,1897,5.3
28107,Corancez,361,0,10519,10519,29.1
32416,Sarrant,361,0,1362,1362,3.8
32442,Terraube,361,0,205,205,0.6
36017,La Berthenoux,361,20885,7930,28815,79.8
40303,Solférino,361,0,2840,2840,7.9
42119,Leigneux,361,0,3234,3234,9
46321,Touzac,361,0,13126,13126,36.4
47134,Lannes,361,0,1750,1750,4.8
50251,Huberville,361,0,11355,11355,31.5
50376,Nicorps,361,0,10445,10445,28.9
52484,Suzannecourt,361,0,1337,1337,3.7
54012,Amance,361,0,2136,2136,5.9
57178,Diffembach-lès-Hellimer,361,0,6164,6164,17.1
59148,Clairfayts,361,0,2860,2860,7.9
61215,Laleu,361,5516,127,5643,15.6
65339,Orincles,361,0,3449,3449,9.6
67221,Ingolsheim,361,0,39776,39776,110.2
70271,Gouhenans,361,0,114,114,0.3
70402,Oyrières,361,0,1822,1822,5
71025,Beaubery,361,0,1400,1400,3.9
72221,Nogent-sur-Loir,361,0,20357,20357,56.4
76236,Envronville,361,0,2751,2751,7.6
80760,Tilloy-Floriville,361,0,7,7,0
81178,Montgaillard,361,0,19834,19834,54.9
81309,Vaour,361,0,9185,9185,25.4
86170,Moulismes,361,0,14601,14601,40.4
87061,Droux,361,2910,6144,9054,25.1
88276,Lusse,361,0,3510,3510,9.7
88379,Rehaincourt,361,0,9078,9078,25.1
89251,Merry-la-Vallée,361,0,8538,8538,23.7
89306,Pontaubert,361,1600,783,2383,6.6
2686,Saint-Paul-aux-Bois,360,0,356,356,1
5093,Névache,360,0,25681,25681,71.3
8206,Ham-les-Moines,360,0,5605,5605,15.6
15079,Jaleyrac,360,6300,6809,13109,36.4
16049,Bonnes,360,5477,16928,22405,62.2
21683,Viévy,360,0,11104,11104,30.8
21713,Vonges,360,0,0,0,0
22138,Maël-Pestivien,360,0,6446,6446,17.9
30231,Saint-André-de-Valborgne,360,0,18009,18009,50
38263,Morette,360,0,5818,5818,16.2
46076,Cornac,360,0,11745,11745,32.6
59216,Eswars,360,0,4679,4679,13
62702,Remilly-Wirquin,360,0,779,779,2.2
66185,Saint-Michel-de-Llotes,360,0,486,486,1.4
67527,Westhouse-Marmoutier,360,0,25392,25392,70.5
70046,Les Aynans,360,0,15825,15825,44
71050,Bourgvilain,360,0,4892,4892,13.6
76045,Auzouville-l'Esneval,360,0,794,794,2.2
79215,Pougne-Hérisson,360,0,9438,9438,26.2
81049,Cahuzac,360,0,7319,7319,20.3
81323,Viterbe,360,0,5384,5384,15
86149,Martaizé,360,0,1839,1839,5.1
87149,Saint-Hilaire-la-Treille,360,7270,6127,13397,37.2
91137,Champmotteux,360,0,907,907,2.5
95656,Vienne-en-Arthies,360,0,2276,2276,6.3
2831,Watigny,359,0,7047,7047,19.6
4141,Ongles,359,0,7291,7291,20.3
9174,Loubières,359,0,9649,9649,26.9
12134,Lugan,359,0,6166,6166,17.2
12189,Pradinas,359,0,10988,10988,30.6
12280,Thérondels,359,0,12165,12165,33.9
23155,Pontarion,359,0,11256,11256,31.4
25511,Rurey,359,0,2616,2616,7.3
26272,Rochefort-en-Valdaine,359,1500,3459,4959,13.8
27138,Chamblac,359,0,1548,1548,4.3
32134,Frégouville,359,0,25539,25539,71.1
33489,Saint-Vivien-de-Blaye,359,0,2009,2009,5.6
39032,Avignon-lès-Saint-Claude,359,0,1322,1322,3.7
51486,Saint-Hilaire-le-Grand,359,0,3378,3378,9.4
55340,Mognéville,359,0,7968,7968,22.2
55462,Saint-Maurice-sous-les-Côtes,359,0,4266,4266,11.9
61385,Saint-Evroult-de-Montfort,359,0,2595,2595,7.2
71243,Joudes,359,0,1478,1478,4.1
73323,Villaroger,359,0,7627,7627,21.2
76609,Sainte-Marie-au-Bosc,359,0,3238,3238,9
79154,Loubillé,359,1851,10368,12219,34
79309,Scillé,359,0,2959,2959,8.2
80568,Morchain,359,0,6843,6843,19.1
81087,Fayssac,359,0,19724,19724,54.9
82045,Cordes-Tolosannes,359,0,4611,4611,12.8
1090,Châtenay,358,0,75,75,0.2
2166,Chartèves,358,0,8275,8275,23.1
2210,Condé-sur-Aisne,358,0,706,706,2
2253,Cuisy-en-Almont,358,0,2995,2995,8.4
2759,La Vallée-au-Blé,358,0,6384,6384,17.8
7012,Arcens,358,3606,7654,11260,31.5
8136,Daigny,358,0,8224,8224,23
9099,Cos,358,0,9622,9622,26.9
12080,Coupiac,358,0,750,750,2.1
14078,Blay,358,0,2478,2478,6.9
16318,Saint-Front,358,0,4501,4501,12.6
19163,Le Pescher,358,0,1805,1805,5
21115,Buncey,358,0,5973,5973,16.7
25055,Berthelange,358,0,242,242,0.7
36174,Roussines,358,11047,7220,18267,51
37220,Saint-Germain-sur-Vienne,358,0,19650,19650,54.9
39317,La Marre,358,1600,9515,11115,31
40014,Arue,358,0,4089,4089,11.4
47090,Espiens,358,0,1736,1736,4.8
47271,Saint-Pierre-sur-Dropt,358,0,17635,17635,49.3
52401,Poulangy,358,0,39324,39324,109.8
53129,Launay-Villiers,358,0,15580,15580,43.5
55053,Billy-sous-Mangiennes,358,0,6543,6543,18.3
56156,Persquen,358,0,11443,11443,32
60077,Blicourt,358,0,1756,1756,4.9
62077,Bajus,358,0,5908,5908,16.5
63056,Brousse,358,4088,3235,7323,20.5
65271,Lézignan,358,0,3420,3420,9.6
68142,Hohrod,358,0,14371,14371,40.1
87159,Saint-Léger-la-Montagne,358,0,580,580,1.6
88033,Ban-de-Sapt,358,0,3481,3481,9.7
88140,Dombrot-le-Sec,358,0,2783,2783,7.8
89349,Saint-Léger-Vauban,358,1995,776,2771,7.7
1382,Sainte-Olive,357,0,74,74,0.2
18040,Bussy,357,1020,3325,4345,12.2
18143,Menetou-Couture,357,0,113,113,0.3
21300,Gissey-sur-Ouche,357,0,2008,2008,5.6
21610,Soissons-sur-Nacey,357,0,0,0,0
23020,Bellegarde-en-Marche,357,0,4687,4687,13.1
24374,Saint-Aubin-de-Lanquais,357,0,669,669,1.9
24565,Varaignes,357,800,2392,3192,8.9
25415,Mouthier-Haute-Pierre,357,0,2602,2602,7.3
30345,La Vernarède,357,0,11159,11159,31.3
35203,La Nouaye,357,0,4102,4102,11.5
36012,Baraize,357,0,2621,2621,7.3
43158,Queyrières,357,0,1980,1980,5.5
45207,Mignerette,357,0,3502,3502,9.8
46120,Gindou,357,0,10097,10097,28.3
46195,Molières,357,0,10542,10542,29.5
54086,Boucq,357,0,745,745,2.1
55508,Thonne-la-Long,357,0,12763,12763,35.8
59003,Aibes,357,0,12734,12734,35.7
62380,Gouy-Servins,357,0,9618,9618,26.9
62421,Havrincourt,357,0,1775,1775,5
68014,Aubure,357,0,853,853,2.4
68148,Hundsbach,357,0,9577,9577,26.8
70167,Conflandey,357,0,2120,2120,5.9
72083,Chevillé,357,0,3244,3244,9.1
77325,Mouy-sur-Seine,357,820,5056,5876,16.5
88326,Neuvillers-sur-Fave,357,0,3471,3471,9.7
2450,Macquigny,356,0,1962,1962,5.5
9054,Betchat,356,0,43140,43140,121.2
10083,Chappes,356,0,6214,6214,17.5
11382,Souilhanels,356,0,3128,3128,8.8
14379,Longvillers,356,0,13201,13201,37.1
19025,Beyssenac,356,0,3424,3424,9.6
23102,Ladapeyre,356,0,5351,5351,15
24027,Bayac,356,2209,1293,3502,9.8
27368,Lignerolles,356,0,4187,4187,11.8
38186,Gresse-en-Vercors,356,0,9973,9973,28
39167,Cosges,356,850,9462,10312,29
44105,Mouais,356,0,5971,5971,16.8
45132,Égry,356,0,2698,2698,7.6
46186,Masclat,356,0,11615,11615,32.6
46328,Varaire,356,0,2001,2001,5.6
47279,Saint-Sixte,356,0,8150,8150,22.9
57280,Guntzviller,356,0,714,714,2
60087,Borest,356,0,0,0,0
60268,Gannes,356,0,1972,1972,5.5
61348,Réveillon,356,6400,1250,7650,21.5
64473,Sainte-Colome,356,1750,4519,6269,17.6
68378,Wolfersdorf,356,0,5069,5069,14.2
71316,Montmelard,356,0,4838,4838,13.6
73028,La Balme,356,0,2259,2259,6.3
78558,Saint-Illiers-la-Ville,356,0,1820,1820,5.1
86182,Orches,356,0,8102,8102,22.8
2489,Molinchart,355,0,13557,13557,38.2
12054,La Capelle-Bleys,355,0,8236,8236,23.2
22033,Caurel,355,0,0,0,0
22263,Le Quiou,355,0,9457,9457,26.6
22370,Tréméven,355,0,7189,7189,20.3
22381,Trézény,355,0,7052,7052,19.9
23199,Saint-Germain-Beaupré,355,0,6719,6719,18.9
27466,Le Plessis-Sainte-Opportune,355,0,1530,1530,4.3
34102,Fontanès,355,0,6615,6615,18.6
36137,Néons-sur-Creuse,355,0,1951,1951,5.5
39072,Bracon,355,1930,7852,9782,27.6
59076,Bettignies,355,0,12663,12663,35.7
63287,Les Pradeaux,355,0,2308,2308,6.5
64092,Banca,355,0,9225,9225,26
67162,Gottesheim,355,4284,25039,29323,82.6
71165,Cussy-en-Morvan,355,0,7943,7943,22.4
74091,La Côte-d'Arbroz,355,0,24806,24806,69.9
77434,Saint-Sauveur-lès-Bray,355,4450,5027,9477,26.7
81050,Cambon-lès-Lavaur,355,0,395,395,1.1
88166,Évaux-et-Ménil,355,0,5102,5102,14.4
89212,Jussy,355,200,6945,7145,20.1
2189,Chivres-en-Laonnois,354,0,953,953,2.7
3148,Loriges,354,0,7241,7241,20.5
17234,Migré,354,0,9860,9860,27.9
18184,Précy,354,0,1222,1222,3.5
18220,Saint-Léger-le-Petit,354,0,1222,1222,3.5
26349,Tersanne,354,0,5827,5827,16.5
34291,Saint-Vincent-d'Olargues,354,0,1340,1340,3.8
35077,Chelun,354,0,6891,6891,19.5
42054,Châtelneuf,354,0,3172,3172,9
46290,Saint-Projet,354,0,10594,10594,29.9
53179,Placé,354,0,13155,13155,37.2
54567,Villacourt,354,0,1463,1463,4.1
55271,Laheycourt,354,0,7857,7857,22.2
59277,Gussignies,354,0,999,999,2.8
62387,Grévillers,354,0,1760,1760,5
66126,Oms,354,0,4745,4745,13.4
68330,Strueth,354,0,5041,5041,14.2
70494,Sornay,354,0,239,239,0.7
71210,Fuissé,354,0,9042,9042,25.5
76439,Mirville,354,0,2698,2698,7.6
76632,Saint-Pierre-Bénouville,354,0,2857,2857,8.1
80088,Bernes,354,0,2536,2536,7.2
86054,Champniers,354,0,7972,7972,22.5
87109,Oradour-Saint-Genest,354,4050,6025,10075,28.5
2228,Courtemont-Varennes,353,0,8159,8159,23.1
6141,Toudon,353,0,7955,7955,22.5
9120,Fabas,353,0,42776,42776,121.2
21512,Puligny-Montrachet,353,0,1535,1535,4.3
27220,Épieds,353,0,4152,4152,11.8
27689,Villegats,353,0,1855,1855,5.3
28419,Vitray-en-Beauce,353,0,10286,10286,29.1
32152,Haget,353,1500,781,2281,6.5
32406,Saint-Sauvy,353,0,4484,4484,12.7
34020,Azillanet,353,0,1336,1336,3.8
34177,Murles,353,1500,6577,8077,22.9
36185,Saint-Christophe-en-Bazelle,353,0,357,357,1
37187,Ports-sur-Vienne,353,0,9578,9578,27.1
41119,Lorges,353,0,1063,1063,3
46123,Girac,353,0,11517,11517,32.6
46154,Laramière,353,0,1030,1030,2.9
50181,Feugères,353,0,7376,7376,20.9
50290,Marcilly,353,0,8685,8685,24.6
50507,Saint-Marcouf,353,0,11103,11103,31.5
51487,Saint-Hilaire-le-Petit,353,0,6273,6273,17.8
54289,Laître-sous-Amance,353,0,2089,2089,5.9
57438,Malroy,353,0,717,717,2
58074,Chiddes,353,0,18208,18208,51.6
62122,Beugny,353,0,1755,1755,5
62314,Estrée-Cauchy,353,0,5825,5825,16.5
65473,Villelongue,353,0,14455,14455,40.9
66052,Codalet,353,0,10572,10572,29.9
67037,Biblisheim,353,3158,8541,11699,33.1
72078,Chérancé,353,0,16616,16616,47.1
76009,Ancourteville-sur-Héricourt,353,0,2286,2286,6.5
88197,Gerbamont,353,0,2757,2757,7.8
88203,Girecourt-sur-Durbion,353,0,463,463,1.3
90002,Angeot,353,2420,12315,14735,41.7
2019,Annois,352,0,50309,50309,142.9
2615,Pontruet,352,0,3189,3189,9.1
3097,Deneuille-les-Mines,352,0,12575,12575,35.7
9187,Mercenac,352,0,42655,42655,121.2
11052,Brousses-et-Villaret,352,0,4547,4547,12.9
14588,Saint-Germain-Langot,352,0,5514,5514,15.7
24050,Borrèze,352,4170,1347,5517,15.7
24059,Bourgnac,352,2000,16855,18855,53.6
24273,Molières,352,14800,1279,16079,45.7
25333,Laviron,352,0,4158,4158,11.8
25617,Villars-sous-Dampjoux,352,0,22283,22283,63.3
30309,Sardan,352,0,732,732,2.1
36078,Fougerolles,352,0,1032,1032,2.9
38527,Vaujany,352,0,20021,20021,56.9
41054,Choussy,352,0,6468,6468,18.4
57251,Goin,352,0,13480,13480,38.3
57689,Valmestroff,352,0,2255,2255,6.4
59296,Hecq,352,0,993,993,2.8
60541,Roberval,352,0,514,514,1.5
63366,Saint-Jean-en-Val,352,0,2288,2288,6.5
67509,Volksberg,352,670,4413,5083,14.4
70381,Neurey-lès-la-Demie,352,0,1127,1127,3.2
71234,Huilly-sur-Seille,352,0,2052,2052,5.8
72041,Bouër,352,0,2147,2147,6.1
73040,Bessans,352,0,6219,6219,17.7
73048,Bonvillard,352,0,8303,8303,23.6
76225,Écretteville-lès-Baons,352,0,651,651,1.8
77007,Argentières,352,0,334,334,0.9
79092,Clavé,352,0,2901,2901,8.2
80293,Ételfay,352,0,425,425,1.2
88183,Frebécourt,352,0,3932,3932,11.2
2288,Essigny-le-Petit,351,0,50166,50166,142.9
2302,Faverolles,351,0,338,338,1
2587,Parfondru,351,0,13405,13405,38.2
7218,Saint-Basile,351,1726,10049,11775,33.5
8318,La Neuville-aux-Joûtes,351,0,9176,9176,26.1
8388,Saint-Marceau,351,0,7699,7699,21.9
16253,Paizay-Naudouin-Embourie,351,830,7683,8513,24.3
19150,Noailhac,351,0,1770,1770,5
25255,Fournet-Blancheroche,351,0,2445,2445,7
27187,Criquebeuf-la-Campagne,351,0,1510,1510,4.3
2A270,Sari-d'Orcino,351,0,1617,1617,4.6
32254,Miramont-d'Astarac,351,0,777,777,2.2
33086,Camiac-et-Saint-Denis,351,0,34655,34655,98.7
37207,Saint-Aubin-le-Dépeint,351,0,3896,3896,11.1
39266,Les Hays,351,470,2079,2549,7.3
39546,Vaudrey,351,0,3399,3399,9.7
46211,Nuzéjouls,351,0,2964,2964,8.4
52365,Orges,351,0,1925,1925,5.5
52442,Rupt,351,0,1300,1300,3.7
60613,Senots,351,2347,7708,10055,28.6
61129,Courgeon,351,3810,1232,5042,14.4
62686,Ramecourt,351,0,7583,7583,21.6
63086,La Chapelle-Agnon,351,5500,3172,8672,24.7
63189,Laqueuille,351,0,1099,1099,3.1
64530,Susmiou,351,0,7337,7337,20.9
65159,Escala,351,0,1048,1048,3
71247,Jully-lès-Buxy,351,0,5384,5384,15.3
72009,Arthezé,351,0,2544,2544,7.2
77003,Amponville,351,0,179,179,0.5
77019,Balloy,351,1400,4971,6371,18.2
77267,La Madeleine-sur-Loing,351,0,370,370,1.1
77282,Mauregard,351,0,4353,4353,12.4
78528,Rolleboise,351,0,3267,3267,9.3
79354,Vouhé,351,0,2893,2893,8.2
4144,La Palud-sur-Verdon,350,6680,12376,19056,54.4
8406,Savigny-sur-Aisne,350,0,8469,8469,24.2
10199,Loches-sur-Ource,350,0,6110,6110,17.5
10351,Saint-Martin-de-Bossenay,350,0,0,0,0
11252,Montmaur,350,7600,3075,10675,30.5
14466,Norolles,350,0,5625,5625,16.1
16298,Saint-Amant-de-Nouère,350,2780,24263,27043,77.3
16336,Saint-Mary,350,1838,7201,9039,25.8
22231,Plourac'h,350,0,6267,6267,17.9
24300,Nabirat,350,818,599,1417,4
27383,Mandres,350,0,9843,9843,28.1
27514,Saint-Aubin-du-Thenney,350,0,1509,1509,4.3
2B229,Pietroso,350,0,0,0,0
32200,Lasséran,350,0,4131,4131,11.8
35242,Rimou,350,0,10729,10729,30.7
40042,Biarrotte,350,0,9941,9941,28.4
53196,Saint-Aignan-de-Couptrain,350,0,3113,3113,8.9
54175,Einvaux,350,0,1446,1446,4.1
54264,Houdelmont,350,0,0,0,0
57738,Waldhouse,350,0,8066,8066,23
60339,Lafraye,350,0,13725,13725,39.2
60605,Sarnois,350,0,1717,1717,4.9
62640,Orville,350,0,2908,2908,8.3
64070,Astis,350,0,5480,5480,15.7
71252,Lalheue,350,0,4240,4240,12.1
73133,Hauteville,350,0,6259,6259,17.9
74291,Vanzy,350,0,8454,8454,24.2
76667,Sauqueville,350,0,4254,4254,12.2
80694,Sailly-le-Sec,350,0,46,46,0.1
86055,La Chapelle-Bâton,350,0,7882,7882,22.5
95422,Montgeroult,350,0,16081,16081,45.9
12284,Le Truel,349,0,6269,6269,18
15095,Laroquevieille,349,1415,11825,13240,37.9
21255,Étaules,349,0,0,0,0
24154,Douchapt,349,6925,2650,9575,27.4
24473,Sainte-Orse,349,0,6104,6104,17.5
27662,Triqueville,349,0,7883,7883,22.6
2B277,Serra-di-Fiumorbo,349,0,0,0,0
31576,Vieillevigne,349,0,1702,1702,4.9
32234,Marestaing,349,0,24827,24827,71.1
35342,Trémeheuc,349,0,4369,4369,12.5
36153,Paulnay,349,0,1730,1730,5
38333,Rencurel,349,0,5640,5640,16.2
49012,Aubigné-sur-Layon,349,0,6928,6928,19.9
50183,Fierville-les-Mines,349,0,10978,10978,31.5
50387,Orglandes,349,0,10978,10978,31.5
50462,Saint-Cyr-du-Bailleul,349,0,8587,8587,24.6
51225,Écueil,349,0,6202,6202,17.8
51477,Saint-Étienne-sur-Suippe,349,0,6202,6202,17.8
57304,Haut-Clocher,349,0,2272,2272,6.5
62236,Contes,349,0,5526,5526,15.8
70504,Traves,349,0,897,897,2.6
71493,Saisy,349,1530,7808,9338,26.8
86280,Vellèches,349,0,7943,7943,22.8
88111,Coinches,349,0,3393,3393,9.7
88524,Vrécourt,349,0,123,123,0.4
1257,Montanges,348,0,4191,4191,12
2224,Courcelles-sur-Vesle,348,0,686,686,2
2644,Retheuil,348,0,335,335,1
2826,Voulpaix,348,0,6206,6206,17.8
14453,Mosles,348,0,2409,2409,6.9
14709,Tracy-sur-Mer,348,0,13413,13413,38.5
19048,Le Chastang,348,0,6603,6603,19
22029,Canihuel,348,0,32046,32046,92.1
23248,Saint-Victor-en-Marche,348,0,5683,5683,16.3
28259,Montboissier,348,0,640,640,1.8
37160,Morand,348,3455,1527,4982,14.3
39456,Relans,348,760,9250,10010,28.8
43047,Chadron,348,0,1930,1930,5.5
46184,Marminiac,348,0,9842,9842,28.3
49053,Brossay,348,7262,3391,10653,30.6
51140,Chaumuzy,348,0,6185,6185,17.8
54144,Crévéchamps,348,0,1438,1438,4.1
57581,Richeling,348,0,4756,4756,13.7
58249,Saint-Léger-de-Fougeret,348,0,4101,4101,11.8
60568,Saint-Aubin-sous-Erquery,348,650,1846,2496,7.2
60671,Versigny,348,0,1363,1363,3.9
61051,Boitron,348,17412,2183,19595,56.3
61408,Sainte-Honorine-la-Guillaume,348,0,1986,1986,5.7
63330,Saint-Cirgues-sur-Couze,348,0,0,0,0
64489,Saint-Martin-d'Arberoue,348,0,9043,9043,26
65282,Loudenvielle,348,0,16730,16730,48.1
70157,Clairegoutte,348,0,590,590,1.7
73294,La Thuile,348,0,4423,4423,12.7
76025,Argueil,348,0,6574,6574,18.9
76176,Clasville,348,0,2254,2254,6.5
76357,Hermeville,348,0,3139,3139,9
84057,Joucas,348,0,7093,7093,20.4
89108,Chitry,348,0,6808,6808,19.6
89452,Villecien,348,600,2728,3328,9.6
2714,Sermoise,347,0,2903,2903,8.4
15157,Quézac,347,2680,3043,5723,16.5
17383,Saint-Pierre-de-Juillers,347,0,9665,9665,27.9
23167,Sannat,347,0,4556,4556,13.1
24373,Saint-Aubin-de-Cadelech,347,2094,650,2744,7.9
27096,Les Bottereaux,347,0,9759,9759,28.1
27337,Heuqueville,347,0,1823,1823,5.3
27437,Nojeon-en-Vexin,347,0,283,283,0.8
28073,Champseru,347,0,10111,10111,29.1
28326,Saint-Avit-les-Guespières,347,0,1284,1284,3.7
30244,Saint-Clément,347,0,25813,25813,74.4
33511,Sendets,347,0,115,115,0.3
36226,Tranzault,347,0,1018,1018,2.9
37126,Lerné,347,0,19047,19047,54.9
38211,Lieudieu,347,0,3786,3786,10.9
38252,Montchaboud,347,0,13405,13405,38.6
38470,La Salle-en-Beaumont,347,0,3633,3633,10.5
40098,Eyres-Moncube,347,0,8017,8017,23.1
46051,Cambes,347,0,10247,10247,29.5
50210,Gorges,347,0,7250,7250,20.9
51313,Lachy,347,0,4528,4528,13
52510,Vaux-sur-Blaise,347,0,3143,3143,9.1
53165,Niafles,347,0,2297,2297,6.6
57721,Vilsberg,347,0,696,696,2
60305,Hautefontaine,347,0,2350,2350,6.8
62198,Cambligneul,347,0,2883,2883,8.3
62601,Nédonchel,347,0,7496,7496,21.6
73280,Saint-Sorlin-d'Arves,347,0,9318,9318,26.9
86229,Saint-Léger-de-Montbrillais,347,0,1773,1773,5.1
95258,Frouville,347,0,9159,9159,26.4
8038,Avançon,346,0,6617,6617,19.1
12062,Castelnau-Pégayrols,346,0,6215,6215,18
16084,Charras,346,3380,6170,9550,27.6
17261,Neuvicq-le-Château,346,0,9638,9638,27.9
17321,Saint-Crépin,346,0,14316,14316,41.4
40185,Miramont-Sensacq,346,0,7994,7994,23.1
46219,Peyrilles,346,0,10355,10355,29.9
51378,Monthelon,346,0,6876,6876,19.9
51548,Somme-Vesle,346,0,578,578,1.7
58196,Nolay,346,0,1734,1734,5
60269,Gaudechart,346,0,1698,1698,4.9
61400,Saint-Gervais-du-Perron,346,8865,2171,11036,31.9
63030,Bas-et-Lezat,346,570,1414,1984,5.7
65119,Caixon,346,0,7816,7816,22.6
65307,Mazères-de-Neste,346,0,2264,2264,6.5
68136,Hettenschlag,346,0,6005,6005,17.4
72184,Mareil-en-Champagne,346,0,3144,3144,9.1
72234,Pezé-le-Robert,346,0,6750,6750,19.5
72283,Saint-Germain-d'Arcé,346,0,1735,1735,5
77236,Jaulnes,346,1640,4900,6540,18.9
77289,Melz-sur-Seine,346,0,1248,1248,3.6
80114,Bosquel,346,0,478,478,1.4
80167,Canchy,346,0,8568,8568,24.8
80566,Fieffes-Montrelet,346,0,1349,1349,3.9
81160,Massaguel,346,0,385,385,1.1
82035,Caumont,346,0,4444,4444,12.8
83044,Comps-sur-Artuby,346,0,4310,4310,12.5
86287,Vézières,346,0,1767,1767,5.1
2029,Attilly,345,0,3126,3126,9.1
4222,Turriers,345,5439,10285,15724,45.6
12053,La Capelle-Balaguier,345,0,1006,1006,2.9
19222,Saint-Martin-la-Méanne,345,0,1024,1024,3
27001,Aclou,345,0,1487,1487,4.3
28037,Bérou-la-Mulotière,345,0,461,461,1.3
28178,Germainville,345,0,461,461,1.3
28319,Rouvray-Saint-Denis,345,0,1812,1812,5.3
32091,Castin,345,0,12156,12156,35.2
32122,Esclassan-Labastide,345,0,4072,4072,11.8
32394,Saint-Médard,345,0,764,764,2.2
33079,Cadarsac,345,0,6730,6730,19.5
40154,Lévignacq,345,0,2808,2808,8.1
45225,La Neuville-sur-Essonne,345,0,2615,2615,7.6
49102,Cléré-sur-Layon,345,0,14336,14336,41.6
50352,Montreuil-sur-Lozon,345,0,5103,5103,14.8
53164,Neuilly-le-Vendin,345,0,3068,3068,8.9
58007,Annay,345,0,6878,6878,19.9
59233,Flaumont-Waudrechies,345,0,2733,2733,7.9
62088,Bayenghem-lès-Seninghem,345,0,746,746,2.2
65055,Ayros-Arbouix,345,0,14127,14127,40.9
67144,Fouday,345,0,24967,24967,72.4
68340,Ueberstrass,345,0,4913,4913,14.2
79297,Sainte-Soline,345,0,9964,9964,28.9
80553,Molliens-au-Bois,345,0,1345,1345,3.9
81193,Nages,345,0,6103,6103,17.7
82147,Puylagarde,345,0,4879,4879,14.1
89434,Vaumort,345,3030,669,3699,10.7
5056,Forest-Saint-Julien,344,0,22887,22887,66.5
12003,Les Albres,344,0,5909,5909,17.2
12115,L'Hospitalet-du-Larzac,344,0,14730,14730,42.8
14411,Meslay,344,0,10400,10400,30.2
19256,Sérandon,344,11790,4716,16506,48
21331,Labergement-lès-Auxonne,344,0,0,0,0
27400,Merey,344,0,1808,1808,5.3
27564,Saint-Mards-de-Fresne,344,0,5297,5297,15.4
27625,Suzay,344,0,1808,1808,5.3
32207,Leboulin,344,0,12121,12121,35.2
33493,Saint-Yzans-de-Médoc,344,0,3025,3025,8.8
37223,Saint-Laurent-de-Lin,344,0,3191,3191,9.3
38106,Cholonge,344,0,3602,3602,10.5
43092,Fay-sur-Lignon,344,0,1908,1908,5.5
46336,Vire-sur-Lot,344,0,12508,12508,36.4
47277,Saint-Sauveur-de-Meilhan,344,0,3559,3559,10.3
50176,L'Étang-Bertrand,344,0,10820,10820,31.5
50525,Saint-Michel-de-Montjoie,344,0,8464,8464,24.6
51107,Chaintrix-Bierges,344,0,6836,6836,19.9
51192,Courthiézy,344,0,498,498,1.4
52282,Leffonds,344,0,1886,1886,5.5
54192,Ferrières,344,0,2737,2737,8
59050,Bas-Lieu,344,0,2725,2725,7.9
59100,Bousignies,344,0,12942,12942,37.6
60112,Brunvillers-la-Motte,344,0,1906,1906,5.5
64066,Ascarat,344,0,8939,8939,26
67088,Dehlingen,344,3590,4313,7903,23
67381,Puberg,344,633,9270,9903,28.8
76156,Canouville,344,0,2228,2228,6.5
80479,Lignières-Châtelain,344,0,475,475,1.4
89347,Saint-Germain-des-Champs,344,3600,746,4346,12.6
90031,Cunelières,344,0,12001,12001,34.9
1432,Verjon,343,0,6631,6631,19.3
2211,Condé-sur-Suippe,343,0,923,923,2.7
5007,Arvieux,343,0,11151,11151,32.5
8153,Escombres-et-le-Chesnois,343,0,12144,12144,35.4
10121,Dampierre,343,0,292,292,0.9
16141,Fontenille,343,850,4312,5162,15
21057,Beire-le-Fort,343,0,8,8,0
23246,Saint-Sulpice-les-Champs,343,0,12972,12972,37.8
24097,Champagne-et-Fontaine,343,5400,2605,8005,23.3
27232,Farceaux,343,0,279,279,0.8
27382,Mandeville,343,0,10172,10172,29.7
36234,Verneuil-sur-Igneraie,343,0,7534,7534,22
39188,Dammartin-Marpain,343,905,5413,6318,18.4
46030,Bio,343,0,11191,11191,32.6
47130,Lagruère,343,0,3549,3549,10.3
49161,La Jaille-Yvon,343,0,9941,9941,29
50069,Bourguenolles,343,0,5796,5796,16.9
53112,Le Ham,343,0,3050,3050,8.9
54570,Villecey-sur-Mad,343,0,2048,2048,6
58138,Langeron,343,0,2293,2293,6.7
59047,Banteux,343,0,4458,4458,13
60095,Boury-en-Vexin,343,1492,7532,9024,26.3
62315,Estréelles,343,0,3649,3649,10.6
62850,Vieil-Hesdin,343,0,5431,5431,15.8
65265,Laslades,343,0,2178,2178,6.3
67029,Berg,343,490,4300,4790,14
70344,Meurcourt,343,0,1269,1269,3.7
71012,Artaix,343,0,7685,7685,22.4
76747,Virville,343,0,4062,4062,11.8
77253,Lissy,343,0,4779,4779,13.9
79203,Pas-de-Jeu,343,0,5337,5337,15.6
80548,Millencourt-en-Ponthieu,343,0,8494,8494,24.8
90025,Chavannes-les-Grands,343,0,2040,2040,5.9
2461,Marest-Dampcourt,342,0,6145,6145,18
8022,Arreux,342,0,7856,7856,23
8124,Clavy-Warby,342,0,7501,7501,21.9
8164,Falaise,342,0,8275,8275,24.2
9305,Tabre,342,0,3037,3037,8.9
10131,Droupt-Saint-Basle,342,0,352,352,1
11383,Souilhe,342,6950,3005,9955,29.1
12191,Privezac,342,0,5874,5874,17.2
12207,Rullac-Saint-Cirq,342,0,18663,18663,54.6
28032,Beauvilliers,342,0,1796,1796,5.3
2B165,Moncale,342,0,0,0,0
33512,Sigalens,342,0,114,114,0.3
34292,Salasc,342,0,390,390,1.1
40011,Arsague,342,0,929,929,2.7
40221,Perquie,342,0,3267,3267,9.6
46199,Montcabrier,342,0,12435,12435,36.4
50172,Émondeville,342,0,10757,10757,31.5
51037,Baslieux-lès-Fismes,342,0,6078,6078,17.8
54360,Ménil-la-Tour,342,0,713,713,2.1
61327,Pervenchères,342,1652,1201,2853,8.3
63208,Marcillat,342,0,2256,2256,6.6
71526,Solutré-Pouilly,342,0,8736,8736,25.5
76396,Longuerue,342,0,234,234,0.7
77225,La Haute-Maison,342,0,1332,1332,3.9
80142,Briquemesnil-Floxicourt,342,0,472,472,1.4
80246,Dommartin,342,0,2101,2101,6.1
80273,Éplessier,342,0,472,472,1.4
86008,Arçay,342,0,1747,1747,5.1
88237,Hennecourt,342,0,4915,4915,14.4
2372,Hartennes-et-Taux,341,0,1139,1139,3.3
2639,Remigny,341,0,0,0,0
8162,Fagnon,341,0,7833,7833,23
14497,Perrières,341,0,5342,5342,15.7
16249,Oradour-Fanais,341,1892,7016,8908,26.1
21714,Vosne-Romanée,341,0,1635,1635,4.8
26024,Barcelonne,341,2900,6912,9812,28.8
29114,Lannéanou,341,855,20446,21301,62.5
2B335,Valle-di-Campoloro,341,0,2447,2447,7.2
31310,Lux,341,0,1663,1663,4.9
31388,Montpitol,341,0,3825,3825,11.2
38356,Saint-André-en-Royans,341,0,5511,5511,16.2
41141,Moisy,341,0,1732,1732,5.1
43256,Venteuges,341,0,3105,3105,9.1
46283,Saint-Michel-de-Bannières,341,0,11125,11125,32.6
47093,Fargues-sur-Ourbise,341,0,5754,5754,16.9
49067,Chenillé-Champteussé,341,0,9883,9883,29
49334,Sermaise,341,0,2609,2609,7.7
50117,Champeaux,341,0,8253,8253,24.2
51092,Broyes,341,0,4449,4449,13
51596,Vauchamps,341,0,10956,10956,32.1
57180,Dolving,341,0,2220,2220,6.5
59498,Reumont,341,0,2343,2343,6.9
59531,Saint-Benin,341,0,2343,2343,6.9
60390,Maulers,341,0,13372,13372,39.2
60579,Saint-Jean-aux-Bois,341,0,3071,3071,9
64146,Bournos,341,0,5339,5339,15.7
65192,Gavarnie-Gèdre,341,0,13963,13963,40.9
68067,Courtavon,341,775,9147,9922,29.1
72107,Crannes-en-Champagne,341,0,3099,3099,9.1
76206,Cuverville,341,0,3076,3076,9
76368,Houquetot,341,0,4038,4038,11.8
76554,Saint-Aignan-sur-Ry,341,1350,233,1583,4.6
77046,Boulancourt,341,0,174,174,0.5
80141,Brie,341,0,2443,2443,7.2
80250,Domvast,341,0,8444,8444,24.8
80669,Rethonvillers,341,0,6499,6499,19.1
3062,Charroux,340,0,6954,6954,20.5
3282,Theneuille,340,0,5345,5345,15.7
8386,Saint-Loup-en-Champagne,340,0,6502,6502,19.1
11241,Montbrun-des-Corbières,340,0,4607,4607,13.6
11422,Villedubert,340,0,2205,2205,6.5
14276,Fontaine-le-Pin,340,0,5326,5326,15.7
16074,Challignac,340,2500,18180,20680,60.8
16083,Charmé,340,2934,4274,7208,21.2
17101,Cherbonnières,340,0,9470,9470,27.9
19135,Mestes,340,0,4661,4661,13.7
25274,Glay,340,0,21523,21523,63.3
27649,Touffreville,340,0,2237,2237,6.6
2B029,Barbaggio,340,0,2055,2055,6
31029,Aurin,340,0,1658,1658,4.9
42277,Saint-Priest-la-Roche,340,2960,9639,12599,37.1
45080,Charmont-en-Beauce,340,0,1237,1237,3.6
46125,Gorses,340,0,10040,10040,29.5
51599,Vaudemange,340,0,6042,6042,17.8
52119,Chaudenay,340,0,6706,6706,19.7
60055,Beaurains-lès-Noyon,340,0,0,0,0
62508,Lières,340,0,5611,5611,16.5
63280,Pignols,340,0,6095,6095,17.9
68027,Berentzwiller,340,0,9121,9121,26.8
68210,Mittlach,340,0,13648,13648,40.1
77402,Saint-Barthélemy,340,0,5599,5599,16.5
89009,Annay-la-Côte,340,0,737,737,2.2
2277,Épagny,339,0,326,326,1
2626,Prouvais,339,0,912,912,2.7
3015,Bagneux,339,0,4563,4563,13.5
3115,Fleuriel,339,0,6934,6934,20.5
6097,Pierrefeu,339,0,7640,7640,22.5
7048,Chalencon,339,4201,1131,5332,15.7
10165,Géraudot,339,3068,1261,4329,12.8
10341,Saint-Hilaire-sous-Romilly,339,0,3464,3464,10.2
15234,Teissières-lès-Bouliès,339,3372,2972,6344,18.7
16188,Le Lindois,339,1370,6975,8345,24.6
17020,Arthenac,339,0,4003,4003,11.8
21035,Auvillars-sur-Saône,339,0,2542,2542,7.5
21369,Magny-Saint-Médard,339,0,1477,1477,4.4
24240,Limeuil,339,5280,4706,9986,29.5
24349,Razac-de-Saussignac,339,8855,7547,16402,48.4
24559,Tursac,339,6250,4706,10956,32.3
2B314,Santo-Pietro-di-Tenda,339,0,2049,2049,6
30139,Lanuéjols,339,0,16958,16958,50
44200,Soulvache,339,0,5686,5686,16.8
46332,Viazac,339,0,10011,10011,29.5
54306,Lay-Saint-Remy,339,0,707,707,2.1
57082,Biding,339,0,5788,5788,17.1
57386,Laudrefang,339,0,15731,15731,46.4
71299,Milly-Lamartine,339,2583,8659,11242,33.2
72144,Gréez-sur-Roc,339,0,2068,2068,6.1
72311,Saint-Pierre-de-Chevillé,339,0,19117,19117,56.4
72345,Surfonds,339,0,6337,6337,18.7
72370,Vernie,339,0,15957,15957,47.1
73309,Verel-de-Montbel,339,0,502,502,1.5
76085,Bertreville-Saint-Ouen,339,0,2736,2736,8.1
76279,Foucart,339,0,2583,2583,7.6
76416,Mathonville,339,1982,7919,9901,29.2
79252,Saint-Généroux,339,0,5275,5275,15.6
80763,Le Titre,339,0,8394,8394,24.8
84117,Saint-Roman-de-Malegarde,339,0,397,397,1.2
8034,Autrecourt-et-Pourron,338,0,11967,11967,35.4
9086,Caumont,338,0,40959,40959,121.2
11070,Carlipa,338,0,1001,1001,3
19265,Tarnac,338,0,5885,5885,17.4
21519,Recey-sur-Ource,338,0,5639,5639,16.7
25618,Villars-sous-Écot,338,0,21397,21397,63.3
26364,Vassieux-en-Vercors,338,5900,21169,27069,80.1
27021,Asnières,338,0,5205,5205,15.4
27047,Beaubray,338,0,3007,3007,8.9
27252,Fontaine-la-Louvet,338,0,5205,5205,15.4
27612,Saint-Vincent-des-Bois,338,0,1776,1776,5.3
29141,Loqueffret,338,50,17572,17622,52.1
30030,Baron,338,0,2597,2597,7.7
30110,Flaux,338,0,2597,2597,7.7
33400,Saint-Ferme,338,0,3357,3357,9.9
34044,Cabrerolles,338,0,661,661,2
34138,Lieuran-Cabrières,338,0,385,385,1.1
37095,Dame-Marie-les-Bois,338,2705,1483,4188,12.4
42203,Saint-Bonnet-des-Quarts,338,2180,9974,12154,36
43197,Saint-Jean-de-Nay,338,1780,14064,15844,46.9
50450,Saint-Barthélemy,338,0,8316,8316,24.6
54345,Manoncourt-en-Vermois,338,0,2690,2690,8
57599,Roupeldange,338,0,2036,2036,6
59529,Saint-Aubin,338,0,2677,2677,7.9
63356,Saint-Gervazy,338,0,2197,2197,6.5
63464,Vitrac,338,0,2230,2230,6.6
67552,Wolfskirchen,338,1544,4237,5781,17.1
70001,Abelcourt,338,0,1251,1251,3.7
70330,Mandrevillars,338,0,2207,2207,6.5
73094,Crest-Voland,338,0,7973,7973,23.6
77444,Sancy-lès-Provins,338,0,1219,1219,3.6
77471,Tousson,338,0,2814,2814,8.3
81053,Cambounès,338,0,3158,3158,9.3
88153,Domptail,338,0,1686,1686,5
1207,Lapeyrouse,337,0,70,70,0.2
5104,Poligny,337,0,22422,22422,66.5
11432,Villeneuve-lès-Montréal,337,0,998,998,3
15207,Saint-Poncy,337,7020,76,7096,21.1
18256,Subligny,337,0,6071,6071,18
25481,Raynans,337,0,21333,21333,63.3
27609,Saint-Victor-d'Épine,337,0,1453,1453,4.3
28159,La Framboisière,337,0,6016,6016,17.9
28184,Gouillons,337,0,1770,1770,5.3
28248,Le Mesnil-Thomas,337,0,6016,6016,17.9
28389,Thiville,337,0,18415,18415,54.6
31521,Saleich,337,0,18112,18112,53.7
32082,Castéra-Lectourois,337,0,191,191,0.6
34107,Fraisse-sur-Agout,337,0,5962,5962,17.7
38171,La Forteresse,337,0,3677,3677,10.9
51142,Chavot-Courcourt,337,0,6697,6697,19.9
55490,Sivry-sur-Meuse,337,0,12186,12186,36.2
57569,Rémeling,337,0,4851,4851,14.4
60054,Beaumont-les-Nonains,337,0,1084,1084,3.2
62107,Bénifontaine,337,0,9079,9079,26.9
62304,Erny-Saint-Julien,337,0,29993,29993,89
64322,Lasse,337,0,8757,8757,26
66125,Olette,337,0,10093,10093,29.9
67062,Breitenau,337,400,53453,53853,159.8
68100,Fulleren,337,0,4799,4799,14.2
71161,Curdin,337,0,1732,1732,5.1
71434,Saint-Julien-de-Jonzy,337,0,9550,9550,28.3
72010,Asnières-sur-Vègre,337,0,7838,7838,23.3
73156,Meyrieux-Trouet,337,0,2138,2138,6.3
76202,Croixdalle,337,0,2487,2487,7.4
79131,Geay,337,0,9586,9586,28.4
80058,Bayonvillers,337,0,6099,6099,18.1
80147,Buigny-l'Abbé,337,0,8345,8345,24.8
80693,Sailly-Laurette,337,0,45,45,0.1
80762,Tincourt-Boucly,337,0,2414,2414,7.2
81198,Orban,337,0,7031,7031,20.9
89048,Bœurs-en-Othe,337,0,653,653,1.9
89246,Massangis,337,3550,1627,5177,15.4
89459,Villeneuve-la-Dondagre,337,2000,1195,3195,9.5
2600,Pierrepont,336,0,1693,1693,5
3005,Archignat,336,0,1367,1367,4.1
5073,Lazer,336,0,10017,10017,29.8
9039,La Bastide-de-Bousignac,336,0,6960,6960,20.7
10375,Thennelières,336,0,4798,4798,14.3
17055,Boscamnant,336,0,3967,3967,11.8
18022,Barlieu,336,0,6053,6053,18
24088,Cause-de-Clérans,336,2000,1221,3221,9.6
24390,Saint-Crépin-d'Auberoche,336,4522,1877,6399,19
25199,Déservillers,336,0,2449,2449,7.3
25561,Thoraise,336,0,5920,5920,17.6
27061,Berthouville,336,0,1449,1449,4.3
27115,Breux-sur-Avre,336,0,9450,9450,28.1
27267,Freneuse-sur-Risle,336,0,7590,7590,22.6
27571,Saint-Martin-Saint-Firmin,336,0,5174,5174,15.4
30293,Saint-Privat-de-Champclos,336,0,13637,13637,40.6
31540,Ségreville,336,4046,1639,5685,16.9
32201,Lasseube-Propre,336,0,3966,3966,11.8
39407,Passenans,336,1500,8931,10431,31
40087,Créon-d'Armagnac,336,0,3838,3838,11.4
52522,Viéville,336,0,36907,36907,109.8
57725,Vittersbourg,336,0,1112,1112,3.3
58282,Surgy,336,0,7030,7030,20.9
64181,Castillon (Canton d'Arthez-de-Béarn),336,0,9047,9047,26.9
67441,Schalkendorf,336,460,9054,9514,28.3
68187,Linsdorf,336,0,9013,9013,26.8
68327,Stetten,336,0,6531,6531,19.4
72177,Maigné,336,0,3053,3053,9.1
73299,Traize,336,0,2132,2132,6.3
76055,Baons-le-Comte,336,0,622,622,1.9
80691,Saigneville,336,0,1025,1025,3.1
82182,Touffailles,336,0,10520,10520,31.3
86018,Basses,336,0,1716,1716,5.1
91180,Courances,336,0,11706,11706,34.8
1009,Andert-et-Condon,335,0,3734,3734,11.1
2184,Chevresis-Monceau,335,0,0,0,0
2753,Tupigny,335,0,1847,1847,5.5
5140,Saint-Étienne-le-Laus,335,0,2988,2988,8.9
7067,Colombier-le-Cardinal,335,0,1726,1726,5.2
7238,Saint-Genest-de-Beauzon,335,1475,23358,24833,74.1
12155,Fondamente,335,0,14345,14345,42.8
14468,Noron-la-Poterie,335,0,2319,2319,6.9
14734,Vendes,335,0,4107,4107,12.3
17386,Saint-Pierre-du-Palais,335,0,3956,3956,11.8
29104,Landévennec,335,0,4330,4330,12.9
32090,Castillon-Savès,335,0,23831,23831,71.1
32311,Pergain-Taillac,335,0,190,190,0.6
33150,Dieulivol,335,0,3327,3327,9.9
35159,Lourmais,335,0,4194,4194,12.5
38430,Saint-Mury-Monteymond,335,0,6225,6225,18.6
45017,Auvilliers-en-Gâtinais,335,0,3435,3435,10.3
52444,Saint-Blin,335,0,5154,5154,15.4
53233,Saint-Loup-du-Dorat,335,0,2013,2013,6
54340,Mamey,335,0,2000,2000,6
57636,Schmittviller,335,0,7721,7721,23
60573,Sainte-Eusoye,335,0,7555,7555,22.6
61199,Habloville,335,0,1912,1912,5.7
67093,Dieffenbach-lès-Wœrth,335,0,8106,8106,24.2
71099,Charbonnières,335,0,8557,8557,25.5
72019,Avessé,335,0,3044,3044,9.1
72043,Bourg-le-Roi,335,0,15769,15769,47.1
78536,Sailly,335,0,3118,3118,9.3
84111,Saint-Marcellin-lès-Vaison,335,0,392,392,1.2
10276,Paisy-Cosdon,334,0,5827,5827,17.4
12071,Compolibat,334,0,5737,5737,17.2
12239,Saint-Martin-de-Lenne,334,0,31633,31633,94.7
21316,Heuilley-sur-Saône,334,0,0,0,0
24351,Ribagnac,334,0,7436,7436,22.3
24464,Saint-Mesmin,334,0,4199,4199,12.6
25447,Passonfontaine,334,0,3945,3945,11.8
27424,Nagel-Séez-Mesnil,334,0,2971,2971,8.9
33488,Saint-Vincent-de-Pertignas,334,0,2330,2330,7
37070,Chenonceaux,334,0,7516,7516,22.5
39289,Lect,334,2000,9720,11720,35.1
42235,Saint-Hilaire-Cusson-la-Valmitte,334,0,2992,2992,9
46005,Anglars-Juillac,334,0,12144,12144,36.4
46265,Saint-Denis-lès-Martel,334,0,10897,10897,32.6
46305,Sérignac,334,0,12144,12144,36.4
47107,Galapian,334,0,3209,3209,9.6
47199,Pardaillan,334,0,16453,16453,49.3
50044,Belval,334,0,9664,9664,28.9
57147,Coin-sur-Seille,334,0,16560,16560,49.6
57592,Romelfing,334,0,2174,2174,6.5
59217,Eth,334,0,943,943,2.8
61111,Colombiers,334,0,9871,9871,29.6
68213,Mollau,334,0,3470,3470,10.4
72032,Berfay,334,0,4515,4515,13.5
76347,Hautot-le-Vatois,334,0,618,618,1.9
86097,La Ferrière-Airoux,334,0,7522,7522,22.5
2662,Rozet-Saint-Albin,333,0,7697,7697,23.1
4127,Montfort,333,7375,7334,14709,44.2
4136,La Mure-Argens,333,0,11775,11775,35.4
9303,Surba,333,0,1285,1285,3.9
12006,Alrance,333,0,2361,2361,7.1
21148,Charrey-sur-Saône,333,0,2497,2497,7.5
24186,Fonroque,333,800,624,1424,4.3
24480,Saint-Paul-de-Serre,333,5275,1860,7135,21.4
25142,Chaux-Neuve,333,0,19832,19832,59.6
27028,Authou,333,0,7522,7522,22.6
31328,Mauremont,333,0,1624,1624,4.9
31423,Plagnole,333,0,11661,11661,35
31464,Sabonnères,333,1135,414,1549,4.7
32088,Castillon-Debats,333,0,2421,2421,7.3
39035,Balanod,333,3000,5078,8078,24.3
40023,Baigts,333,0,5215,5215,15.7
43232,Salzuit,333,1327,3032,4359,13.1
52315,Marnay-sur-Marne,333,0,36578,36578,109.8
54591,Voinémont,333,0,0,0,0
57502,Neunkirchen-lès-Bouzonville,333,0,4794,4794,14.4
57681,Tromborn,333,0,2006,2006,6
62679,Questrecques,333,0,961,961,2.9
63456,Vichel,333,0,2165,2165,6.5
68176,Largitzen,333,0,4742,4742,14.2
70328,Malbouhans,333,0,3830,3830,11.5
71026,Beaumont-sur-Grosne,333,0,4034,4034,12.1
71034,Bissey-sous-Cruchaud,333,0,5108,5108,15.3
76138,Bracquetuit,333,0,2687,2687,8.1
76284,Fresnay-le-Long,333,1400,2687,4087,12.3
77426,Saint-Méry,333,0,316,316,0.9
1317,Ramasse,332,0,6418,6418,19.3
2687,Saint-Pierre-Aigle,332,0,320,320,1
5134,Saint-Clément-sur-Durance,332,0,10794,10794,32.5
8492,Vrigne-Meuse,332,0,7626,7626,23
10149,Feuges,332,0,4741,4741,14.3
16231,Montrollet,332,2240,6831,9071,27.3
16414,Villognon,332,4750,4174,8924,26.9
17445,Thézac,332,0,5531,5531,16.7
18001,Achères,332,0,2516,2516,7.6
21226,Darcey,332,0,0,0,0
2B135,Isolaccio-di-Fiumorbo,332,0,0,0,0
39083,Censeau,332,600,3361,3961,11.9
39344,Monnet-la-Ville,332,1320,3361,4681,14.1
39413,La Pesse,332,3110,1222,4332,13
40159,Louer,332,0,5199,5199,15.7
57496,Nébing,332,0,1099,1099,3.3
57516,Oberdorff,332,0,2000,2000,6
59664,Wulverdinghe,332,0,6394,6394,19.3
60162,Corbeil-Cerf,332,0,1068,1068,3.2
62218,Caucourt,332,5060,5479,10539,31.7
62260,Croix-en-Ternois,332,0,7172,7172,21.6
64291,Labastide-Villefranche,332,0,6940,6940,20.9
64433,Osse-en-Aspe,332,0,7150,7150,21.5
65120,Calavanté,332,0,2108,2108,6.3
70299,Lavoncourt,332,0,1704,1704,5.1
71245,Jugy,332,0,4022,4022,12.1
80375,Gauville,332,0,458,458,1.4
80476,Liercourt,332,0,1013,1013,3.1
11004,Alaigne,331,4300,4357,8657,26.2
24353,La Rochebeaucourt-et-Argentine,331,7820,4663,12483,37.7
24496,Saint-Romain-et-Saint-Clément,331,650,1092,1742,5.3
27697,Vironvay,331,0,9816,9816,29.7
30056,La Bruguière,331,0,2544,2544,7.7
32032,Bassoues,331,0,5019,5019,15.2
36061,Crozon-sur-Vauvre,331,0,962,962,2.9
51488,Saint-Imoges,331,0,818,818,2.5
59530,Saint-Aybert,331,0,6376,6376,19.3
60367,Loconville,331,3585,7269,10854,32.8
65422,Séron,331,0,3162,3162,9.6
67321,Neuviller-la-Roche,331,6822,23954,30776,93
67427,Saint-Maurice,331,609,52502,53111,160.5
68308,Sickert,331,0,6945,6945,21
76459,Nesle-Hodeng,331,0,7732,7732,23.4
80113,Bonneville,331,0,1290,1290,3.9
91001,Abbéville-la-Rivière,331,0,834,834,2.5
3214,Rocles,330,0,5069,5069,15.4
9070,Les Cabannes,330,4250,47525,51775,156.9
9128,Gajan,330,0,39989,39989,121.2
12048,Campouriez,330,0,11182,11182,33.9
16057,Bouteville,330,460,12347,12807,38.8
17048,Blanzac-lès-Matha,330,0,9192,9192,27.9
21385,Marey-sur-Tille,330,0,4697,4697,14.2
21708,Villy-le-Moutier,330,0,1583,1583,4.8
23217,Saint-Martin-Sainte-Catherine,330,3865,10347,14212,43.1
25378,Meslières,330,0,20890,20890,63.3
27055,Bérengeville-la-Campagne,330,0,1419,1419,4.3
27512,Saint-Aubin-de-Scellon,330,0,5082,5082,15.4
30038,Bez-et-Esparon,330,0,5323,5323,16.1
30148,Liouc,330,0,686,686,2.1
33045,Belvès-de-Castillon,330,0,12821,12821,38.9
33507,Sauviac,330,0,110,110,0.3
38380,Saint-Didier-de-Bizonnes,330,0,1766,1766,5.4
39399,Ounans,330,1230,3196,4426,13.4
41255,Ternay,330,0,4082,4082,12.4
48005,Antrenas,330,5140,7868,13008,39.4
51243,Faux-Fresnay,330,0,622,622,1.9
52480,Soncourt-sur-Marne,330,0,36248,36248,109.8
54055,Bayonville-sur-Mad,330,0,1970,1970,6
54423,Pexonne,330,0,1171,1171,3.5
54579,Villers-sous-Prény,330,0,3606,3606,10.9
60046,Bargny,330,0,1292,1292,3.9
60270,Genvry,330,0,0,0,0
65444,Tibiran-Jaunac,330,0,2159,2159,6.5
69230,Sainte-Paule,330,0,2974,2974,9
70432,Quers,330,0,1221,1221,3.7
71107,Charrecey,330,0,9073,9073,27.5
71327,Mussy-sous-Dun,330,0,6405,6405,19.4
71362,Pruzilly,330,1978,8429,10407,31.5
76749,Wanchy-Capval,330,800,2436,3236,9.8
77157,Dhuisy,330,0,4845,4845,14.7
77297,Mondreville,330,0,348,348,1.1
77460,Tancrou,330,0,4845,4845,14.7
79340,Vausseroux,330,0,8652,8652,26.2
80109,Le Boisle,330,0,8172,8172,24.8
80462,Lamotte-Buleux,330,0,8172,8172,24.8
80569,Morcourt,330,0,44,44,0.1
80576,Moyencourt,330,0,6290,6290,19.1
88039,Baudricourt,330,0,4743,4743,14.4
89430,Varennes,330,3000,45,3045,9.2
91037,Auvernaux,330,0,485,485,1.5
1012,Aranc,329,0,12445,12445,37.8
1260,Le Montellier,329,0,5615,5615,17.1
8322,Neuville-lès-This,329,0,5122,5122,15.6
10254,Montpothier,329,0,2033,2033,6.2
11095,Comigne,329,0,2134,2134,6.5
12160,Mostuéjouls,329,0,3400,3400,10.3
15166,Roumégoux,329,3350,2885,6235,19
16222,Montboyer,329,2810,15471,18281,55.6
17233,Meux,329,0,3885,3885,11.8
18042,La Celle,329,0,1450,1450,4.4
19249,Saint-Yrieix-le-Déjalat,329,0,4221,4221,12.8
21012,Ampilly-le-Sec,329,0,5489,5489,16.7
27492,Romilly-la-Puthenaye,329,0,1418,1418,4.3
32098,Cazaux-Savès,329,0,2053,2053,6.2
39431,Poids-de-Fiole,329,775,9575,10350,31.5
41219,Saint-Laurent-des-Bois,329,0,1356,1356,4.1
45158,Gondreville,329,0,3227,3227,9.8
47023,Beaugas,329,0,8401,8401,25.5
49057,Cernusson,329,0,13671,13671,41.6
50553,Saint-Senier-de-Beuvron,329,0,8095,8095,24.6
50617,Varenguebec,329,0,6874,6874,20.9
51515,Saint-Remy-sur-Bussy,329,0,3095,3095,9.4
53223,Saint-Germain-de-Coulamer,329,0,2926,2926,8.9
54048,Les Baroches,329,0,3055,3055,9.3
57364,Kirsch-lès-Sierck,329,0,4736,4736,14.4
57394,Léning,329,0,1089,1089,3.3
57490,Moyenvic,329,0,1089,1089,3.3
58212,Poiseux,329,0,18568,18568,56.4
60535,Reuil-sur-Brêche,329,0,7419,7419,22.6
60557,Roy-Boissy,329,4969,1614,6583,20
62546,Maninghen-Henne,329,0,1309,1309,4
63449,Le Vernet-Sainte-Marguerite,329,0,2402,2402,7.3
67091,Diedendorf,329,0,4124,4124,12.5
68035,Biederthal,329,950,8826,9776,29.7
68104,Geiswasser,329,0,5710,5710,17.4
72027,Beaumont-sur-Dême,329,0,18553,18553,56.4
76022,Anquetierville,329,0,2507,2507,7.6
76126,Bosc-Mesnil,329,0,7685,7685,23.4
76153,Calleville-les-Deux-Églises,329,0,2655,2655,8.1
86003,Anché,329,0,7409,7409,22.5
89291,Passy,329,460,2186,2646,8
95690,Wy-dit-Joli-Village,329,0,2080,2080,6.3
3081,Colombier,328,0,11718,11718,35.7
7189,Ribes,328,1700,22870,24570,74.9
8216,Haudrecy,328,0,7535,7535,23
11313,Ricaud,328,0,2882,2882,8.8
14668,Saonnet,328,0,2271,2271,6.9
16297,Graves-Saint-Amant,328,5500,12272,17772,54.2
17118,Corignac,328,0,3873,3873,11.8
28029,Bazoches-les-Hautes,328,0,1723,1723,5.3
31197,Franquevielle,328,0,6794,6794,20.7
35354,Vieux-Viel,328,0,2789,2789,8.5
39320,Maynal,328,1200,5001,6201,18.9
53257,Saulges,328,0,2346,2346,7.2
54182,Essey-et-Maizerais,328,0,1958,1958,6
54365,Merviller,328,0,1449,1449,4.4
57276,Guinglange,328,0,15220,15220,46.4
57326,Hinckange,328,0,1975,1975,6
59549,Salesches,328,0,926,926,2.8
60473,Ognes,328,0,1284,1284,3.9
61149,Échalou,328,4050,8785,12835,39.1
62068,Ayette,328,0,1631,1631,5
63144,Égliseneuve-d'Entraigues,328,0,2395,2395,7.3
64034,Arbérats-Sillègue,328,0,8523,8523,26
64382,Mesplède,328,0,8832,8832,26.9
65202,Gez,328,0,13431,13431,40.9
66118,Montner,328,0,2732,2732,8.3
70427,Purgerot,328,0,1948,1948,5.9
71173,Devrouze,328,0,613,613,1.9
71459,Saint-Martin-sous-Montaigu,328,880,9018,9898,30.2
80590,Neuilly-l'Hôpital,328,0,8122,8122,24.8
87099,Moissannes,328,0,1350,1350,4.1
89134,Cussy-les-Forges,328,1370,711,2081,6.3
2366,Hannapes,327,0,1803,1803,5.5
2620,Presles-et-Boves,327,0,645,645,2
2629,Puisieux-et-Clanlieu,327,0,5831,5831,17.8
6078,Malaussène,327,0,7369,7369,22.5
8319,Neuville-lez-Beaulieu,327,0,8549,8549,26.1
14256,Étréham,327,0,2264,2264,6.9
14308,Goustranville,327,0,4154,4154,12.7
17271,Paillé,327,0,9108,9108,27.9
19086,Goulles,327,0,970,970,3
26262,Recoubeau-Jansac,327,316,18181,18497,56.6
27360,Jumelles,327,0,3846,3846,11.8
28109,Les Corvées-les-Yys,327,0,233,233,0.7
30291,Saint-Paul-la-Coste,327,0,10221,10221,31.3
38049,Bossieu,327,0,3568,3568,10.9
39285,Lavans-lès-Dole,327,1210,6637,7847,24
44078,Juigné-des-Moutiers,327,0,5484,5484,16.8
46329,Vaylats,327,0,1838,1838,5.6
47098,Fieux,327,0,1585,1585,4.8
54001,Abaucourt,327,0,1935,1935,5.9
54510,Sornéville,327,0,1935,1935,5.9
59174,Dimechaux,327,0,2590,2590,7.9
61032,Beaufai,327,5131,3371,8502,26
62775,Sanghen,327,0,2001,2001,6.1
64016,Aldudes,327,0,8497,8497,26
64203,Doumy,327,9472,5120,14592,44.6
66204,Taurinya,327,0,9794,9794,30
71266,Lucenay-l'Évêque,327,0,7316,7316,22.4
73074,La Chapelle,327,0,46849,46849,143.3
73275,Saint-Pierre-de-Genebroz,327,0,22390,22390,68.5
80759,Tilloloy,327,0,395,395,1.2
91495,Plessis-Saint-Benoist,327,0,824,824,2.5
95119,Buhy,327,0,2067,2067,6.3
2392,Joncourt,326,0,2954,2954,9.1
2739,Terny-Sorny,326,0,643,643,2
10313,Radonvilliers,326,0,6882,6882,21.1
10356,Saint-Oulph,326,0,335,335,1
12107,Gaillac-d'Aveyron,326,0,30875,30875,94.7
17076,Celles,326,0,3849,3849,11.8
17256,Nantillé,326,0,9081,9081,27.9
21414,Mimeure,326,0,10055,10055,30.8
25235,Ferrières-les-Bois,326,0,220,220,0.7
25620,Ville-du-Pont,326,0,0,0,0
26306,Sainte-Jalle,326,0,16751,16751,51.4
27630,Thibouville,326,0,1405,1405,4.3
28285,Oinville-sous-Auneau,326,0,9499,9499,29.1
30021,Aubussargues,326,0,2505,2505,7.7
30275,Saint-Just-et-Vacquières,326,0,10190,10190,31.3
31111,Castagnac,326,0,561,561,1.7
33043,Bellebat,326,0,3237,3237,9.9
33391,Saint-Côme,326,0,108,108,0.3
37127,Le Liège,326,0,5659,5659,17.4
38103,Chichilianne,326,0,9133,9133,28
41087,Fontaine-les-Coteaux,326,2350,4032,6382,19.6
42142,Merle-Leignec,326,0,2921,2921,9
43088,Espalem,326,4366,15976,20342,62.4
47251,Saint-Léon,326,0,3132,3132,9.6
50166,Doville,326,0,6812,6812,20.9
51017,Arzillières-Neuville,326,0,5142,5142,15.8
51086,Breuil-sur-Vesle,326,0,5794,5794,17.8
51147,La Cheppe,326,0,3067,3067,9.4
51644,Vincelles,326,0,472,472,1.4
55347,Les Monthairons,326,0,2075,2075,6.4
57145,Coincy,326,0,794,794,2.4
58053,Champlemy,326,0,18399,18399,56.4
60241,Fontaine-Chaalis,326,0,0,0,0
60255,Fréniches,326,0,0,0,0
62320,Étrun,326,0,9169,9169,28.1
62379,Gouy-en-Artois,326,0,2709,2709,8.3
62655,Pierremont,326,0,7043,7043,21.6
62787,Sempy,326,0,5161,5161,15.8
70109,Buthiers,326,0,2730,2730,8.4
72272,Sainte-Cérotte,326,0,4407,4407,13.5
76721,Varneville-Bretteville,326,0,2631,2631,8.1
76726,Vattetot-sur-Mer,326,0,2115,2115,6.5
77043,Boitron,326,0,5368,5368,16.5
89143,Dollot,326,1025,1156,2181,6.7
2576,Osly-Courtil,325,0,2719,2719,8.4
2767,Vauxrezis,325,0,2719,2719,8.4
4109,Mallefougasse-Augès,325,0,13622,13622,41.9
5018,La Bâtie-Vieille,325,0,2899,2899,8.9
10232,Merrey-sur-Arce,325,0,5673,5673,17.5
12031,Bournazel,325,0,699,699,2.2
12247,Saint-Saturnin-de-Lenne,325,0,30781,30781,94.7
14261,Le Faulq,325,0,5223,5223,16.1
14337,La Houblonnière,325,0,3618,3618,11.1
16135,Eymouthiers,325,1127,5796,6923,21.3
21245,Épagny,325,0,4626,4626,14.2
24574,Veyrignac,325,3600,1244,4844,14.9
25223,Éternoz,325,0,2368,2368,7.3
25426,Noirefontaine,325,12923,20574,33497,103.1
25459,La Planée,325,0,19356,19356,59.6
29299,Tréouergat,325,0,585,585,1.8
34216,Le Pradal,325,0,3026,3026,9.3
37029,Bossée,325,0,5642,5642,17.4
37041,Bueil-en-Touraine,325,0,3607,3607,11.1
39307,Maisod,325,1500,9458,10958,33.7
40029,Bats,325,0,7509,7509,23.1
47012,Anzex,325,0,5484,5484,16.9
50338,Montbray,325,0,5492,5492,16.9
50552,Saint-Sébastien-de-Raids,325,0,6791,6791,20.9
50619,Le Vast,325,1351,10223,11574,35.6
50637,Villebaudon,325,0,5492,5492,16.9
51464,Romain,325,0,5776,5776,17.8
51597,Vauciennes,325,0,471,471,1.4
51627,Villeneuve-Renneville-Chevigny,325,0,6459,6459,19.9
54486,Saint-Remimont,325,0,0,0,0
61326,Perrou,325,350,4033,4383,13.5
62677,Le Quesnoy-en-Artois,325,0,5146,5146,15.8
62749,Saint-Georges,325,0,5146,5146,15.8
63241,Montpeyroux,325,0,2113,2113,6.5
63259,Olloix,325,0,5826,5826,17.9
64257,Haut-de-Bosdarros,325,2560,3476,6036,18.6
67096,Dimbsthal,325,1400,22923,24323,74.8
67461,Schwobsheim,325,0,6846,6846,21.1
71185,Dyo,325,0,6308,6308,19.4
71437,Saint-Laurent-en-Brionnais,325,0,6308,6308,19.4
74095,Crempigny-Bonneguête,325,0,4401,4401,13.5
78472,Orsonville,325,1400,633,2033,6.3
80408,Halloy-lès-Pernois,325,0,559,559,1.7
95462,Omerville,325,0,2054,2054,6.3
2164,Le Charmel,324,0,7489,7489,23.1
3041,Le Brethon,324,0,5094,5094,15.7
3259,Saint-Sauvier,324,0,1318,1318,4.1
14291,Fresney-le-Vieux,324,0,9795,9795,30.2
24075,Campagnac-lès-Quercy,324,8740,555,9295,28.7
27320,La Haye-du-Theil,324,0,1393,1393,4.3
28366,Santeuil,324,0,9441,9441,29.1
30203,Portes,324,0,10127,10127,31.3
33302,Néac,324,0,12588,12588,38.9
36097,Liniez,324,0,6581,6581,20.3
38542,Veyssilieu,324,0,1673,1673,5.2
40276,Saint-Michel-Escalus,324,0,2637,2637,8.1
47187,Monteton,324,0,15960,15960,49.3
56019,Billio,324,0,1306,1306,4
67102,Dossenheim-Kochersberg,324,2439,6164,8603,26.6
67373,Pfalzweyer,324,2496,8731,11227,34.7
70325,Maizières,324,0,2714,2714,8.4
71268,Lugny-lès-Charolles,324,0,1256,1256,3.9
77004,Andrezel,324,0,307,307,0.9
80025,Argoules,324,0,8023,8023,24.8
86144,Maisonneuve,324,0,16837,16837,52
89216,Lainsecq,324,3250,14630,17880,55.2
90084,Reppe,324,950,11304,12254,37.8
1052,Bouligneux,323,0,67,67,0.2
2236,Crécy-au-Mont,323,0,320,320,1
4161,Méolans-Revel,323,24814,96463,121277,375.5
12086,La Cresse,323,0,3338,3338,10.3
12158,Montsalès,323,0,942,942,2.9
14086,Bonneville-sur-Touques,323,0,5191,5191,16.1
14245,Ernes,323,0,5060,5060,15.7
15063,Drugeac,323,10880,6109,16989,52.6
16306,Saint-Christophe,323,4961,6645,11606,35.9
18094,Feux,323,0,5819,5819,18
18151,Montigny,323,0,2448,2448,7.6
24466,Saint-Michel-de-Montaigne,323,0,2254,2254,7
25295,Les Grangettes,323,0,19236,19236,59.6
25566,La Tour-de-Sçay,323,0,16100,16100,49.8
27603,Saint-Siméon,323,0,4974,4974,15.4
28202,Lamblore,323,0,5766,5766,17.9
31255,Labroquère,323,0,3092,3092,9.6
35258,Saint-Brieuc-des-Iffs,323,0,4043,4043,12.5
41124,Marcilly-en-Beauce,323,0,3995,3995,12.4
46255,Saint-Cirgues,323,0,9538,9538,29.5
51117,Champigneul-Champagne,323,0,16417,16417,50.8
51631,Villers-aux-Nœuds,323,0,5740,5740,17.8
53232,Saint-Léger,323,0,2310,2310,7.2
54320,Loisy,323,0,3529,3529,10.9
59176,Doignies,323,0,4198,4198,13
68383,Zellenberg,323,0,772,772,2.4
70056,Baulay,323,0,1918,1918,5.9
71121,La Chaux,323,0,40,40,0.1
77498,Vignely,323,0,4405,4405,13.6
79209,Pierrefitte,323,0,5026,5026,15.6
79303,Salles,323,0,1795,1795,5.6
80749,Terramesnil,323,0,1259,1259,3.9
87186,Saint-Vitte-sur-Briance,323,2771,5179,7950,24.6
90079,Petitmagny,323,1840,9621,11461,35.5
6037,Caussols,322,0,3902,3902,12.1
7113,Labastide-de-Virac,322,4460,19662,24122,74.9
7321,Thorrenc,322,0,1659,1659,5.2
10295,Polisot,322,0,5621,5621,17.5
10319,Rigny-le-Ferron,322,0,5618,5618,17.4
11061,Cambieure,322,6140,4239,10379,32.2
14405,Martigny-sur-l'Ante,322,0,5044,5044,15.7
14733,Vaux-sur-Seulles,322,0,12410,12410,38.5
15233,Teissières-de-Cornet,322,1500,10910,12410,38.5
17327,Saint-Félix,322,0,8969,8969,27.9
21178,Valforêt,322,0,1544,1544,4.8
21575,Saint-Symphorien-sur-Saône,322,0,2414,2414,7.5
23258,Vareilles,322,0,6094,6094,18.9
24262,Mayac,322,530,4048,4578,14.2
26202,Montjoux,322,0,11226,11226,34.9
27672,Vascœuil,322,0,2119,2119,6.6
39149,Chissey-sur-Loue,322,750,3118,3868,12
42031,Caloire,322,0,7545,7545,23.4
42131,Maizilly,322,0,8354,8354,25.9
50059,Blosville,322,0,1745,1745,5.4
50118,Champrepus,322,0,5441,5441,16.9
53128,Laubrières,322,0,2132,2132,6.6
57430,Mainvillers,322,0,14942,14942,46.4
57610,Saint-François-Lacroix,322,0,4635,4635,14.4
62783,Saulchoy,322,0,5098,5098,15.8
64363,Lys,322,0,4087,4087,12.7
65394,Saint-Paul,322,0,2107,2107,6.5
74030,La Baume,322,0,22500,22500,69.9
76531,Rocquefort,322,0,596,596,1.9
89232,Lucy-le-Bois,322,150,698,848,2.6
90055,Grosne,322,0,1915,1915,5.9
2491,Monceau-le-Neuf-et-Faucouzy,321,0,5724,5724,17.8
3066,Châtel-Montagne,321,0,8794,8794,27.4
3090,Couzon,321,0,4321,4321,13.5
3274,Sorbier,321,0,5544,5544,17.3
7142,Lespéron,321,670,2510,3180,9.9
12220,Sainte-Eulalie-de-Cernon,321,0,13745,13745,42.8
14161,Clarbec,321,0,5159,5159,16.1
16040,Berneuil,321,2970,17164,20134,62.7
16399,Verrières,321,2775,12010,14785,46.1
17106,Cierzac,321,0,3790,3790,11.8
19154,Orgnac-sur-Vézère,321,0,0,0,0
21401,Meloisey,321,0,1396,1396,4.3
22313,Saint-Martin-des-Prés,321,0,0,0,0
24348,Razac-d'Eymet,321,1000,602,1602,5
24357,Rouffignac-de-Sigoulès,321,4250,7146,11396,35.5
25003,Abbenans,321,0,740,740,2.3
25109,Cessey,321,0,2339,2339,7.3
27247,Flipou,321,0,2112,2112,6.6
27298,Graveron-Sémerville,321,0,1381,1381,4.3
28079,Chapelle-Royale,321,0,125,125,0.4
29115,Lannédern,321,0,5059,5059,15.8
33499,Les Salles-de-Castillon,321,0,2240,2240,7
34083,Combes,321,0,2989,2989,9.3
34279,Saint-Nazaire-de-Ladarez,321,0,628,628,2
36236,Vicq-Exemplet,321,11710,7051,18761,58.4
36243,Villegouin,321,0,4030,4030,12.6
40164,Retjons,321,0,3666,3666,11.4
45056,Bromeilles,321,0,2433,2433,7.6
47321,Villeneuve-de-Duras,321,0,15813,15813,49.3
50086,Brillevast,321,300,10097,10397,32.4
51630,Villers-aux-Bois,321,0,6379,6379,19.9
53234,Saint-Loup-du-Gast,321,0,4232,4232,13.2
54120,Charmes-la-Côte,321,0,670,670,2.1
55497,Les Souhesmes-Rampont,321,0,2043,2043,6.4
60314,Hétomesnil,321,1345,1575,2920,9.1
64442,Parbayse,321,0,8643,8643,26.9
73194,Orelle,321,0,8880,8880,27.7
77301,Montceaux-lès-Provins,321,0,1157,1157,3.6
78416,Montalet-le-Bois,321,0,2987,2987,9.3
84061,Lagarde-Paréol,321,0,0,0,0
88506,Vieux-Moulin,321,0,3121,3121,9.7
1230,Mantenay-Montlin,320,0,6186,6186,19.3
3166,Mazerier,320,0,6545,6545,20.5
8195,Gomont,320,0,6120,6120,19.1
8220,Hauviné,320,0,7743,7743,24.2
8389,Saint-Marcel,320,0,4982,4982,15.6
9274,Saint-Quentin-la-Tour,320,0,6628,6628,20.7
14664,Sallen,320,0,2215,2215,6.9
22318,Saint-Michel-de-Plélan,320,0,8525,8525,26.6
24183,Fleurac,320,970,4442,5412,16.9
26293,Saint-Avit,320,0,5268,5268,16.5
30134,Issirac,320,0,4670,4670,14.6
33054,Blaignac,320,0,2605,2605,8.1
34059,La Caunette,320,0,1211,1211,3.8
36019,Bommiers,320,0,6500,6500,20.3
37034,Braslou,320,0,8683,8683,27.1
38342,Roissard,320,0,8965,8965,28
46205,Montgesty,320,0,2702,2702,8.4
46320,Tour-de-Faure,320,0,2702,2702,8.4
52289,Liffol-le-Petit,320,0,3575,3575,11.2
53030,Le Bignon-du-Maine,320,0,1923,1923,6
54392,Moutrot,320,0,10610,10610,33.2
54559,Velle-sur-Moselle,320,0,1322,1322,4.1
57518,Oberstinzel,320,0,2083,2083,6.5
57697,Vasperviller,320,0,2083,2083,6.5
62732,Sachin,320,1360,6913,8273,25.9
63251,Neuf-Église,320,0,497,497,1.6
65065,Barlest,320,0,3057,3057,9.6
72088,Congé-sur-Orne,320,0,5934,5934,18.5
76040,Autigny,320,0,2072,2072,6.5
76094,Bierville,320,0,219,219,0.7
77235,Jaignes,320,0,4699,4699,14.7
79274,Saint-Martin-de-Mâcon,320,0,4979,4979,15.6
80319,Fluy,320,0,442,442,1.4
80387,Grattepanche,320,0,20516,20516,64.1
80603,Ochancourt,320,0,2128,2128,6.6
80614,Outrebois,320,0,1247,1247,3.9
80733,Senlis-le-Sec,320,0,358,358,1.1
5097,Orpierre,319,0,9510,9510,29.8
8415,Sery,319,0,6997,6997,21.9
9202,Montégut-Plantaurel,319,0,8574,8574,26.9
18262,Thauvenay,319,0,5747,5747,18
23099,Janaillat,319,0,10002,10002,31.4
23103,Lafat,319,0,9524,9524,29.9
24405,Saint-Félix-de-Villadeix,319,830,1159,1989,6.2
25125,Charmoille,319,0,8794,8794,27.6
25176,Courvières,319,0,4628,4628,14.5
28004,Allonnes,319,0,9295,9295,29.1
28182,Gohory,319,0,17431,17431,54.6
32005,Arblade-le-Haut,319,0,212,212,0.7
33258,Lugasson,319,0,3168,3168,9.9
39308,Malange,319,1050,6474,7524,23.6
40053,Bourriot-Bergonce,319,0,3643,3643,11.4
41096,Le Gault-du-Perche,319,0,9528,9528,29.9
42107,Gumières,319,0,2858,2858,9
43187,Saint-Geneys-près-Saint-Paulien,319,6699,13273,19972,62.6
45091,Chevannes,319,0,3129,3129,9.8
45118,Crottes-en-Pithiverais,319,0,1160,1160,3.6
52514,Verbiesles,319,0,35040,35040,109.8
55058,Boncourt-sur-Meuse,319,0,1287,1287,4
57613,Saint-Jean-de-Bassel,319,0,2077,2077,6.5
57641,Schweyen,319,0,7352,7352,23
60124,Candor,319,0,2789,2789,8.7
62437,Herly,319,0,18877,18877,59.2
65095,Bonnefont,319,0,10334,10334,32.4
65098,Boô-Silhen,319,0,13063,13063,40.9
67288,Memmelshoffen,319,2135,8790,10925,34.2
71264,Lournand,319,0,2217,2217,6.9
77380,Puisieux,319,0,4684,4684,14.7
2213,Connigis,318,0,7350,7350,23.1
2216,Corcy,318,0,306,306,1
2480,Mesbrecourt-Richecourt,318,0,1602,1602,5
4227,Vachères,318,0,838,838,2.6
12124,Lassouts,318,0,1575,1575,5
12228,Saint-Izaire,318,0,666,666,2.1
14226,Donnay,318,0,9614,9614,30.2
14334,L'Hôtellerie,318,0,3540,3540,11.1
15144,Omps,318,3450,2788,6238,19.6
16020,Aubeterre-sur-Dronne,318,15480,14953,30433,95.7
17007,Anais,318,0,13158,13158,41.4
18274,Verdigny,318,0,5729,5729,18
21111,Brognon,318,0,8,8,0
21363,Magnien,318,0,9809,9809,30.8
24318,Paunat,318,3995,1776,5771,18.1
25108,Cernay-l'Église,318,10871,2215,13086,41.2
25365,Mancenans,318,0,733,733,2.3
27271,Fresney,318,0,3740,3740,11.8
27326,Hécourt,318,0,1671,1671,5.3
27652,Tourneville,318,1350,3740,5090,16
27694,Villez-sous-Bailleul,318,0,1671,1671,5.3
28010,Argenvilliers,318,0,124,124,0.4
28396,Trizay-lès-Bonneval,318,0,585,585,1.8
32115,Dému,318,0,0,0,0
32167,Laas,318,0,4821,4821,15.2
36204,Saint-Michel-en-Brenne,318,0,1577,1577,5
41291,Villetrun,318,0,3933,3933,12.4
43091,Les Estables,318,500,1764,2264,7.1
45110,Courcelles-le-Roi,318,0,2410,2410,7.6
46152,Lamothe-Fénelon,318,0,10375,10375,32.6
47194,Moustier,318,0,5922,5922,18.6
51066,Blaise-sous-Arzillières,318,0,5016,5016,15.8
51369,Mœurs-Verdey,318,0,4149,4149,13
51568,Thil,318,0,5651,5651,17.8
54064,Bertrambois,318,0,1128,1128,3.5
54256,Haussonville,318,0,1314,1314,4.1
57001,Aboncourt,318,0,2038,2038,6.4
60487,Parnes,318,0,6983,6983,22
62490,Lattre-Saint-Quentin,318,0,2642,2642,8.3
62739,Sains-lès-Marquion,318,0,396,396,1.2
72121,Douillet,318,0,14968,14968,47.1
73292,Thénésol,318,0,7501,7501,23.6
76415,Massy,318,0,7428,7428,23.4
83015,Bauduen,318,0,1239,1239,3.9
85184,Puy-de-Serre,318,2780,4984,7764,24.4
2050,Barzy-en-Thiérache,317,0,5653,5653,17.8
2119,Brécy,317,0,7327,7327,23.1
2511,Montigny-en-Arrouaise,317,0,2872,2872,9.1
7091,Fons,317,2346,5411,7757,24.5
7109,Joannas,317,1311,4994,6305,19.9
11074,Les Cassés,317,7850,2785,10635,33.5
12085,Crespin,317,0,9702,9702,30.6
14003,Agy,317,0,12218,12218,38.5
14467,Noron-l'Abbaye,317,0,4966,4966,15.7
14492,Pennedepie,317,0,2369,2369,7.5
19240,Saint-Salvadour,317,4973,6015,10988,34.7
21212,Crépand,317,0,6175,6175,19.5
23185,Saint-Chabrais,317,0,4162,4162,13.1
24360,Sagelat,317,3085,15517,18602,58.7
25119,Champvans-les-Moulins,317,0,5585,5585,17.6
25300,Guyans-Durnes,317,0,3745,3745,11.8
26264,Rémuzat,317,0,16289,16289,51.4
27059,Bernouville,317,0,258,258,0.8
27234,Fauville,317,0,3728,3728,11.8
34205,Les Plans,317,0,3560,3560,11.2
37048,Chambon,317,965,5503,6468,20.4
39138,Chemin,317,750,1878,2628,8.3
47121,Labastide-Castel-Amouroux,317,0,5349,5349,16.9
47295,Savignac-sur-Leyze,317,0,8094,8094,25.5
49010,Armaillé,317,0,316,316,1
54161,Domèvre-sur-Vezouze,317,0,1125,1125,3.5
56088,Île-d'Arz,317,0,2933,2933,9.3
57126,Chambrey,317,0,1049,1049,3.3
60200,Domfront,317,0,1756,1756,5.5
60522,Quinquempoix,317,0,1756,1756,5.5
61451,Saint-Quentin-les-Chardonnets,317,20,10710,10730,33.8
62495,Ledinghem,317,0,686,686,2.2
63041,Biollet,317,0,492,492,1.6
64235,Garris,317,0,8237,8237,26
67038,Bietlenheim,317,1467,5266,6733,21.2
67053,Bœsenbiesen,317,0,6677,6677,21.1
67499,Urbeis,317,0,50281,50281,158.6
68186,Ligsdorf,317,0,8504,8504,26.8
68361,Wegscheid,317,0,6651,6651,21
70150,Chenevrey-et-Morogne,317,0,214,214,0.7
70243,Fontenois-lès-Montbozon,317,0,1015,1015,3.2
81102,Garrigues,317,0,1035,1035,3.3
81125,Lacaze,317,0,2962,2962,9.3
89221,Leugny,317,200,14314,14514,45.8
1129,Crans,316,0,66,66,0.2
7219,Saint-Bauzile,316,0,6766,6766,21.4
17258,Neuillac,316,0,3731,3731,11.8
19091,Hautefage,316,0,938,938,3
21256,Étevaux,316,0,0,0,0
22018,Brélidy,316,0,5658,5658,17.9
24023,Baneuil,316,5386,1148,6534,20.7
32460,Vergoignan,316,0,9892,9892,31.3
33429,Saint-Léger-de-Balson,316,0,3231,3231,10.2
40203,Nassiet,316,0,858,858,2.7
41160,Neuvy,316,0,2214,2214,7
47013,Argenton,316,0,5332,5332,16.9
47125,Lacépède,316,0,3036,3036,9.6
54114,Champey-sur-Moselle,316,0,3453,3453,10.9
54269,Hudiviller,316,0,2515,2515,8
57605,Sailly-Achâtel,316,0,12101,12101,38.3
57756,Xouaxange,316,0,2057,2057,6.5
58031,Billy-Chevannes,316,0,1584,1584,5
60062,Berlancourt,316,0,0,0,0
60648,Troussencourt,316,0,7126,7126,22.6
63036,Bergonne,316,0,2054,2054,6.5
63161,La Forie,316,0,2856,2856,9
68312,Sondersdorf,316,0,8477,8477,26.8
76570,Saint-Crespin,316,0,2550,2550,8.1
95139,La Chapelle-en-Vexin,316,0,1998,1998,6.3
8187,Gernelle,315,0,7236,7236,23
11025,Bagnoles,315,0,2043,2043,6.5
12188,Prades-Salars,315,0,5678,5678,18
15104,Leynhac,315,2520,2762,5282,16.8
22295,Saint-Gilles-Vieux-Marché,315,0,0,0,0
24148,Cunèges,315,830,7013,7843,24.9
28141,Ermenonville-la-Grande,315,0,9179,9179,29.1
31087,Bragayrac,315,0,391,391,1.2
36004,Anjouin,315,0,319,319,1
38275,Serre-Nerpol,315,0,5091,5091,16.2
42047,Champoly,315,4322,5909,10231,32.5
42077,Croizet-sur-Gand,315,750,8930,9680,30.7
48012,Les Monts-Verts,315,0,11641,11641,37
51081,Branscourt,315,0,5598,5598,17.8
51099,Bussy-Lettrée,315,0,16011,16011,50.8
51256,Fontaine-sur-Ay,315,0,779,779,2.5
52391,Planrupt,315,0,2853,2853,9.1
53058,La Chapelle-Craonnaise,315,0,2085,2085,6.6
54550,Vathiménil,315,0,1392,1392,4.4
60190,Cuvergnon,315,0,1233,1233,3.9
63033,Beaumont-lès-Randan,315,0,1287,1287,4.1
63162,Fournols,315,0,2847,2847,9
63279,Picherande,315,0,2300,2300,7.3
63444,Varennes-sur-Usson,315,0,2048,2048,6.5
69258,Vauxrenard,315,884,0,884,2.8
76148,Bures-en-Bray,315,0,2325,2325,7.4
76373,Imbleville,315,0,2542,2542,8.1
76546,Royville,315,0,2542,2542,8.1
81173,Montcabrier,315,0,1029,1029,3.3
87044,Chéronnac,315,2600,6889,9489,30.1
90064,Lepuix-Neuf,315,0,1873,1873,5.9
2080,Besny-et-Loizy,314,0,11992,11992,38.2
2581,Paars,314,0,619,619,2
2800,Viffort,314,0,7258,7258,23.1
8064,Biermes,314,0,6005,6005,19.1
9111,Engomer,314,0,38050,38050,121.2
11427,Villelongue-d'Aude,314,23007,4133,27140,86.4
16264,Pleuville,314,525,6460,6985,22.2
17198,Juicq,314,0,8746,8746,27.9
24536,Singleyrac,314,1225,588,1813,5.8
25236,Fertans,314,0,2288,2288,7.3
28040,Billancelles,314,0,1162,1162,3.7
2B361,Zilia,314,0,0,0,0
33250,Loubens,314,0,2556,2556,8.1
33379,Saint-Brice,314,0,3118,3118,9.9
36197,Saint-Hilaire-sur-Benaize,314,0,6333,6333,20.2
37198,Rillé,314,0,2913,2913,9.3
40099,Fargues,314,0,7255,7255,23.1
45206,Mignères,314,0,3080,3080,9.8
45243,Ouzouer-sous-Bellegarde,314,0,3220,3220,10.3
47198,Pailloles,314,0,8018,8018,25.5
48177,Saint-Pierre-le-Vieux,314,0,3225,3225,10.3
55532,Vaubecourt,314,0,4250,4250,13.5
61237,Lougé-sur-Maire,314,2345,663,3008,9.6
61415,Saint-Léger-sur-Sarthe,314,1960,111,2071,6.6
62082,Barastre,314,0,1561,1561,5
62228,Clerques,314,0,679,679,2.2
64404,Montory,314,0,8160,8160,26
65125,Campistrous,314,0,938,938,3
66099,Llauro,314,0,4209,4209,13.4
68333,Tagsdorf,314,0,8423,8423,26.8
70038,Authoison,314,0,1005,1005,3.2
70355,Montarlot-lès-Rioz,314,0,2630,2630,8.4
71141,Colombier-en-Brionnais,314,0,6094,6094,19.4
76529,Riville,314,0,2037,2037,6.5
80331,Forest-l'Abbaye,314,0,7775,7775,24.8
86260,Sérigny,314,0,7146,7146,22.8
90019,Bretagne,314,0,1868,1868,5.9
2275,Effry,313,0,6144,6144,19.6
3069,Châtillon,313,0,4808,4808,15.4
12251,Saint-Victor-et-Melvieu,313,0,5622,5622,18
14657,Saint-Samson,313,0,3976,3976,12.7
16307,Saint-Ciers-sur-Bonnieure,313,0,3935,3935,12.6
16361,Salles-de-Villefagnan,313,7762,6851,14613,46.7
17252,Le Mung,313,0,8718,8718,27.9
21135,Champagne-sur-Vingeanne,313,0,1363,1363,4.4
27690,Villers-en-Vexin,313,0,255,255,0.8
28390,Tillay-le-Péneux,313,0,1644,1644,5.3
31023,Aulon,313,0,6483,6483,20.7
31183,Figarol,313,0,16822,16822,53.7
32398,Saint-Mont,313,0,3133,3133,10
32429,Sempesserre,313,0,178,178,0.6
37157,Montrésor,313,0,5433,5433,17.4
39068,Les Bouchoux,313,2131,1152,3283,10.5
40330,Villenave,313,0,7363,7363,23.5
42014,Belleroche,313,0,8120,8120,25.9
45198,Marsainvilliers,313,860,389,1249,4
46098,Fajoles,313,0,9367,9367,29.9
51027,Auve,313,0,4648,4648,14.8
53046,Le Buret,313,0,1881,1881,6
57637,Schneckenbusch,313,0,2038,2038,6.5
62556,Marles-sur-Canche,313,0,4956,4956,15.8
64088,Balansun,313,0,8428,8428,26.9
65212,Guchen,313,0,15048,15048,48.1
66119,Mosset,313,0,9374,9374,29.9
67260,Laubach,313,0,7573,7573,24.2
68080,Emlingen,313,0,8396,8396,26.8
70004,Adelans-et-le-Val-de-Bithaine,313,0,1158,1158,3.7
72209,Montreuil-le-Chétif,313,0,14733,14733,47.1
76407,Manneville-ès-Plains,313,0,2027,2027,6.5
76487,Osmoy-Saint-Valery,313,0,2310,2310,7.4
77167,Égligny,313,1635,4433,6068,19.4
80657,Quiry-le-Sec,313,0,1923,1923,6.1
5106,Prunières,312,0,24932,24932,79.9
10129,Dosches,312,0,1160,1160,3.7
10274,Orvilliers-Saint-Julien,312,0,0,0,0
12051,Cantoin,312,0,10572,10572,33.9
15219,Salers,312,15920,5166,21086,67.6
16008,Ambérac,312,1734,3922,5656,18.1
16419,Vouharte,312,3550,3922,7472,23.9
17288,Poursay-Garnaud,312,0,8691,8691,27.9
17356,Saint-Loup,312,0,8691,8691,27.9
21386,Marigny-le-Cahouët,312,0,0,0,0
27550,Saint-Grégoire-du-Vièvre,312,0,4805,4805,15.4
27611,Saint-Vigor,312,0,3669,3669,11.8
29292,Tréguennec,312,780,11710,12490,40
31288,Layrac-sur-Tarn,312,0,0,0,0
34005,Agonès,312,1340,6683,8023,25.7
34124,Lacoste,312,0,355,355,1.1
37106,La Ferrière,312,0,1369,1369,4.4
40262,Saint-Gor,312,0,3563,3563,11.4
46113,Frayssinet,312,0,1805,1805,5.8
50227,Le Ham,312,1550,9814,11364,36.4
50518,Saint-Martin-le-Bouillant,312,0,5272,5272,16.9
51090,Broussy-le-Grand,312,0,588,588,1.9
51139,Chaudefontaine,312,0,4633,4633,14.8
54316,Limey-Remenauville,312,0,1863,1863,6
57088,Bistroff,312,0,5327,5327,17.1
63374,Saint-Martin-des-Olmes,312,1736,2819,4555,14.6
63468,Vollore-Montagne,312,0,7234,7234,23.2
64036,Arbouet-Sussaute,312,0,8108,8108,26
64500,Salles-Mongiscard,312,0,8401,8401,26.9
65264,Lascazères,312,0,7048,7048,22.6
67344,Oberhoffen-lès-Wissembourg,312,0,34377,34377,110.2
67553,Wolschheim,312,369,22006,22375,71.7
70564,Villers-lès-Luxeuil,312,0,1154,1154,3.7
79002,Adilly,312,0,8180,8180,26.2
80642,Prouville,312,0,1216,1216,3.9
86220,Saint-Gaudent,312,0,7026,7026,22.5
88054,Bertrimoutier,312,0,3033,3033,9.7
91507,Prunay-sur-Essonne,312,0,10870,10870,34.8
1037,Bénonces,311,0,5308,5308,17.1
2159,Champs,311,0,308,308,1
10267,Nogent-sur-Aube,311,0,265,265,0.9
14524,Putot-en-Auge,311,0,3951,3951,12.7
16362,Salles-Lavalette,311,6224,14624,20848,67
17126,Courcerac,311,0,8663,8663,27.9
24423,Saint-Julien-Innocence-Eulalie,311,1522,583,2105,6.8
24444,Saint-Louis-en-l'Isle,311,6203,14892,21095,67.8
26342,Solérieux,311,0,4808,4808,15.5
2B058,Canari,311,0,11405,11405,36.7
33059,Blésignac,311,0,30706,30706,98.7
34048,Campagne,311,0,3400,3400,10.9
42213,Saint-Cyr-de-Valorges,311,1420,5637,7057,22.7
46084,Creysse,311,0,10147,10147,32.6
50285,Magneville,311,0,9782,9782,31.5
50596,Théville,311,0,9782,9782,31.5
51284,Haussignémont,311,0,1932,1932,6.2
53192,La Rouaudière,311,0,2059,2059,6.6
54168,Dommartin-sous-Amance,311,0,1840,1840,5.9
54201,Fontenoy-la-Joûte,311,0,1374,1374,4.4
55078,Brieulles-sur-Meuse,311,0,11246,11246,36.2
55423,Rembercourt-Sommaisne,311,0,4210,4210,13.5
57259,Grindorff-Bizing,311,0,4477,4477,14.4
58033,Bitry,311,0,14043,14043,45.2
62006,Achiet-le-Petit,311,0,1546,1546,5
63100,Châteauneuf-les-Bains,311,0,2052,2052,6.6
63311,Saint-Agoulin,311,0,1271,1271,4.1
69164,Ranchal,311,0,3676,3676,11.8
69183,Saint-Bonnet-le-Troncy,311,0,3676,3676,11.8
71044,Bosjean,311,0,582,582,1.9
81157,Marzens,311,0,1016,1016,3.3
82168,Saint-Nazaire-de-Valentane,311,0,9737,9737,31.3
89072,Champcevrais,311,4600,14043,18643,59.9
2358,Grougis,310,0,1709,1709,5.5
3139,Laprugne,310,0,8492,8492,27.4
9040,La Bastide-de-Lordat,310,0,1396,1396,4.5
10116,Crésantignes,310,0,4427,4427,14.3
10391,Vailly,310,0,4427,4427,14.3
12187,Prades-d'Aubrac,310,0,29360,29360,94.7
17181,Grandjean,310,0,8635,8635,27.9
23056,Châtelus-le-Marcheix,310,0,1717,1717,5.5
27525,Sainte-Colombe-près-Vernon,310,0,1629,1629,5.3
31443,Puymaurin,310,0,6421,6421,20.7
31505,Saint-Michel,310,0,10856,10856,35
32219,Lupiac,310,0,2254,2254,7.3
32382,Saint-Jean-Poutge,310,0,10923,10923,35.2
33360,La Roquille,310,0,2340,2340,7.5
35199,Moussé,310,0,4657,4657,15
39216,Étival,310,3172,9022,12194,39.3
41201,Saint-Arnoult,310,0,3834,3834,12.4
42238,Saint-Jean-la-Vêtre,310,3000,2777,5777,18.6
47044,Cahuzac,310,0,7916,7916,25.5
52258,Laferté-sur-Aube,310,0,1700,1700,5.5
56068,La Grée-Saint-Laurent,310,0,4668,4668,15.1
57108,Breidenbach,310,0,7144,7144,23
58229,Saint-André-en-Morvan,310,0,3653,3653,11.8
62131,Bihucourt,310,0,1541,1541,5
63039,Beurières,310,0,2801,2801,9
63171,Gouttières,310,0,481,481,1.6
71320,Mont-Saint-Vincent,310,0,4981,4981,16.1
76583,Saint-Germain-sous-Cailly,310,0,212,212,0.7
80033,Assevillers,310,0,5610,5610,18.1
80207,Contay,310,0,1208,1208,3.9
82102,Mansonville,310,0,33307,33307,107.4
89240,Malay-le-Petit,310,810,2060,2870,9.3
2827,Voyenne,309,0,1557,1557,5
3012,Autry-Issards,309,0,4747,4747,15.4
3088,Courçais,309,0,1257,1257,4.1
6062,Fontan,309,0,1734,1734,5.6
11158,Gaja-et-Villedieu,309,2860,4067,6927,22.4
14397,Mandeville-en-Bessin,309,0,2139,2139,6.9
17105,Chives,309,0,8607,8607,27.9
19070,Darnets,309,0,3964,3964,12.8
21241,Échevronne,309,0,1344,1344,4.3
21322,Jallanges,309,0,2317,2317,7.5
24513,Saint-Vincent-sur-l'Isle,309,0,3885,3885,12.6
25514,Saint-Antoine,309,0,18403,18403,59.6
28192,Happonvilliers,309,0,220,220,0.7
33347,Puynormand,309,0,6027,6027,19.5
34021,Babeau-Bouldoux,309,0,1747,1747,5.7
40318,Toulouzette,309,0,4839,4839,15.7
46208,Montvalent,309,0,10081,10081,32.6
46272,Saint-Jean-Mirabel,309,0,9125,9125,29.5
50469,Sainte-Geneviève,309,1806,9719,11525,37.3
57334,Hommert,309,0,2012,2012,6.5
58241,Saint-Germain-Chassenay,309,0,797,797,2.6
59085,Blécourt,309,0,4016,4016,13
60072,Bitry,309,0,2093,2093,6.8
60322,Jaméricourt,309,11556,6785,18341,59.4
61298,Moulins-sur-Orne,309,0,653,653,2.1
61472,Sévigny,309,0,653,653,2.1
62241,Cormont,309,0,3287,3287,10.6
62402,Halinghen,309,0,892,892,2.9
62484,Lagnicourt-Marcel,309,1500,384,1884,6.1
63147,Églisolles,309,0,2792,2792,9
72136,Fontenay-sur-Vègre,309,0,2808,2808,9.1
73271,Saint-Pierre-d'Alvey,309,0,1960,1960,6.3
74148,Leschaux,309,0,2387,2387,7.7
80214,Coullemelle,309,0,1898,1898,6.1
81044,Cabanès,309,0,4622,4622,15
81152,Mailhoc,309,0,7069,7069,22.9
83078,Moissac-Bellevue,309,0,1204,1204,3.9
86119,Joussé,309,0,6959,6959,22.5
90074,Novillard,309,0,10780,10780,34.9
2008,Aizy-Jouy,308,0,607,607,2
9321,Ussat,308,0,1189,1189,3.9
21251,Essey,308,0,4681,4681,15.2
24031,Beauregard-et-Bassac,308,54050,14748,68798,223.4
24175,Les Farges,308,1450,4276,5726,18.6
27572,Saint-Meslin-du-Bosc,308,0,1325,1325,4.3
30301,Saint-Victor-des-Oules,308,0,2367,2367,7.7
31570,Vaux,308,0,6262,6262,20.3
36177,Sacierges-Saint-Martin,308,0,1693,1693,5.5
38403,Saint-Jean-d'Hérans,308,0,8628,8628,28
41132,Méhers,308,410,5660,6070,19.7
54485,Saint-Pancré,308,0,3910,3910,12.7
57040,Aulnois-sur-Seille,308,0,1019,1019,3.3
57467,Mey,308,0,15271,15271,49.6
58210,Planchez,308,0,3629,3629,11.8
60117,Bussy,308,0,0,0,0
62663,Pommera,308,0,2559,2559,8.3
62671,Pronville-en-Artois,308,0,383,383,1.2
67384,Ranrupt,308,5741,22289,28030,91
70226,Fallon,308,0,97,97,0.3
71287,Massilly,308,2350,2141,4491,14.6
72079,Chérisay,308,0,14498,14498,47.1
76346,Hautot-l'Auvray,308,0,1995,1995,6.5
80740,Sourdon,308,0,1892,1892,6.1
84013,Beaumettes,308,0,3002,3002,9.7
89462,Villeneuve-les-Genêts,308,1000,13907,14907,48.4
3169,Meillard,307,0,4716,4716,15.4
5077,Molines-en-Queyras,307,0,9981,9981,32.5
9057,Biert,307,0,37202,37202,121.2
10125,Dierrey-Saint-Pierre,307,0,4384,4384,14.3
11221,Les Martys,307,0,3966,3966,12.9
12242,Saint-Rémy,307,0,895,895,2.9
16038,Benest,307,3094,6316,9410,30.7
19016,Bar,307,0,5825,5825,19
21242,Échigey,307,0,7,7,0
21578,Saint-Victor-sur-Ouche,307,0,1727,1727,5.6
23082,Fleurat,307,0,1700,1700,5.5
27033,Bacquepuis,307,0,1320,1320,4.3
30187,Navacelles,307,0,12460,12460,40.6
36114,Mauvières,307,0,6191,6191,20.2
37184,Le Petit-Pressigny,307,2025,5329,7354,24
39539,Vadans,307,610,6790,7400,24.1
42124,Lupé,307,0,9421,9421,30.7
45032,Le Bignon-Mirabeau,307,0,3011,3011,9.8
45045,Bouilly-en-Gâtinais,307,0,382,382,1.2
47202,Paulhiac,307,0,7839,7839,25.5
47212,Poussignac,307,0,5181,5181,16.9
53076,Cossé-en-Champagne,307,0,1845,1845,6
54421,Petitmont,307,0,1089,1089,3.5
57698,Vatimont,307,0,14246,14246,46.4
61411,Saint-Jouin-de-Blavou,307,2770,1078,3848,12.5
68198,Magstatt-le-Haut,307,800,5967,6767,22
69166,Riverie,307,0,9852,9852,32.1
71409,Saint-Émiland,307,0,6869,6869,22.4
73106,École,307,0,3902,3902,12.7
76158,Canville-les-Deux-Églises,307,0,677,677,2.2
76380,Lammerville,307,0,2477,2477,8.1
82111,Miramont-de-Quercy,307,0,9612,9612,31.3
84015,Beaumont-du-Ventoux,307,0,10024,10024,32.7
95181,Courcelles-sur-Viosne,307,0,14105,14105,45.9
1035,Belleydoux,306,0,11575,11575,37.8
2267,Dommiers,306,0,294,294,1
2456,Manicamp,306,0,5498,5498,18
5095,Le Noyer,306,0,20359,20359,66.5
7080,Devesset,306,0,6543,6543,21.4
8026,Aubigny-les-Pothées,306,0,8000,8000,26.1
16176,Lachaise,306,850,16362,17212,56.2
16338,Saint-Médard,306,592,16362,16954,55.4
19173,Rilhac-Xaintrie,306,0,908,908,3
21099,Bouze-lès-Beaune,306,0,1331,1331,4.3
21122,Bussy-le-Grand,306,0,0,0,0
25540,Semondans,306,0,19371,19371,63.3
28367,Santilly,306,0,1607,1607,5.3
31278,Latoue,306,0,6338,6338,20.7
31357,Montastruc-de-Salies,306,0,16446,16446,53.7
32449,Toujouse,306,0,204,204,0.7
39350,Montbarrey,306,3532,2963,6495,21.2
46252,Les Pechs du Vers,306,0,1770,1770,5.8
55404,Pierrefitte-sur-Aire,306,0,4142,4142,13.5
57709,Vescheim,306,0,614,614,2
60094,Boursonne,306,0,1198,1198,3.9
60645,Trie-la-Ville,306,0,6720,6720,22
62135,Blairville,306,0,2543,2543,8.3
62280,Dury,306,0,381,381,1.2
62418,Hauteville,306,0,2543,2543,8.3
62478,Journy,306,0,662,662,2.2
63309,Saillant,306,0,2765,2765,9
70007,Ailloncourt,306,0,1132,1132,3.7
70160,Coisevaux,306,0,1998,1998,6.5
71029,Bellevesvre,306,0,38,38,0.1
71160,Curbigny,306,0,5939,5939,19.4
72036,Béthon,306,0,14404,14404,47.1
79132,Genneton,306,0,8705,8705,28.4
80077,Béhencourt,306,0,1193,1193,3.9
80155,Bussus-Bussuel,306,0,7577,7577,24.8
80393,Gruny,306,0,369,369,1.2
86175,Nalliers,306,0,12376,12376,40.4
88393,Rollainville,306,756,0,756,2.5
95094,Bouqueval,306,0,3795,3795,12.4
2649,Rocourt-Saint-Martin,305,0,7050,7050,23.1
3164,Le Mayet-d'École,305,0,6239,6239,20.5
7103,Saint-Julien-d'Intres,305,2020,6521,8541,28
14708,Tracy-Bocage,305,0,11310,11310,37.1
16213,Mazerolles,305,2100,6275,8375,27.5
16342,Saint-Palais-du-Né,305,0,16309,16309,53.5
18039,Bué,305,0,5495,5495,18
18136,Marçais,305,0,1344,1344,4.4
21629,Thoisy-la-Berchère,305,0,875,875,2.9
24263,Mazeyrolles,305,3090,522,3612,11.8
25525,Saint-Point-Lac,305,0,18164,18164,59.6
28277,Neuvy-en-Dunois,305,0,561,561,1.8
31166,Empeaux,305,0,379,379,1.2
31208,Ganties,305,0,16392,16392,53.7
31256,Labruyère-Dorsa,305,0,1604,1604,5.3
36037,La Champenoise,305,0,6195,6195,20.3
39567,Villeneuve-sous-Pymont,305,570,9612,10182,33.4
40143,Lamothe,305,0,7174,7174,23.5
47254,Saint-Martin-Curton,305,0,5147,5147,16.9
47258,Sainte-Maure-de-Peyriac,305,0,1479,1479,4.8
48144,Sainte-Croix-Vallée-Française,305,0,16612,16612,54.5
53115,Hercé,305,0,4021,4021,13.2
58058,La Chapelle-Saint-André,305,0,6381,6381,20.9
59294,Haynecourt,305,0,3964,3964,13
61332,Pointel,305,5390,8169,13559,44.5
64017,Alos-Sibas-Abense,305,0,7926,7926,26
67051,Blienschwiller,305,135,9432,9567,31.4
70011,Amage,305,0,3508,3508,11.5
73267,Saint-Pancrace,305,0,8191,8191,26.9
76611,Saint-Martin-aux-Arbres,305,0,672,672,2.2
77461,Thénisy,305,3000,4319,7319,24
79267,Saint-Lin,305,0,2514,2514,8.2
80249,Domqueur,305,0,7553,7553,24.8
90077,Petit-Croix,305,0,10641,10641,34.9
3002,Agonges,304,0,4670,4670,15.4
8236,Jandun,304,0,6668,6668,21.9
22294,Saint-Gilles-Pligeaux,304,0,27995,27995,92.1
25062,Le Bizot,304,0,5105,5105,16.8
27142,Champenard,304,0,9015,9015,29.7
27266,Franqueville,304,0,1311,1311,4.3
27407,Mesnil-Verclives,304,0,1597,1597,5.3
28086,Chassant,304,0,216,216,0.7
37274,Villebourg,304,0,3374,3374,11.1
39390,Nogna,304,1546,8847,10393,34.2
40206,Oeyregave,304,0,2262,2262,7.4
41265,Troo,304,3257,3760,7017,23.1
45185,Lombreuil,304,0,4095,4095,13.5
46119,Gigouzac,304,0,2567,2567,8.4
47109,Gavaudun,304,0,7762,7762,25.5
51485,Saint-Hilaire-au-Temple,304,0,15452,15452,50.8
55097,Chalaines,304,0,1227,1227,4
57237,Frémestroff,304,0,5191,5191,17.1
58198,Oisy,304,0,6360,6360,20.9
60458,La Neuville-sur-Oudeuil,304,0,1491,1491,4.9
61139,Crouttes,304,0,2198,2198,7.2
62069,Azincourt,304,0,4813,4813,15.8
62786,Selles,304,0,878,878,2.9
64218,Estérençuby,304,0,7900,7900,26
64551,Verdets,304,0,6547,6547,21.5
65115,Cabanac,304,0,1930,1930,6.3
65116,Cadéac,304,0,14615,14615,48.1
65465,Vielle-Aure,304,0,14615,14615,48.1
70385,La Neuvelle-lès-Lure,304,0,13363,13363,44
72125,Écorpain,304,0,4110,4110,13.5
72366,Valennes,304,0,4110,4110,13.5
73041,Betton-Bettonet,304,0,5436,5436,17.9
78565,Saint-Martin-des-Champs,304,0,3048,3048,10
80221,Cramont,304,0,7528,7528,24.8
80764,Tœufles,304,0,2021,2021,6.6
81188,Moulin-Mage,304,0,5378,5378,17.7
6142,Touët-de-l'Escarène,303,0,8544,8544,28.2
8339,Perthes,303,0,5795,5795,19.1
14175,Condé-sur-Seulles,303,0,11678,11678,38.5
14345,Jort,303,0,4746,4746,15.7
16158,Grassac,303,700,5403,6103,20.1
18224,Saint-Martin-des-Champs,303,0,1046,1046,3.5
27228,Éturqueraye,303,0,1241,1241,4.1
31302,Lodes,303,1650,6276,7926,26.2
36099,Lourdoueix-Saint-Michel,303,2100,881,2981,9.8
38437,Saint-Paul-d'Izeaux,303,0,3306,3306,10.9
43198,Saint-Jean-Lachalm,303,3455,1469,4924,16.3
45149,Foucherolles,303,0,919,919,3
46072,Concorès,303,0,9068,9068,29.9
48059,La Fage-Saint-Julien,303,0,3112,3112,10.3
52190,Esnouveaux,303,0,33282,33282,109.8
58105,Druy-Parigny,303,0,782,782,2.6
59208,Escobecques,303,0,5018,5018,16.6
59425,Neuville-en-Avesnois,303,0,855,855,2.8
60140,Chambors,303,0,6654,6654,22
62030,Amplier,303,0,2518,2518,8.3
62740,Sains-lès-Pernes,303,0,6546,6546,21.6
64312,Lanneplaà,303,0,8159,8159,26.9
65233,Jarret,303,0,2895,2895,9.6
68034,Bettlach,303,0,8128,8128,26.8
68299,Saint-Ulrich,303,0,4315,4315,14.2
73246,Saint-Jean-de-Couz,303,0,20747,20747,68.5
76741,Villainville,303,0,2733,2733,9
77332,Nantouillet,303,0,230,230,0.8
80499,Mailly-Raineval,303,0,1861,1861,6.1
80527,Méneslies,303,0,2014,2014,6.6
80681,Rouvrel,303,0,1861,1861,6.1
88080,Bult,303,0,1512,1512,5
7287,Saint-Pons,302,0,9368,9368,31
12273,Soulages-Bonneval,302,0,10233,10233,33.9
12307,Curan,302,0,2141,2141,7.1
16343,Saint-Preuil,302,1170,11300,12470,41.3
18102,Givardon,302,0,4839,4839,16
21670,Verrey-sous-Salmaise,302,0,0,0,0
24048,Bonneville-et-Saint-Avit-de-Fumadières,302,3180,1052,4232,14
24397,Saint-Cyr-les-Champagnes,302,0,3797,3797,12.6
2B057,Canale-di-Verde,302,0,2299,2299,7.6
32247,Maurens,302,0,3836,3836,12.7
37258,Thizay,302,0,16576,16576,54.9
39209,Val-d'Épy,302,1112,4605,5717,18.9
39558,Vevy,302,1900,9517,11417,37.8
41138,Meslay,302,1522,3735,5257,17.4
43093,Félines,302,6035,12566,18601,61.6
46129,Gréalou,302,0,8918,8918,29.5
50577,Sortosville-en-Beaumont,302,2090,9499,11589,38.4
51187,Courlandon,302,0,5367,5367,17.8
51295,Huiron,302,0,4764,4764,15.8
51320,Leuvrigny,302,0,437,437,1.4
51592,Vandières,302,0,437,437,1.4
52001,Ageville,302,0,33173,33173,109.8
55101,Chardogne,302,0,3641,3641,12.1
59473,Preux-au-Sart,302,0,852,852,2.8
62594,Mory,302,0,1502,1502,5
64246,Gomer,302,0,3152,3152,10.4
65001,Adast,302,0,12366,12366,40.9
65146,Chis,302,0,2885,2885,9.6
67036,Bettwiller,302,1973,3786,5759,19.1
70326,La Malachère,302,0,2529,2529,8.4
72218,Neuvillette-en-Charnie,302,0,5892,5892,19.5
73256,Saint-Martin-d'Arc,302,0,8355,8355,27.7
77097,Chartronges,302,0,4973,4973,16.5
77310,Montigny-le-Guesdier,302,0,4277,4277,14.2
78283,Grandchamp,302,0,3028,3028,10
79152,Lorigné,302,0,8722,8722,28.9
87031,Le Chalard,302,1829,9249,11078,36.7
88356,Les Poulières,302,0,2936,2936,9.7
2223,Courboin,301,0,6957,6957,23.1
3129,Hyds,301,0,10753,10753,35.7
3179,Montaigu-le-Blin,301,0,5199,5199,17.3
5172,Trescléoux,301,0,8973,8973,29.8
10193,Lesmont,301,0,6354,6354,21.1
10371,Sommeval,301,0,4298,4298,14.3
11053,Brugairolles,301,2950,3962,6912,23
14138,Cartigny-l'Épinay,301,0,2084,2084,6.9
14571,Saint-Denis-de-Mailloc,301,0,3351,3351,11.1
17115,Colombiers,301,0,9540,9540,31.7
17204,Léoville,301,0,3554,3554,11.8
17362,Saint-Martial-de-Mirambeau,301,0,3554,3554,11.8
18013,Arpheuilles,301,0,1326,1326,4.4
18130,Loye-sur-Arnon,301,680,807,1487,4.9
23145,Nouhant,301,0,4524,4524,15
24470,Sainte-Mondane,301,1250,1152,2402,8
31179,Le Faget,301,0,1468,1468,4.9
33017,Aubiac,301,0,100,100,0.3
34250,Saint-Étienne-d'Albagnan,301,0,1139,1139,3.8
39323,Menotey,301,1250,6109,7359,24.4
40177,Maylis,301,0,4714,4714,15.7
41186,Rahart,301,0,3723,3723,12.4
43238,Séneujols,301,1540,1459,2999,10
46034,Le Bourg,301,0,8889,8889,29.5
46207,Montredon,301,0,8889,8889,29.5
54146,Crézilles,301,0,9980,9980,33.2
54291,Lalœuf,301,0,0,0,0
54297,Laneuveville-aux-Bois,301,0,1330,1330,4.4
57418,Loudrefing,301,0,996,996,3.3
59665,Wylder,301,0,5797,5797,19.3
62507,Liencourt,301,0,2501,2501,8.3
63268,Pardines,301,0,1957,1957,6.5
65040,Aspin-en-Lavedan,301,0,2876,2876,9.6
67017,Baerendorf,301,3694,3773,7467,24.8
68071,Diefmatten,301,0,4286,4286,14.2
70094,Breuchotte,301,0,289,289,1
71233,L'Hôpital-le-Mercier,301,0,1167,1167,3.9
71578,Clux-Villeneuve,301,0,3473,3473,11.5
72261,Ruillé-en-Champagne,301,0,5872,5872,19.5
74175,Meillerie,301,7150,15595,22745,75.6
76425,Mentheville,301,0,3564,3564,11.8
86040,La Bussière,301,0,12174,12174,40.4
86132,Liglet,301,0,12174,12174,40.4
88269,Liézey,301,0,506,506,1.7
3031,Bizeneuille,300,0,10718,10718,35.7
4041,Le Castellet,300,0,3487,3487,11.6
5038,Château-Ville-Vieille,300,0,9753,9753,32.5
8472,Viel-Saint-Remy,300,0,6580,6580,21.9
10208,La Louptière-Thénard,300,0,1854,1854,6.2
18259,Sury-ès-Bois,300,0,5405,5405,18
23081,Flayat,300,0,3938,3938,13.1
24004,Ajat,300,4015,5247,9262,30.9
36210,Sarzay,300,0,6590,6590,22
39034,Balaiseaux,300,790,1777,2567,8.6
43013,Vissac-Auteyrac,300,0,2732,2732,9.1
47220,Razimet,300,0,2882,2882,9.6
51393,Nanteuil-la-Forêt,300,0,742,742,2.5
51509,Saint-Pierre,300,0,15248,15248,50.8
52212,Fronville,300,0,1111,1111,3.7
54198,Fléville-Lixières,300,0,2785,2785,9.3
57084,Bioncourt,300,0,993,993,3.3
58158,Mars-sur-Allier,300,0,1121,1121,3.7
60285,Grandvillers-aux-Bois,300,0,1662,1662,5.5
61487,Torchamp,300,2530,3723,6253,20.8
62258,Croisette,300,0,6481,6481,21.6
62366,Gauchin-Légal,300,0,4951,4951,16.5
63406,Sardon,300,0,1226,1226,4.1
64469,Saint-Abit,300,700,3208,3908,13
65104,Boulin,300,0,1905,1905,6.4
65436,Souyeaux,300,0,1905,1905,6.4
80421,Hattencourt,300,0,362,362,1.2
80801,Villers-Carbonnel,300,0,2149,2149,7.2
88271,Lignéville,300,0,2332,2332,7.8
89087,Chassignelles,300,100,697,797,2.7
2162,La Chapelle-sur-Chézy,299,0,163,163,0.5
2517,Montigny-sur-Crécy,299,0,1506,1506,5
2665,Grand-Rozoy,299,0,999,999,3.3
8297,Montcornet,299,0,4655,4655,15.6
14025,Aubigny,299,0,4684,4684,15.7
24468,Saint-Michel-de-Villadeix,299,2650,1670,4320,14.4
27370,Lisors,299,0,1967,1967,6.6
30054,Brouzet-lès-Quissac,299,0,621,621,2.1
31340,Mervilla,299,0,4875,4875,16.3
33282,Mérignas,299,0,2086,2086,7
36087,Ingrandes,299,0,1644,1644,5.5
39103,La Chapelle-sur-Furieuse,299,800,6613,7413,24.8
39274,Lajoux,299,500,1101,1601,5.4
45021,Barville-en-Gâtinais,299,0,2266,2266,7.6
45107,Coudroy,299,0,3066,3066,10.3
45263,Rouvres-Saint-Jean,299,0,372,372,1.2
50182,La Feuillie,299,0,6247,6247,20.9
50528,Saint-Nicolas-de-Pierrepont,299,0,6247,6247,20.9
51556,Soudron,299,0,15197,15197,50.8
51633,Villers-Franqueux,299,0,5314,5314,17.8
52193,Euffigneix,299,0,32843,32843,109.8
55481,Senon,299,0,5465,5465,18.3
57020,Ancerville,299,0,11450,11450,38.3
59306,Hestrud,299,0,2369,2369,7.9
60204,Écuvilly,299,0,2614,2614,8.7
61402,Saint-Hilaire-de-Briouze,299,0,1706,1706,5.7
62669,Pressy,299,0,6459,6459,21.6
68371,Willer,299,1770,8021,9791,32.7
70341,Menoux,299,0,1776,1776,5.9
70356,Montboillon,299,0,2504,2504,8.4
71171,Dennevy,299,0,8221,8221,27.5
72210,Montreuil-le-Henri,299,0,16861,16861,56.4
80079,Belleuse,299,0,413,413,1.4
89104,Chichée,299,1700,41,1741,5.8
5055,La Faurie,298,0,11152,11152,37.4
8473,Vieux-lès-Asfeld,298,0,5699,5699,19.1
9240,Quié,298,0,1150,1150,3.9
11165,Ginoles,298,0,3274,3274,11
16289,Roussines,298,1000,6131,7131,23.9
17345,Saint-Hilaire-du-Bois,298,0,3519,3519,11.8
17358,Saint-Mandé-sur-Brédoire,298,0,8301,8301,27.9
17479,Virollet,298,1248,4964,6212,20.8
24180,Firbeix,298,2950,983,3933,13.2
25461,Pompierre-sur-Doubs,298,0,687,687,2.3
26288,Sahune,298,0,15313,15313,51.4
28081,Charonville,298,0,1103,1103,3.7
28410,Villampuy,298,0,16284,16284,54.6
2B315,Santo-Pietro-di-Venaco,298,0,5148,5148,17.3
33431,Saint-Léon,298,0,29423,29423,98.7
33524,Tarnès,298,0,4485,4485,15.1
46316,Thédirac,298,0,8428,8428,28.3
50155,Crollon,298,0,7332,7332,24.6
53075,Cosmes,298,0,1973,1973,6.6
54429,Pierreville,298,0,3035,3035,10.2
57538,Pettoncourt,298,0,986,986,3.3
60653,Valescourt,298,0,1651,1651,5.5
67269,Littenheim,298,2203,21019,23222,77.9
67333,Niedersoultzbach,298,3539,8030,11569,38.8
70130,Charcenne,298,0,1348,1348,4.5
73131,Hautecour,298,0,23118,23118,77.6
76023,Anvéville,298,0,657,657,2.2
76553,Sainte-Agathe-d'Aliermont,298,0,2199,2199,7.4
77530,Voulton,298,0,1074,1074,3.6
79180,Montalembert,298,0,0,0,0
80275,Équancourt,298,0,2135,2135,7.2
80832,Yvrench,298,0,7379,7379,24.8
87016,Les Billanges,298,0,483,483,1.6
88131,Deycimont,298,0,391,391,1.3
89111,Les Clérimois,298,2520,578,3098,10.4
89400,Sougères-en-Puisaye,298,0,13456,13456,45.2
1247,Mijoux,297,0,3823,3823,12.9
2123,Brissay-Choigny,297,0,0,0,0
10339,Saint-Flavy,297,0,0,0,0
14097,Bretteville-le-Rabet,297,0,8979,8979,30.2
15030,Cayrols,297,3100,2604,5704,19.2
15084,Labesserette,297,2030,2604,4634,15.6
18287,Vinon,297,630,5351,5981,20.1
19263,Soudeilles,297,0,3810,3810,12.8
21037,Auxey-Duresses,297,0,1292,1292,4.4
22284,Saint-Connan,297,0,27350,27350,92.1
33263,Madirac,297,0,29324,29324,98.7
39447,Quintigny,297,1290,7894,9184,30.9
42243,Saint-Julien-d'Oddes,297,1551,2452,4003,13.5
45209,Montbarrois,297,0,2251,2251,7.6
51634,Villers-le-Château,297,0,15096,15096,50.8
54179,Éply,297,0,1758,1758,5.9
57075,Beux,297,0,11374,11374,38.3
57131,Château-Rouge,297,0,1789,1789,6
57300,Haselbourg,297,0,596,596,2
57471,Momerstroff,297,0,1789,1789,6
58035,Bona,297,0,1489,1489,5
58177,Montigny-en-Morvan,297,0,3500,3500,11.8
59353,Locquignol,297,0,838,838,2.8
60108,Briot,297,2020,1457,3477,11.7
60251,Fouquerolles,297,0,11646,11646,39.2
60328,Juvignies,297,0,11646,11646,39.2
60445,Nampcel,297,0,2012,2012,6.8
62180,Brias,297,0,6416,6416,21.6
62424,Hendecourt-lès-Cagnicourt,297,0,370,370,1.2
63439,Usson,297,0,1931,1931,6.5
64450,Pomps,297,0,4650,4650,15.7
70373,La Roche-Morey,297,0,899,899,3
70572,Vitrey-sur-Mance,297,0,899,899,3
71062,Brion,297,0,6645,6645,22.4
71281,Marly-sur-Arroux,297,0,1527,1527,5.1
71307,Montceaux-l'Étoile,297,0,6655,6655,22.4
73316,Villard-Sallet,297,0,5311,5311,17.9
80362,Frettemeule,297,0,6,6,0
82120,Montastruc,297,0,1514,1514,5.1
85261,Sainte-Pexine,297,0,6277,6277,21.1
88050,Belmont-sur-Buttant,297,0,390,390,1.3
88444,Le Saulcy,297,0,2888,2888,9.7
89021,Asquins,297,400,644,1044,3.5
89289,Paroy-sur-Tholon,297,700,2328,3028,10.2
95151,Chauvry,297,0,1931,1931,6.5
97352,Saül,297,0,1397,1397,4.7
1433,Vernoux,296,0,5722,5722,19.3
3293,Urçay,296,0,4654,4654,15.7
4058,Claret,296,8850,420,9270,31.3
5078,Monêtier-Allemont,296,0,8824,8824,29.8
7193,Rocher,296,6280,4663,10943,37
8060,Bergnicourt,296,0,5661,5661,19.1
16013,Angeac-Charente,296,1655,11075,12730,43
17217,Macqueville,296,0,8245,8245,27.9
17438,Tanzac,296,1080,4931,6011,20.3
18146,Ménétréol-sous-Sancerre,296,0,5333,5333,18
24401,Sainte-Eulalie-d'Ans,296,800,5177,5977,20.2
25383,Moncley,296,0,200,200,0.7
30121,Gailhan,296,0,615,615,2.1
30310,Saumane,296,0,14807,14807,50
32044,Béraut,296,0,1138,1138,3.8
36214,Sazeray,296,2865,6502,9367,31.6
38308,Plan,296,0,3229,3229,10.9
46124,Glanes,296,0,9657,9657,32.6
51116,Champguyon,296,0,3862,3862,13
51623,Ville-en-Selve,296,0,5260,5260,17.8
51655,Vouzy,296,0,5882,5882,19.9
53177,La Pellerine,296,0,1345,1345,4.5
54581,Ville-sur-Yron,296,0,2748,2748,9.3
57286,Halstroff,296,0,4261,4261,14.4
57453,Maxstadt,296,0,5054,5054,17.1
59175,Dimont,296,0,2345,2345,7.9
61459,Saires-la-Verrerie,296,3120,7928,11048,37.3
62022,Alincthun,296,0,855,855,2.9
62312,Estrée,296,0,3149,3149,10.6
70537,Velleminfroy,296,0,1095,1095,3.7
71111,Chassy,296,0,1522,1522,5.1
77367,Le Plessis-Placy,296,0,4346,4346,14.7
80151,Buire-sur-l'Ancre,296,0,331,331,1.1
80313,Flaucourt,296,0,2121,2121,7.2
85123,Liez,296,0,4639,4639,15.7
87153,Saint-Julien-le-Petit,296,0,4216,4216,14.2
89465,Villeperrot,296,500,55,555,1.9
1391,Salavre,295,0,5703,5703,19.3
2565,Œuilly,295,0,2121,2121,7.2
3181,Montcombroux-les-Mines,295,0,5095,5095,17.3
6129,Saint-Sauveur-sur-Tinée,295,0,5808,5808,19.7
10098,Chesley,295,0,5492,5492,18.6
16395,Vaux-Rouillac,295,294,20451,20745,70.3
18252,Sidiailles,295,0,791,791,2.7
21240,Échevannes,295,0,4199,4199,14.2
25622,Villers-Buzon,295,0,199,199,0.7
27057,Bernienville,295,4484,1269,5753,19.5
31074,Bonrepos-Riquet,295,0,3309,3309,11.2
31331,Maureville,295,0,1439,1439,4.9
35286,Saint-Léger-des-Prés,295,0,3693,3693,12.5
39145,Chille,295,1970,9297,11267,38.2
39412,Peseux,295,800,5987,6787,23
42067,Colombier,295,0,6036,6036,20.5
50205,La Godefroy,295,0,7258,7258,24.6
51360,Le Meix-Saint-Epoing,295,0,3849,3849,13
52383,Perrancey-les-Vieux-Moulins,295,0,1354,1354,4.6
54208,Francheville,295,0,615,615,2.1
57064,Berling,295,0,592,592,2
57723,Virming,295,0,976,976,3.3
60468,Nourard-le-Franc,295,0,1634,1634,5.5
61490,Tournai-sur-Dive,295,0,623,623,2.1
62272,Douchy-lès-Ayette,295,0,1467,1467,5
62697,Récourt,295,0,367,367,1.2
63228,Miremont,295,0,9976,9976,33.8
63445,Vassel,295,0,2830,2830,9.6
64458,Préchacq-Josbaig,295,0,6353,6353,21.5
68194,Lutter,295,0,7913,7913,26.8
71129,Chissey-en-Morvan,295,0,6600,6600,22.4
72166,Longnes,295,0,2681,2681,9.1
73014,Allondaz,295,0,6959,6959,23.6
76320,Grandcourt,295,0,2177,2177,7.4
77110,Chenou,295,0,311,311,1.1
80493,Louvencourt,295,0,330,330,1.1
80713,Saint-Quentin-en-Tourmont,295,0,7305,7305,24.8
81236,Saint-Agnan,295,0,964,964,3.3
88376,Rebeuville,295,0,3296,3296,11.2
2196,Clacy-et-Thierret,294,0,11228,11228,38.2
3311,Vicq,294,0,6014,6014,20.5
12125,Laval-Roquecezière,294,0,11504,11504,39.1
16402,Vibrac,294,1252,11000,12252,41.7
19239,Saint-Robert,294,0,4692,4692,16
21346,Leuglay,294,0,4905,4905,16.7
21652,Vandenesse-en-Auxois,294,0,4468,4468,15.2
25150,Chevigney-sur-l'Ognon,294,0,199,199,0.7
25233,Fallerans,294,0,3473,3473,11.8
34006,Aigne,294,0,1113,1113,3.8
34019,Avène,294,0,2737,2737,9.3
41228,Saint-Rimay,294,0,3636,3636,12.4
43017,Azérat,294,0,3293,3293,11.2
45328,Treilles-en-Gâtinais,294,0,2884,2884,9.8
53202,Saint-Berthevin-la-Tannière,294,0,3876,3876,13.2
54172,Doncourt-lès-Longuyon,294,0,3732,3732,12.7
56208,Saint-Brieuc-de-Mauron,294,0,4427,4427,15.1
59093,Boulogne-sur-Helpe,294,0,2329,2329,7.9
60137,Cernoy,294,0,1629,1629,5.5
60484,Oudeuil,294,0,1442,1442,4.9
62503,Leubringhen,294,0,1170,1170,4
64165,Cardesse,294,0,7916,7916,26.9
67201,Hirschland,294,1445,3686,5131,17.5
67401,Rimsdorf,294,0,3686,3686,12.5
67417,Rottelsheim,294,0,3575,3575,12.2
70417,Pontcey,294,0,755,755,2.6
77094,Charmentray,294,0,223,223,0.8
81008,Almayrac,294,0,6726,6726,22.9
95154,Chennevières-lès-Louvres,294,0,3646,3646,12.4
1128,Courtes,293,0,5664,5664,19.3
3020,Beaune-d'Allier,293,0,10467,10467,35.7
3317,Viplaix,293,0,1192,1192,4.1
4035,Brunet,293,0,3406,3406,11.6
4086,Faucon-de-Barcelonnette,293,9329,87503,96832,330.5
12182,Pierrefiche,293,0,27750,27750,94.7
16195,Lussac,293,532,6028,6560,22.4
18029,Bessais-le-Fromental,293,0,1291,1291,4.4
19115,Ligneyrac,293,0,1477,1477,5
19169,Puy-d'Arnac,293,0,1477,1477,5
19233,Saint-Pardoux-le-Vieux,293,0,4017,4017,13.7
21483,Pichanges,293,0,4170,4170,14.2
24512,Saint-Vincent-le-Paluel,293,475,1846,2321,7.9
25627,Villers-sous-Chalamont,293,0,6623,6623,22.6
27323,La Haye-Saint-Sylvestre,293,0,8240,8240,28.1
27359,Juignettes,293,0,8240,8240,28.1
28355,Saint-Ouen-Marchefroy,293,0,392,392,1.3
31241,Izaut-de-l'Hôtel,293,0,15747,15747,53.7
34201,Pierrerue,293,0,1657,1657,5.7
36144,Nuret-le-Ferron,293,0,1611,1611,5.5
41234,Santenay,293,1841,11230,13071,44.6
43122,Lissac,293,50,12192,12242,41.8
45135,Erceville,293,0,1066,1066,3.6
52061,Bourdons-sur-Rognon,293,0,4508,4508,15.4
52141,Condes,293,0,32184,32184,109.8
55204,Génicourt-sur-Meuse,293,0,1865,1865,6.4
58208,Pazy,293,0,4556,4556,15.5
58301,Vandenesse,293,0,15113,15113,51.6
60538,Ricquebourg,293,500,2562,3062,10.5
62061,Averdoingt,293,0,6330,6330,21.6
62821,Tingry,293,0,846,846,2.9
64172,Casteide-Candau,293,0,7889,7889,26.9
76243,Ernemont-sur-Buchy,293,0,200,200,0.7
76455,Morville-sur-Andelle,293,0,5535,5535,18.9
76619,Saint-Martin-le-Gaillard,293,0,1853,1853,6.3
77151,Dagny,293,0,1141,1141,3.9
80230,Curchy,293,0,5585,5585,19.1
89179,Fontenoy,293,3993,13230,17223,58.8
3086,Coulanges,292,0,1132,1132,3.9
4167,La Robine-sur-Galabre,292,2210,12239,14449,49.5
11010,Antugnac,292,0,3844,3844,13.2
14250,Esquay-sur-Seulles,292,0,11254,11254,38.5
15192,Saint-Jacques-des-Blats,292,2985,1304,4289,14.7
16036,Bécheresse,292,700,15614,16314,55.9
18101,Germigny-l'Exempt,292,0,92,92,0.3
18167,Nohant-en-Graçay,292,1570,4219,5789,19.8
19141,Monestier-Merlines,292,0,4003,4003,13.7
21435,Montliot-et-Courcelles,292,0,4872,4872,16.7
23097,Issoudun-Létrieix,292,0,3833,3833,13.1
24302,Nailhac,292,0,5107,5107,17.5
25155,Cléron,292,0,2128,2128,7.3
27027,Les Authieux,292,0,3434,3434,11.8
30247,Saint-Denis,292,0,11852,11852,40.6
31276,Larroque,292,0,6048,6048,20.7
33048,Berthez,292,0,2377,2377,8.1
46163,Laval-de-Cère,292,0,9527,9527,32.6
46238,Rignac,292,0,9527,9527,32.6
47276,Saint-Sardos,292,0,2805,2805,9.6
51031,Baconnes,292,0,14842,14842,50.8
51566,Thibie,292,0,14842,14842,50.8
52349,Neuilly-sur-Suize,292,0,32074,32074,109.8
57301,Haspelschiedt,292,0,6730,6730,23
57563,Raville,292,0,711,711,2.4
60572,Saint-Étienne-Roilaye,292,0,1978,1978,6.8
61121,Coulimer,292,2960,1025,3985,13.6
62388,Grigny,292,0,4623,4623,15.8
70253,Frasne-le-Château,292,0,1320,1320,4.5
78406,Milon-la-Chapelle,292,0,368,368,1.3
80245,Domléger-Longvillers,292,0,1138,1138,3.9
80266,Englebelmer,292,0,326,326,1.1
80473,Liancourt-Fosse,292,0,352,352,1.2
82059,Faudoas,292,0,6845,6845,23.4
84121,Sannes,292,0,1310,1310,4.5
88150,Dommartin-sur-Vraine,292,0,3262,3262,11.2
10104,Cormost,291,0,4155,4155,14.3
10255,Montreuil-sur-Barse,291,0,4155,4155,14.3
12034,Brandonnet,291,0,4998,4998,17.2
14335,Hotot-en-Auge,291,0,3697,3697,12.7
14651,Saint-Pierre-du-Jonquet,291,0,2342,2342,8
23113,Lupersat,291,0,3820,3820,13.1
25202,Dompierre-les-Tilleuls,291,0,4221,4221,14.5
30197,Les Plans,291,0,9096,9096,31.3
30234,Saint-Bénézet,291,0,605,605,2.1
32172,Labéjan,291,0,644,644,2.2
33399,Saint-Félix-de-Foncaude,291,0,2890,2890,9.9
35357,Villamée,291,0,3563,3563,12.2
39553,Le Vernois,291,2300,7735,10035,34.5
43069,Chenereilles,291,3550,6666,10216,35.1
50214,Gouvets,291,0,4304,4304,14.8
56103,Lantillac,291,0,4382,4382,15.1
61406,Saint-Hilaire-sur-Risle,291,0,3000,3000,10.3
62059,Autingues,291,0,1781,1781,6.1
62223,Chérisy,291,0,1447,1447,5
62275,Douriez,291,0,4607,4607,15.8
63363,Saint-Jacques-d'Ambur,291,0,9840,9840,33.8
65418,Sénac,291,0,6573,6573,22.6
67078,Crastatt,291,800,15805,16605,57.1
68184,Liebsdorf,291,0,7806,7806,26.8
68373,Winkel,291,0,7806,7806,26.8
77366,Le Plessis-l'Évêque,291,0,221,221,0.8
78076,Boissets,291,0,2918,2918,10
79118,Fénery,291,0,7629,7629,26.2
88245,Hurbache,291,0,2829,2829,9.7
88259,Landaville,291,0,3251,3251,11.2
89285,Pailly,291,1850,54,1904,6.5
89437,Venouse,291,2220,40,2260,7.8
95301,Haute-Isle,291,0,1840,1840,6.3
1042,Bey,290,0,1174,1174,4
2716,Servais,290,0,5211,5211,18
5181,Villar-d'Arêne,290,0,20688,20688,71.3
8151,Écordal,290,0,6361,6361,21.9
11119,La Digne-d'Amont,290,2000,3817,5817,20.1
11193,Lasserre-de-Prouille,290,0,859,859,3
14665,Sallenelles,290,0,3684,3684,12.7
23179,Saint-Alpinien,290,0,10968,10968,37.8
24261,Mauzens-et-Miremont,290,4525,4026,8551,29.5
24277,Monfaucon,290,6799,6456,13255,45.7
25227,Étray,290,0,3426,3426,11.8
27276,Gamaches-en-Vexin,290,0,236,236,0.8
28095,Chauffours,290,0,8450,8450,29.1
32202,Laujuzan,290,0,193,193,0.7
32340,Réans,290,0,0,0,0
32372,Saint-Cricq,290,0,1094,1094,3.8
38427,Saint-Michel-de-Saint-Geoirs,290,0,3164,3164,10.9
39387,Nevy-lès-Dole,290,2320,5886,8206,28.3
47204,Peyrière,290,0,5401,5401,18.6
52105,Changey,290,0,1331,1331,4.6
54473,Saint-Firmin,290,0,0,0,0
55124,Consenvoye,290,0,3032,3032,10.5
57459,Merschweiller,290,0,4175,4175,14.4
63190,Larodde,290,0,908,908,3.1
64505,Sarpourenx,290,0,7809,7809,26.9
66042,Cassagnes,290,0,2415,2415,8.3
71337,Oyé,290,0,8218,8218,28.3
71518,Serrières,290,0,3941,3941,13.6
72126,Épineu-le-Chevreuil,290,0,2635,2635,9.1
73149,Lucey,290,0,1840,1840,6.3
76107,Bois-Guilbert,290,0,198,198,0.7
80626,Pissy,290,0,18592,18592,64.1
88006,Ambacourt,290,0,4168,4168,14.4
89331,Sainpuits,290,0,13095,13095,45.2
90007,Banvillars,290,1450,10118,11568,39.9
2324,Fontenelle,289,0,5154,5154,17.8
2518,Montlevon,289,0,6680,6680,23.1
10012,Arsonval,289,0,0,0,0
11407,Verdun-en-Lauragais,289,0,2539,2539,8.8
12074,Condom-d'Aubrac,289,0,9793,9793,33.9
14316,Grangues,289,0,3671,3671,12.7
23229,Saint-Pardoux-les-Cards,289,0,3794,3794,13.1
25537,Scey-Maisières,289,0,2106,2106,7.3
27066,Bézu-la-Forêt,289,0,235,235,0.8
27245,Fleury-la-Forêt,289,0,1902,1902,6.6
31005,Alan,289,0,5986,5986,20.7
31461,Rouède,289,0,15532,15532,53.7
33308,Omet,289,0,8862,8862,30.7
34287,Saint-Saturnin-de-Lucian,289,0,1561,1561,5.4
36240,Vijon,289,0,6348,6348,22
37256,Theneuil,289,0,7842,7842,27.1
37262,Trogues,289,0,7842,7842,27.1
38313,Ponsonnas,289,0,3026,3026,10.5
41192,Les Roches-l'Évêque,289,0,3575,3575,12.4
47035,Bourgougnague,289,0,5382,5382,18.6
51345,Mareuil-en-Brie,289,0,418,418,1.4
54042,Bainville-aux-Miroirs,289,0,0,0,0
59532,Saint-Georges-sur-l'Aa,289,0,35288,35288,122.1
61100,La Chapelle-Viel,289,0,2979,2979,10.3
61148,Durcet,289,0,7740,7740,26.8
62206,Campigneulles-les-Grandes,289,0,3075,3075,10.6
62499,Lépine,289,0,3075,3075,10.6
62581,Monchy-Cayeux,289,0,6243,6243,21.6
62597,Moyenneville,289,0,1437,1437,5
64391,Moncayolle-Larrory-Mendibieu,289,0,7510,7510,26
65435,Soulom,289,0,11834,11834,40.9
67126,Erckartswiller,289,509,7788,8297,28.7
67387,Reichsfeld,289,0,8937,8937,30.9
72347,Tassé,289,0,2626,2626,9.1
80536,Mesnil-Bruntel,289,0,2071,2071,7.2
80774,Vaire-sous-Corbie,289,0,38,38,0.1
81121,Lacabarède,289,16161,2495,18656,64.6
82053,Escazeaux,289,0,6774,6774,23.4
88301,Ménil-sur-Belvitte,289,0,1442,1442,5
95610,Théméricourt,289,0,13278,13278,45.9
1425,La Tranclière,288,0,5568,5568,19.3
3201,Nizerolles,288,0,7890,7890,27.4
5016,La Bâtie-Montsaléon,288,0,8586,8586,29.8
7170,Pailharès,288,4100,12672,16772,58.2
15082,Junhac,288,4681,2525,7206,25
17287,Pouillac,288,0,3401,3401,11.8
23065,Colondannes,288,0,8598,8598,29.9
26278,La Roche-sur-le-Buis,288,0,14799,14799,51.4
27451,Parville,288,0,3387,3387,11.8
28407,Vichères,288,0,112,112,0.4
33231,Laroque,288,0,8831,8831,30.7
33520,Taillecavat,288,0,2860,2860,9.9
40137,Lacquy,288,0,2751,2751,9.6
41114,Lestiou,288,0,867,867,3
46188,Maxou,288,0,2432,2432,8.4
48045,Chaudeyrac,288,1900,3392,5292,18.4
48166,Cans et Cévennes,288,0,7064,7064,24.5
53093,La Dorée,288,0,3797,3797,13.2
58255,Saint-Martin-du-Puy,288,0,3394,3394,11.8
60424,Montmartin,288,2600,269,2869,10
62831,Troisvaux,288,0,6222,6222,21.6
64492,Saint-Michel,288,0,7484,7484,26
67068,Buswiller,288,2100,7761,9861,34.2
74295,La Vernaz,288,0,20124,20124,69.9
76622,Saint-Maurice-d'Ételan,288,0,2195,2195,7.6
79111,Ensigné,288,0,8318,8318,28.9
81066,Caucalières,288,0,3029,3029,10.5
82172,Saint-Projet,288,0,4073,4073,14.1
1410,Sonthonnax-la-Montagne,287,0,10857,10857,37.8
10395,Vanlay,287,0,5343,5343,18.6
12193,Pruines,287,0,11842,11842,41.3
12195,Rebourguil,287,0,11230,11230,39.1
14195,Courvaudon,287,0,10642,10642,37.1
14206,Crocy,287,0,4496,4496,15.7
18053,Charentonnay,287,0,990,990,3.4
18112,Ids-Saint-Roch,287,0,769,769,2.7
21478,Pasques,287,0,1614,1614,5.6
21536,Sacquenay,287,0,198,198,0.7
24101,Champs-Romain,287,368,1923,2291,8
24459,Saint-Mayme-de-Péreyrol,287,3439,1603,5042,17.6
25362,Malpas,287,0,17092,17092,59.6
27074,Boisney,287,0,1237,1237,4.3
33024,Bagas,287,0,2337,2337,8.1
37168,Neuilly-le-Brignon,287,0,4982,4982,17.4
39106,Charchilla,287,1610,8353,9963,34.7
39552,Vernantois,287,1520,9045,10565,36.8
47284,Salles,287,0,7328,7328,25.5
50302,Le Mesnil-Amey,287,0,4245,4245,14.8
50395,La Pernelle,287,897,9027,9924,34.6
50514,Chaulieu,287,0,7061,7061,24.6
51003,Aigny,287,0,14588,14588,50.8
51014,Arcis-le-Ponsart,287,0,5101,5101,17.8
55214,Givrauval,287,0,3460,3460,12.1
60377,Maisoncelle-Tuilerie,287,0,6472,6472,22.6
60474,Ognolles,287,0,2509,2509,8.7
62184,Buissy,287,0,357,357,1.2
62733,Sailly-au-Bois,287,0,1427,1427,5
63407,Saulzet-le-Froid,287,0,898,898,3.1
64313,Lantabat,287,0,7458,7458,26
65427,Siradan,287,0,1878,1878,6.5
71343,Paris-l'Hôpital,287,0,1248,1248,4.3
71368,Reclesne,287,0,6421,6421,22.4
71441,Saint-Léger-sous-la-Bussière,287,0,3900,3900,13.6
72190,Marolles-lès-Saint-Calais,287,0,3880,3880,13.5
72368,Vancé,287,0,3880,3880,13.5
76362,Heurteauville,287,0,2187,2187,7.6
78070,Boinville-en-Mantois,287,0,2671,2671,9.3
80115,Bouchavesnes-Bergen,287,0,2056,2056,7.2
84066,Lioux,287,0,5850,5850,20.4
89364,Saint-Père,287,0,622,622,2.2
90006,Auxelles-Haut,287,600,8549,9149,31.9
2398,Juvigny,286,0,2393,2393,8.4
9075,Campagne-sur-Arize,286,0,5087,5087,17.8
9081,Le Carlaret,286,0,1288,1288,4.5
14244,Eraines,286,0,4480,4480,15.7
14378,Longueville,286,0,1980,1980,6.9
14540,Rocques,286,0,3184,3184,11.1
17290,Prignac,286,0,7966,7966,27.9
22085,Kerbors,286,0,5682,5682,19.9
24563,Valojoulx,286,1800,3970,5770,20.2
26224,Ourches,286,0,5797,5797,20.3
27312,Hardencourt-Cocherel,286,0,1503,1503,5.3
27319,La Haye-de-Routot,286,0,1172,1172,4.1
28162,Fresnay-le-Comte,286,0,8334,8334,29.1
28305,Pré-Saint-Évroult,286,0,526,526,1.8
32271,Monguilhem,286,0,190,190,0.7
33383,Saint-Christoly-Médoc,286,0,2515,2515,8.8
38090,Château-Bernard,286,0,8012,8012,28
40138,Lacrabe,286,0,6608,6608,23.1
40141,Lahosse,286,0,4479,4479,15.7
43079,Couteuges,286,2900,2604,5504,19.2
45251,Pierrefitte-ès-Bois,286,1060,3329,4389,15.3
47188,Montignac-de-Lauzun,286,0,5326,5326,18.6
51269,Giffaumont-Champaubert,286,0,1777,1777,6.2
52158,Cusey,286,0,3542,3542,12.4
59461,Petit-Fayt,286,0,2266,2266,7.9
60564,Sains-Morainvillers,286,0,1585,1585,5.5
62675,Quercamps,286,0,619,619,2.2
65006,Ancizan,286,0,13750,13750,48.1
65017,Aragnouet,286,0,13750,13750,48.1
65044,Aubarède,286,0,1816,1816,6.3
66044,Castelnou,286,0,3833,3833,13.4
67178,Gungwiller,286,0,3585,3585,12.5
68196,Magny,286,0,4072,4072,14.2
70102,Brussey,286,0,193,193,0.7
71013,Authumes,286,0,35,35,0.1
76542,Routes,286,2872,630,3502,12.2
83006,Artigues,286,0,2933,2933,10.3
87093,Masléon,286,0,133,133,0.5
89041,Beugnon,286,830,1848,2678,9.4
89084,Charentenay,286,100,12914,13014,45.5
89171,Foissy-sur-Vanne,286,2400,555,2955,10.3
2681,Saint-Gobert,285,0,5082,5082,17.8
2806,Villeneuve-sur-Fère,285,0,6588,6588,23.1
3178,Montaiguët-en-Forez,285,0,4922,4922,17.3
3232,Saint-Félix,285,0,4922,4922,17.3
5176,Valserres,285,0,2542,2542,8.9
10162,Fresnoy-le-Château,285,0,4070,4070,14.3
11320,Roquefeuil,285,0,3131,3131,11
14751,Vignats,285,0,4465,4465,15.7
15211,Saint-Santin-Cantalès,285,4440,2499,6939,24.3
17326,Saint-Eugène,285,0,3365,3365,11.8
18034,Bouzais,285,0,1256,1256,4.4
18221,Saint-Loup-des-Chaumes,285,0,5159,5159,18.1
22315,Saint-Maudez,285,0,7593,7593,26.6
24248,Lussas-et-Nontronneau,285,770,1910,2680,9.4
24580,Villac,285,1850,4984,6834,24
25095,Bretonvillers,285,0,7857,7857,27.6
31011,Arbas,285,0,15317,15317,53.7
32146,Gimbrède,285,0,162,162,0.6
32304,Panassac,285,0,3364,3364,11.8
39406,Le Pasquier,285,100,2886,2986,10.5
40215,Ousse-Suzan,285,0,4072,4072,14.3
40319,Trensacq,285,0,2242,2242,7.9
42171,Pinay,285,0,5166,5166,18.1
50235,La Haye-d'Ectot,285,2107,8965,11072,38.8
50282,Le Luot,285,0,7012,7012,24.6
51278,Les Grandes-Loges,285,0,14486,14486,50.8
51387,Moslins,285,0,5664,5664,19.9
51611,Vert-Toulon,285,0,5664,5664,19.9
52377,Parnoy-en-Bassigny,285,0,5621,5621,19.7
54358,Mazerulles,285,0,1686,1686,5.9
55085,Broussey-Raulecourt,285,0,3387,3387,11.9
57128,Charleville-sous-Bois,285,0,694,694,2.4
57381,Laneuveville-en-Saulnois,285,0,943,943,3.3
57387,Laumesfeld,285,0,4103,4103,14.4
58056,Champvoux,285,0,16085,16085,56.4
60207,Éméville,285,0,1116,1116,3.9
60599,Saint-Thibault,285,0,1398,1398,4.9
61473,Sevrai,285,0,602,602,2.1
71576,Le Villars,285,0,6633,6633,23.3
77522,Villiers-sur-Seine,285,1961,4036,5997,21
78417,Montchauvet,285,434,2858,3292,11.6
80023,Andechy,285,0,344,344,1.2
80159,Cachy,285,0,38,38,0.1
80359,Fresnoy-lès-Roye,285,0,344,344,1.2
80490,Longueval,285,0,2042,2042,7.2
80501,Maison-Ponthieu,285,0,7057,7057,24.8
82175,Saint-Vincent-Lespinasse,285,0,30621,30621,107.4
88061,Bleurville,285,0,2215,2215,7.8
88520,Les Voivres,285,0,7167,7167,25.1
2283,Erlon,284,0,1431,1431,5
3224,Saint-Clément,284,0,7780,7780,27.4
11392,Tournissan,284,0,3848,3848,13.5
12232,Saint-Jean-et-Saint-Paul,284,0,12161,12161,42.8
14320,Grimbosq,284,0,8586,8586,30.2
14427,Le Mesnil-Villement,284,0,4449,4449,15.7
14732,Vaux-sur-Aure,284,0,10946,10946,38.5
16137,Feuillade,284,4180,5065,9245,32.6
17206,Loiré-sur-Nie,284,0,7911,7911,27.9
18017,Augy-sur-Aubois,284,0,4551,4551,16
19128,Margerides,284,0,3893,3893,13.7
23117,Maison-Feyne,284,0,8479,8479,29.9
28030,Beauche,284,0,380,380,1.3
28323,Saint-Ange-et-Torçay,284,0,380,380,1.3
38438,Saint-Paul-lès-Monestier,284,0,7956,7956,28
53142,Madré,284,0,2526,2526,8.9
54331,Magnières,284,0,1255,1255,4.4
54558,Velaine-sous-Amance,284,0,1681,1681,5.9
55466,Salmagne,284,0,3424,3424,12.1
55566,Villers-sur-Meuse,284,0,1808,1808,6.4
58024,Bazolles,284,0,1423,1423,5
60048,Baugy,284,0,2483,2483,8.7
61283,Montabard,284,0,600,600,2.1
61433,Saint-Nicolas-des-Bois,284,1000,8393,9393,33.1
62731,Ruyaulcourt,284,0,1412,1412,5
65224,Houeydets,284,0,848,848,3
67531,Wildersbach,284,4206,20552,24758,87.2
70208,Échenoz-le-Sec,284,0,909,909,3.2
70487,Senargent-Mignafans,284,0,90,90,0.3
71103,Charmoy,284,0,4563,4563,16.1
73140,Jongieux,284,0,1802,1802,6.3
76048,Avesnes-en-Bray,284,0,5365,5365,18.9
89281,Les Ormes,284,3312,6717,10029,35.3
2752,Tugny-et-Pont,283,0,40447,40447,142.9
7149,Marcols-les-Eaux,283,2862,944,3806,13.4
24504,Saint-Sulpice-de-Roumagnac,283,0,2149,2149,7.6
25002,Abbans-Dessus,283,0,2062,2062,7.3
25124,Charmauvillers,283,0,1971,1971,7
25616,Villars-Saint-Georges,283,1620,4986,6606,23.3
28050,Boncourt,283,0,379,379,1.3
28170,Garancières-en-Drouais,283,0,379,379,1.3
28283,Nottonville,283,0,1486,1486,5.3
30097,Courry,283,0,11486,11486,40.6
31265,Lagraulet-Saint-Nicolas,283,0,2367,2367,8.4
32163,Jû-Belloc,283,0,5217,5217,18.4
38429,Saint-Michel-les-Portes,283,0,7928,7928,28
40325,Vielle-Tursan,283,0,8859,8859,31.3
47105,Frespech,283,0,1630,1630,5.8
50563,Saint-Vigor-des-Monts,283,0,4186,4186,14.8
59267,Gonnelieu,283,0,3678,3678,13
60551,Rousseloy,283,0,2911,2911,10.3
62009,Adinfer,283,0,2352,2352,8.3
63081,Champétières,283,400,2557,2957,10.4
63428,Teilhet,283,0,439,439,1.6
65084,Bernac-Dessus,283,0,2704,2704,9.6
70060,Beaumotte-lès-Pin,283,0,191,191,0.7
76214,Dénestanville,283,0,2284,2284,8.1
76485,Omonville,283,2970,2284,5254,18.6
82174,Saint-Vincent-d'Autéjac,283,0,8367,8367,29.6
2035,Audigny,282,0,1555,1555,5.5
3079,Cindré,282,0,4871,4871,17.3
3284,Thionne,282,0,4871,4871,17.3
7112,Labastide-sur-Bésorgues,282,0,4813,4813,17.1
15008,Antignac,282,4357,1443,5800,20.6
18124,Lazenay,282,2580,3826,6406,22.7
25372,Médière,282,0,650,650,2.3
28041,Blandainville,282,0,1043,1043,3.7
28290,Orrouer,282,0,1043,1043,3.7
33464,Saint-Pierre-de-Bat,282,0,2801,2801,9.9
37032,Bournan,282,0,4895,4895,17.4
40158,Losse,282,0,3221,3221,11.4
42247,Saint-Just-en-Bas,282,0,2527,2527,9
45166,Huêtre,282,0,398,398,1.4
45325,Tivernon,282,0,1026,1026,3.6
46094,Espédaillac,282,0,8328,8328,29.5
53052,Champfrémont,282,0,2508,2508,8.9
55001,Abainville,282,0,5512,5512,19.5
55449,Rupt-en-Woëvre,282,0,1795,1795,6.4
59182,Drincham,282,0,5431,5431,19.3
59439,Noyelles-sur-Sambre,282,0,10059,10059,35.7
60210,Épineuse,282,0,264,264,0.9
60553,Rouvillers,282,0,1562,1562,5.5
60594,Saint-Quentin-des-Prés,282,2220,1384,3604,12.8
62797,Siracourt,282,0,6092,6092,21.6
63294,Queuille,282,0,1860,1860,6.6
67142,Fort-Louis,282,0,3417,3417,12.1
71207,Fretterans,282,1515,35,1550,5.5
71286,Mary,282,0,4531,4531,16.1
71397,Sainte-Cécile,282,0,1960,1960,7
72060,La Chapelle-aux-Choux,282,0,1414,1414,5
74041,Bonnevaux,282,27196,14611,41807,148.3
78196,Davron,282,0,662,662,2.3
80624,Pierregot,282,0,1099,1099,3.9
82092,Lapenche,282,0,8338,8338,29.6
88458,Socourt,282,0,7092,7092,25.1
89045,Bleigny-le-Carreau,282,8364,5517,13881,49.2
89474,Villiers-Vineux,282,0,1822,1822,6.5
89479,Vincelottes,282,1800,5517,7317,25.9
2017,Anguilcourt-le-Sart,281,0,5049,5049,18
2409,Lappion,281,0,756,756,2.7
2614,Pontru,281,0,2546,2546,9.1
5111,Puy-Sanières,281,0,22455,22455,79.9
12103,Florentin-la-Capelle,281,0,9522,9522,33.9
17335,Saint-Georges-des-Agoûts,281,0,3318,3318,11.8
19102,Lamazière-Basse,281,0,3852,3852,13.7
21527,La Rochepot,281,0,1222,1222,4.3
23250,Saint-Yrieix-les-Bois,281,0,4589,4589,16.3
23261,Viersat,281,0,4224,4224,15
24034,Beleymas,281,1940,13456,15396,54.8
2A099,Cozzano,281,0,210,210,0.7
2B320,Tallone,281,0,2139,2139,7.6
31173,Esperce,281,0,1478,1478,5.3
32365,Saint-Blancard,281,0,3316,3316,11.8
32418,Sauveterre,281,0,1753,1753,6.2
33359,Roquebrune,281,0,2288,2288,8.1
37035,Braye-sous-Faye,281,0,7624,7624,27.1
39201,Doucier,281,810,8178,8988,32
43264,Villeneuve-d'Allier,281,1548,2559,4107,14.6
50362,Moulines,281,0,6914,6914,24.6
54016,Andilly,281,0,586,586,2.1
54242,Gye,281,0,586,586,2.1
55328,Maxey-sur-Vaise,281,0,1134,1134,4
57617,Saint-Jure,281,0,10761,10761,38.3
57761,Zilling,281,0,564,564,2
58082,Corancy,281,0,3311,3311,11.8
60347,Lannoy-Cuillère,281,0,1379,1379,4.9
62102,Bécourt,281,0,16628,16628,59.2
62615,Nielles-lès-Calais,281,0,8446,8446,30.1
64385,Miossens-Lanusse,281,0,4400,4400,15.7
65161,Escondeaux,281,0,6347,6347,22.6
71425,Saint-Gilles,281,0,7726,7726,27.5
76149,Butot,281,0,619,619,2.2
76364,Hodeng-Hodenger,281,0,5308,5308,18.9
77484,Vaucourtois,281,0,1094,1094,3.9
78009,Allainville,281,0,547,547,1.9
80291,Estrées-sur-Noye,281,0,18015,18015,64.1
80583,Nampty,281,0,388,388,1.4
80803,Villers-lès-Roye,281,0,339,339,1.2
81250,Saint-Genest-de-Contest,281,0,4203,4203,15
90096,Thiancourt,281,0,1671,1671,5.9
1045,Birieux,280,0,58,58,0.2
1087,Charix,280,0,10592,10592,37.8
3167,Mazirat,280,0,6591,6591,23.5
3175,Monestier,280,0,5727,5727,20.5
8499,Wasigny,280,0,6141,6141,21.9
10095,Le Chêne,280,0,238,238,0.8
14598,Saint-Jouin,280,0,3557,3557,12.7
24288,Montazeau,280,1980,976,2956,10.6
24413,Saint-Georges-Blancaneix,280,1525,6233,7758,27.7
25184,Cuse-et-Adrisans,280,0,646,646,2.3
25456,Plaimbois-du-Miroir,280,0,4702,4702,16.8
29083,Île-de-Sein,280,0,0,0,0
36084,Gournay,280,0,821,821,2.9
41182,Pray,280,0,3463,3463,12.4
47076,Cuq,280,0,6410,6410,22.9
54283,Jouaville,280,0,2600,2600,9.3
55267,Lachaussée,280,0,3327,3327,11.9
60672,Vez,280,0,1096,1096,3.9
62553,Marest,280,0,6049,6049,21.6
70296,Larians-et-Munans,280,0,896,896,3.2
71273,Maltat,280,0,1439,1439,5.1
76736,Veulettes-sur-Mer,280,0,1813,1813,6.5
80276,Équennes-Éramecourt,280,0,387,387,1.4
80709,Saint-Maulvis,280,0,387,387,1.4
95304,Hédouville,280,0,7391,7391,26.4
2671,Saint-Aubin,279,0,276,276,1
3051,Chambérat,279,0,1135,1135,4.1
7243,Saint-Jacques-d'Atticieux,279,3660,1437,5097,18.3
12041,Cabanès,279,0,8539,8539,30.6
21560,Saint-Martin-de-la-Mer,279,0,8606,8606,30.8
22352,Tréfumel,279,0,7433,7433,26.6
23142,Néoux,279,0,10552,10552,37.8
24126,Colombier,279,781,6211,6992,25.1
24414,Saint-Georges-de-Montclard,279,1594,13360,14954,53.6
24548,Teyjat,279,1720,1870,3590,12.9
32283,Montégut-Arros,279,0,617,617,2.2
39025,Augea,279,1160,4254,5414,19.4
45242,Ouzouer-des-Champs,279,1780,2861,4641,16.6
45337,Villamblain,279,0,393,393,1.4
52230,Gudmont-Villiers,279,0,1033,1033,3.7
52297,Luzy-sur-Marne,279,0,30646,30646,109.8
54406,Ogéviller,279,0,990,990,3.5
55489,Sivry-la-Perche,279,0,17293,17293,62
59395,Mazinghien,279,0,1917,1917,6.9
60698,Wacquemoulin,279,0,1546,1546,5.5
64381,Méritein,279,0,5832,5832,20.9
66105,Matemale,279,0,0,0,0
67070,Burbach,279,3400,3498,6898,24.7
70322,Mailleroncourt-Charette,279,0,1032,1032,3.7
70343,Mersuay,279,0,1657,1657,5.9
70407,Perrouse,279,0,2337,2337,8.4
71021,Baron,279,0,1082,1082,3.9
71553,Vareilles,279,0,5415,5415,19.4
76692,Thiouville,279,0,1807,1807,6.5
80066,Beaucourt-sur-l'Hallue,279,0,1088,1088,3.9
80185,Champien,279,0,337,337,1.2
80312,Fins,279,0,1999,1999,7.2
80595,La Neuville-Sire-Bernard,279,0,1714,1714,6.1
80647,Puzeaux,279,0,5049,5049,18.1
81242,Saint-Avit,279,0,311,311,1.1
88308,Mont-lès-Neufchâteau,279,0,3117,3117,11.2
89272,Moulins-sur-Ouanne,279,1470,12598,14068,50.4
90082,Autrechêne,279,0,9734,9734,34.9
91184,Courdimanche-sur-Essonne,279,0,9721,9721,34.8
2332,Fresnes-en-Tardenois,278,390,6426,6816,24.5
2637,Remaucourt,278,0,39732,39732,142.9
3130,Isle-et-Bardais,278,0,4371,4371,15.7
4138,Niozelles,278,0,5646,5646,20.3
7060,Châteauneuf-de-Vernoux,278,0,928,928,3.3
9101,Coussa,278,0,7472,7472,26.9
10281,Le Pavillon-Sainte-Julie,278,0,3970,3970,14.3
18204,Saint-Denis-de-Palin,278,0,2589,2589,9.3
28349,Saint-Lucien,278,0,1613,1613,5.8
31171,Espanès,278,0,4533,4533,16.3
32446,Tillac,278,0,5125,5125,18.4
33153,Doulezon,278,0,1940,1940,7
33288,Monprimblanc,278,0,8524,8524,30.7
36175,Rouvres-les-Bois,278,0,45,45,0.2
42100,La Gimond,278,0,6514,6514,23.4
50360,Morville,278,0,8744,8744,31.5
51290,Heiltz-l'Évêque,278,0,1631,1631,5.9
51354,Marson,278,0,464,464,1.7
55298,Loisey,278,0,3352,3352,12.1
55568,Ville-sur-Saulx,278,0,5434,5434,19.5
60449,Neufvy-sur-Aronde,278,0,2430,2430,8.7
61476,Suré,278,1033,5155,6188,22.3
62742,Saint-Aubin,278,0,2958,2958,10.6
64375,Méharin,278,0,7224,7224,26
65113,Burg,278,0,1765,1765,6.3
67181,Handschuheim,278,2830,5289,8119,29.2
69082,Émeringes,278,0,0,0,0
76134,Bourville,278,0,1800,1800,6.5
78404,Millemont,278,4760,120,4880,17.6
83005,Artignosc-sur-Verdon,278,0,1083,1083,3.9
86217,Saint-Christophe,278,0,6327,6327,22.8
89057,Brosses,278,1534,603,2137,7.7
90062,Larivière,278,0,9699,9699,34.9
2711,Serches,277,0,2317,2317,8.4
3266,Sanssat,277,0,4784,4784,17.3
9173,Loubens,277,0,7445,7445,26.9
19055,Chirac-Bellevue,277,0,3797,3797,13.7
21429,Montigny-Montfort,277,0,5396,5396,19.5
24482,Saint-Paul-Lizonne,277,2950,2103,5053,18.2
25317,Jallerange,277,0,187,187,0.7
26203,Montjoyer,277,0,7457,7457,26.9
28284,Oinville-Saint-Liphard,277,0,1455,1455,5.3
32347,Roquefort,277,0,9760,9760,35.2
33027,Barie,277,4067,2255,6322,22.8
33181,Gardegan-et-Tourtirac,277,0,10762,10762,38.9
36135,Moulins-sur-Céphons,277,0,45,45,0.2
39480,Saint-Didier,277,947,8730,9677,34.9
41253,Talcy,277,0,834,834,3
43192,Saint-Haon,277,3595,1343,4938,17.8
46133,Issepts,277,0,8180,8180,29.5
51185,Courgivaux,277,0,3614,3614,13
55248,Houdelaincourt,277,0,5414,5414,19.5
55512,Tilly-sur-Meuse,277,0,1763,1763,6.4
57504,Niderhoff,277,0,1803,1803,6.5
59061,Beaurepaire-sur-Sambre,277,0,2194,2194,7.9
61005,Appenai-sous-Bellême,277,0,3216,3216,11.6
61277,La Mesnière,277,2630,973,3603,13
63152,Espinasse,277,0,430,430,1.6
70221,Étobon,277,0,1809,1809,6.5
71065,Buffières,277,0,1925,1925,6.9
76345,Haussez,277,0,5233,5233,18.9
76375,Ingouville,277,0,1794,1794,6.5
76629,Saint-Ouen-le-Mauger,277,0,2235,2235,8.1
77066,Cerneux,277,0,999,999,3.6
79243,Saint-Coutant,277,0,8000,8000,28.9
80183,Cerisy-Buleux,277,0,382,382,1.4
80301,Famechon,277,0,382,382,1.4
89336,Saint-Brancher,277,1500,601,2101,7.6
91619,Torfou,277,0,1876,1876,6.8
3312,Vieure,276,0,4240,4240,15.4
8084,Brienne-sur-Aisne,276,0,5278,5278,19.1
12233,Saint-Juéry,276,0,578,578,2.1
14032,Les Authieux-sur-Calonne,276,0,4436,4436,16.1
14369,Litteau,276,0,1911,1911,6.9
19029,Branceilles,276,0,1391,1391,5
21128,Chailly-sur-Armançon,276,0,4195,4195,15.2
23136,Mortroux,276,0,742,742,2.7
31571,Vendine,276,0,1346,1346,4.9
32209,Lelin-Lapujolle,276,0,2763,2763,10
33156,Escoussans,276,0,8463,8463,30.7
34190,Oupia,276,0,1045,1045,3.8
38404,Saint-Jean-le-Vieux,276,0,5128,5128,18.6
39445,Publy,276,1630,8698,10328,37.4
40115,Gousse,276,0,4322,4322,15.7
46136,Labastide-du-Vert,276,0,2330,2330,8.4
47267,Saint-Pierre-de-Buzet,276,0,2651,2651,9.6
49056,Carbay,276,0,275,275,1
51023,Aulnay-sur-Marne,276,0,14028,14028,50.8
52488,Thivet,276,0,30317,30317,109.8
53041,Brains-sur-les-Marches,276,0,1827,1827,6.6
55274,Lamorville,276,0,3280,3280,11.9
55346,Montfaucon-d'Argonne,276,0,2886,2886,10.5
55509,Thonne-le-Thil,276,0,9867,9867,35.8
55531,Vassincourt,276,0,6126,6126,22.2
57139,Chérisey,276,0,10569,10569,38.3
57507,Niedervisse,276,0,1662,1662,6
58157,Marigny-l'Église,276,0,3252,3252,11.8
58306,Verneuil,276,0,712,712,2.6
61015,Aunou-sur-Orne,276,8254,1732,9986,36.2
63184,Lachaux,276,0,6399,6399,23.2
64228,Gabat,276,0,7172,7172,26
64262,Higuères-Souye,276,0,2881,2881,10.4
64512,Sauvelade,276,0,7432,7432,26.9
67099,Domfessel,276,1061,3460,4521,16.4
71136,Clessy,276,0,1419,1419,5.1
71355,Pontoux,276,0,3185,3185,11.5
72309,Saint-Paul-le-Gaultier,276,0,12991,12991,47.1
2624,Proisy,275,0,1516,1516,5.5
12190,Prévinquières,275,0,6380,6380,23.2
14135,Carcagny,275,0,3371,3371,12.3
17426,Le Seure,275,0,8716,8716,31.7
21172,Chivres,275,0,2062,2062,7.5
21301,Glanon,275,0,2062,2062,7.5
24518,Salon,275,1010,1536,2546,9.3
26259,Ratières,275,1300,4527,5827,21.2
26285,Rousset-les-Vignes,275,0,7403,7403,26.9
30160,Maruéjols-lès-Gardon,275,0,572,572,2.1
33329,Pompéjac,275,0,2812,2812,10.2
35244,Romazy,275,0,8430,8430,30.7
39437,Pont-du-Navoy,275,1538,2784,4322,15.7
39502,Santans,275,1552,2663,4215,15.3
42274,Saint-Polgues,275,0,2270,2270,8.3
42303,Souternon,275,1660,2270,3930,14.3
45086,Châtillon-le-Roi,275,0,1000,1000,3.6
46200,Montcléra,275,0,7778,7778,28.3
47141,Laussou,275,0,7022,7022,25.5
52021,Attancourt,275,0,2491,2491,9.1
52274,Latrecey-Ormoy-sur-Aube,275,0,1508,1508,5.5
52407,Prez-sous-Lafauche,275,0,4231,4231,15.4
52544,Voisey,275,0,5424,5424,19.7
58171,Montapas,275,0,14185,14185,51.6
59412,Montay,275,0,1890,1890,6.9
61244,Mahéru,275,3770,2835,6605,24
61304,Neuilly-le-Bisson,275,1587,97,1684,6.1
67209,Hohfrankenheim,275,0,9242,9242,33.6
67394,Retschwiller,275,400,7577,7977,29
68282,Romagny,275,0,3916,3916,14.2
70507,Trésilley,275,0,2303,2303,8.4
71403,Saint-Denis-de-Vaux,275,0,7561,7561,27.5
77012,Augers-en-Brie,275,0,992,992,3.6
79226,Le Retail,275,0,7210,7210,26.2
80395,Guerbigny,275,0,332,332,1.2
82029,Castanet,275,0,3889,3889,14.1
88021,Autrey,275,0,1372,1372,5
88065,Bonvillet,275,0,2138,2138,7.8
3137,Langy,274,0,4732,4732,17.3
5057,Fouillouse,274,0,388,388,1.4
7234,Saint-Étienne-de-Valoux,274,3330,4511,7841,28.6
8417,Sévigny-la-Forêt,274,0,4266,4266,15.6
10124,Dierrey-Saint-Julien,274,0,0,0,0
14455,Moulines,274,0,8284,8284,30.2
18153,Morlac,274,0,734,734,2.7
19251,Sarran,274,0,3515,3515,12.8
21271,Flavigny-sur-Ozerain,274,0,0,0,0
21419,Molesme,274,0,4571,4571,16.7
2A232,Pila-Canale,274,0,205,205,0.7
32384,Saint-Lary,274,0,9654,9654,35.2
35134,Les Iffs,274,0,3430,3430,12.5
36105,Lureuil,274,0,1506,1506,5.5
37140,Luzé,274,0,7435,7435,27.1
39187,Cuvier,274,640,2774,3414,12.5
40016,Aubagnan,274,0,6331,6331,23.1
45088,Chaussy,274,1670,997,2667,9.7
47129,Lagarrigue,274,0,2632,2632,9.6
51484,Saint-Gilles,274,0,4870,4870,17.8
53132,Levaré,274,0,3613,3613,13.2
55388,Noyers-Auzécourt,274,0,6081,6081,22.2
57461,Métairies-Saint-Quirin,274,0,1784,1784,6.5
58147,Lurcy-le-Bourg,274,0,15464,15464,56.4
59633,Wallers-en-Fagne,274,0,4495,4495,16.4
61193,La Gonfrière,274,0,2825,2825,10.3
62429,Henneveux,274,0,791,791,2.9
64043,Argelos,274,0,4290,4290,15.7
64543,Urepel,274,0,7120,7120,26
65360,Peyrouse,274,0,2618,2618,9.6
65456,Uglas,274,0,818,818,3
69180,Saint-André-la-Côte,274,0,8793,8793,32.1
71376,Roussillon-en-Morvan,274,0,6130,6130,22.4
71465,Saint-Micaud,274,0,4403,4403,16.1
71529,Suin,274,0,1062,1062,3.9
76612,Saint-Martin-au-Bosc,274,0,5,5,0
76695,Tocqueville-les-Murs,274,0,3245,3245,11.8
77041,Boissy-aux-Cailles,274,0,2281,2281,8.3
77526,Vincy-Manœuvre,274,0,4023,4023,14.7
80089,Berneuil,274,0,1068,1068,3.9
80807,Ville-sur-Ancre,274,0,306,306,1.1
81179,Montgey,274,0,5570,5570,20.3
82014,Beaupuy,274,0,3677,3677,13.4
82166,Saint-Michel,274,0,29439,29439,107.4
88366,Rainville,274,0,3061,3061,11.2
1002,L'Abergement-de-Varey,273,0,4659,4659,17.1
3272,Servilly,273,0,549,549,2
7290,Saint-Prix,273,2560,7816,10376,38
14529,Ranchy,273,0,10522,10522,38.5
15159,Raulhac,273,3090,1220,4310,15.8
16047,Blanzaguet-Saint-Cybard,273,2860,12837,15697,57.5
18173,Osmery,273,0,2543,2543,9.3
19257,Sérilhac,273,0,1376,1376,5
21259,Fain-lès-Montbard,273,0,5318,5318,19.5
24190,Fouleix,273,5020,1525,6545,24
24458,Saint-Martin-le-Pin,273,200,1829,2029,7.4
27315,Harquency,273,0,1434,1434,5.3
33209,Jugazan,273,0,1905,1905,7
34262,Saint-Guiraud,273,0,1475,1475,5.4
38245,Montagne,273,0,4412,4412,16.2
40054,Brassempouy,273,0,741,741,2.7
40121,Hauriet,273,0,4275,4275,15.7
42314,La Tuilière,273,5281,5121,10402,38.1
46178,Loupiac,273,0,8907,8907,32.6
47058,Caubeyres,273,0,4607,4607,16.9
50589,Tanis,273,0,6717,6717,24.6
51277,Sainte-Marie-du-Lac-Nuisement,273,0,1696,1696,6.2
51625,Villeneuve-la-Lionne,273,0,3562,3562,13
52172,Dommartin-le-Saint-Père,273,0,1011,1011,3.7
57172,Denting,273,0,1644,1644,6
57489,Mouterhouse,273,0,6292,6292,23
59442,Obrechies,273,0,9738,9738,35.7
60617,Sermaize,273,0,0,0,0
62111,Berlencourt-le-Cauroy,273,0,2268,2268,8.3
62398,Guisy,273,0,4322,4322,15.8
62636,Offrethun,273,0,1086,1086,4
62715,Rocquigny,273,0,1357,1357,5
62719,Rollancourt,273,0,4322,4322,15.8
63289,Prondines,273,0,9232,9232,33.8
65409,Sarriac-Bigorre,273,0,6167,6167,22.6
70081,Bouhans-lès-Lure,273,0,1010,1010,3.7
70195,Dambenoît-lès-Colombe,273,0,1010,1010,3.7
70254,Frédéric-Fontaine,273,0,463,463,1.7
80374,Gapennes,273,0,6760,6760,24.8
82040,Cayriech,273,0,8072,8072,29.6
87090,Mailhac-sur-Benaize,273,2935,4646,7581,27.8
88121,Damas-aux-Bois,273,0,6865,6865,25.1
89148,Druyes-les-Belles-Fontaines,273,3515,12327,15842,58
7133,Larnas,272,0,21683,21683,79.7
7303,Saint-Vincent-de-Durfort,272,0,908,908,3.3
8006,Alland'Huy-et-Sausseuil,272,0,5966,5966,21.9
8158,Étrépigny,272,0,6248,6248,23
9177,Madière,272,0,1225,1225,4.5
9254,Saint-Amadou,272,0,1225,1225,4.5
11302,Puilaurens,272,0,2988,2988,11
15127,Molompize,272,3370,61,3431,12.6
16125,Édon,272,1913,12790,14703,54.1
17195,La Jarrie-Audouin,272,0,7576,7576,27.9
18230,Saint-Pierre-les-Bois,272,0,729,729,2.7
19053,Chaveroche,272,455,3729,4184,15.4
21088,Boncourt-le-Bois,272,0,1304,1304,4.8
21272,Le Val-Larrey,272,0,5776,5776,21.2
22006,Berhet,272,0,5403,5403,19.9
22317,Saint-Méloir-des-Bois,272,0,7246,7246,26.6
24015,Audrix,272,3750,3776,7526,27.7
25281,Goux-lès-Dambelin,272,0,17219,17219,63.3
27144,Champigny-la-Futelaye,272,0,3199,3199,11.8
27627,Le Theil-Nolent,272,0,4189,4189,15.4
28263,Montigny-sur-Avre,272,0,7650,7650,28.1
30194,Peyremale,272,0,11040,11040,40.6
30261,Saint-Hippolyte-de-Caton,272,0,8502,8502,31.3
32020,Aux-Aussat,272,0,602,602,2.2
36178,Saint-Aigny,272,0,1495,1495,5.5
37105,Faye-la-Vineuse,272,0,7380,7380,27.1
40116,Gouts,272,0,6398,6398,23.5
47104,Frégimont,272,0,2613,2613,9.6
50334,Montabot,272,0,4596,4596,16.9
51402,Neuvy,272,0,3549,3549,13
52374,Le Pailly,272,0,5364,5364,19.7
58011,Armes,272,0,5691,5691,20.9
58312,Villiers-sur-Yonne,272,0,5691,5691,20.9
60618,Séry-Magneval,272,0,1065,1065,3.9
61030,La Bazoque,272,236,7285,7521,27.7
63343,Saint-Flour-l'Étang,272,0,6306,6306,23.2
67136,Eywiller,272,3700,3410,7110,26.1
72194,Meurcé,272,0,5044,5044,18.5
76538,Rosay,272,0,6354,6354,23.4
76620,Saint-Martin-l'Hortier,272,0,6354,6354,23.4
77220,Guercheville,272,0,139,139,0.5
80784,Vaux-sur-Somme,272,0,36,36,0.1
83002,Aiguines,272,0,1060,1060,3.9
89261,Molinons,272,1567,527,2094,7.7
95316,Jagny-sous-Bois,272,0,1573,1573,5.8
2353,Grandlup-et-Fay,271,0,1365,1365,5
2512,Montigny-l'Allier,271,0,6264,6264,23.1
5026,Ceillac,271,0,8811,8811,32.5
7267,Saint-Martial,271,3860,2119,5979,22.1
10195,Lhuître,271,0,231,231,0.9
17138,Dampierre-sur-Boutonne,271,0,7549,7549,27.9
18174,Osmoy,271,0,1249,1249,4.6
25115,Champagney,271,0,4775,4775,17.6
27674,Vaux-sur-Eure,271,0,1424,1424,5.3
30090,Concoules,271,0,8471,8471,31.3
33482,Saint-Sulpice-de-Pommiers,271,0,2691,2691,9.9
34235,Rosis,271,0,4794,4794,17.7
41013,Bauzy,271,0,1899,1899,7
41093,Françay,271,0,10386,10386,38.3
43037,Le Bouchet-Saint-Nicolas,271,4440,1314,5754,21.2
47181,Montagnac-sur-Lède,271,0,6920,6920,25.5
51033,Le Baizil,271,0,392,392,1.4
51363,Merlaut,271,0,1590,1590,5.9
54018,Anoux,271,0,2516,2516,9.3
54238,Gripport,271,0,0,0,0
60016,Ansacq,271,0,1126,1126,4.2
60020,Antilly,271,0,1061,1061,3.9
60488,Passel,271,0,0,0,0
64171,Casteide-Cami,271,0,7297,7297,26.9
64268,Idaux-Mendy,271,0,7042,7042,26
64368,Masparraute,271,0,7042,7042,26
64466,Rivehaute,271,0,5665,5665,20.9
71146,Cortambert,271,0,1884,1884,7
73242,Saint-Jean-d'Arves,271,0,7277,7277,26.9
81210,Poudis,271,0,5509,5509,20.3
82162,Saint-Georges,271,0,8013,8013,29.6
83114,Saint-Martin-de-Pallières,271,0,2780,2780,10.3
86150,Massognes,271,0,14083,14083,52
89408,Tannerre-en-Puisaye,271,1350,12237,13587,50.1
91578,Saint-Sulpice-de-Favières,271,0,1835,1835,6.8
2097,Boncourt,270,0,727,727,2.7
2158,Chamouille,270,0,10311,10311,38.2
2567,Ohis,270,0,5300,5300,19.6
2699,Saponay,270,0,6241,6241,23.1
2730,Soupir,270,0,532,532,2
5110,Puy-Saint-Vincent,270,0,18624,18624,69
7065,Chirols,270,2293,1109,3402,12.6
10258,Morvilliers,270,0,1607,1607,6
11416,Villarzel-Cabardès,270,0,1751,1751,6.5
17476,Villexavier,270,0,3188,3188,11.8
21717,Voulaines-les-Templiers,270,0,4505,4505,16.7
27038,Les Barils,270,0,7593,7593,28.1
2B047,Calacuccia,270,0,1015,1015,3.8
32300,Orbessan,270,0,3187,3187,11.8
35005,Arbrissel,270,0,5256,5256,19.5
36048,Chavin,270,0,1982,1982,7.3
40172,Mant,270,0,6238,6238,23.1
43067,Chavaniac-Lafayette,270,1963,2459,4422,16.4
45101,Combreux,270,0,525,525,1.9
45299,Saint-Sigismond,270,0,381,381,1.4
48119,Prévenchères,270,0,5472,5472,20.3
51205,Dampierre-au-Temple,270,0,0,0,0
51316,Larzicourt,270,0,1677,1677,6.2
51524,Saron-sur-Aube,270,0,3523,3523,13
53263,Thubœuf,270,0,10033,10033,37.2
54047,Barisey-la-Côte,270,0,8952,8952,33.2
57517,Obergailbach,270,0,6223,6223,23
58195,La Nocle-Maulaix,270,0,13927,13927,51.6
58275,Saxi-Bourdon,270,0,1353,1353,5
60585,Saint-Martin-aux-Bois,270,0,1496,1496,5.5
60604,Sarcus,270,0,1325,1325,4.9
62630,Noyelle-Vion,270,0,2244,2244,8.3
63286,Pouzol,270,0,1781,1781,6.6
65439,Tarasteix,270,0,6099,6099,22.6
68079,Elbach,270,0,3845,3845,14.2
70441,Recologne-lès-Rioz,270,0,2261,2261,8.4
72259,Rouperroux-le-Coquet,270,0,5007,5007,18.5
73047,Bonneval-sur-Arc,270,0,4771,4771,17.7
80226,Croix-Moligneaux,270,0,5146,5146,19.1
80285,Essertaux,270,0,373,373,1.4
89273,Moutiers-en-Puisaye,270,644,12192,12836,47.5
90036,Eguenigue,270,0,9420,9420,34.9
2419,Leschelle,269,0,4797,4797,17.8
2791,Veslud,269,0,10273,10273,38.2
3154,Luneau,269,0,4646,4646,17.3
3313,Le Vilhain,269,0,4229,4229,15.7
7077,Darbres,269,1220,8344,9564,35.6
7093,Genestelle,269,200,4591,4791,17.8
8373,Rumigny,269,0,7032,7032,26.1
11323,Roquetaillade-et-Conilhac,269,8050,3541,11591,43.1
11345,Saint-Jean-de-Barrou,269,0,414,414,1.5
14759,Villy-lez-Falaise,269,0,4214,4214,15.7
15131,Le Monteil,269,6590,1377,7967,29.6
15264,Vitrac,269,3080,2359,5439,20.2
18009,Arcomps,269,0,721,721,2.7
18116,Jalognes,269,0,4846,4846,18
22092,Kerpert,269,0,4817,4817,17.9
25059,Beutal,269,0,17029,17029,63.3
25489,Reugney,269,0,1960,1960,7.3
26192,Montbrison-sur-Lez,269,0,7242,7242,26.9
27380,Malleville-sur-le-Bec,269,0,1160,1160,4.3
28342,Saint-Jean-Pierre-Fixte,269,0,105,105,0.4
2B347,Vezzani,269,0,0,0,0
32321,Polastron,269,0,1678,1678,6.2
37244,Sazilly,269,0,7299,7299,27.1
41004,Artins,269,0,3327,3327,12.4
41283,Villemardy,269,0,3327,3327,12.4
42255,Saint-Marcel-d'Urfé,269,5384,5046,10430,38.8
50317,Le Mesnil-Ozenne,269,0,6619,6619,24.6
55229,Han-sur-Meuse,269,0,3964,3964,14.7
58081,Colméry,269,0,5363,5363,19.9
59236,Flesquières,269,0,3497,3497,13
67013,Asswiller,269,6309,3372,9681,36
88334,Oëlleville,269,0,3866,3866,14.4
89433,Vault-de-Lugny,269,0,583,583,2.2
2713,Seringes-et-Nesles,268,0,6195,6195,23.1
2808,Villeret,268,0,2428,2428,9.1
4233,Vaumeilh,268,0,7990,7990,29.8
10032,Baroville,268,0,0,0,0
11054,Les Brunels,268,0,5448,5448,20.3
14280,Formentin,268,0,4307,4307,16.1
14293,Fumichon,268,0,2983,2983,11.1
17209,Lonzac,268,0,3164,3164,11.8
17384,Saint-Pierre-de-l'Isle,268,0,7465,7465,27.9
21133,Chambolle-Musigny,268,0,1285,1285,4.8
24293,Monplaisant,268,5100,13119,18219,68
24552,Thonac,268,600,3720,4320,16.1
27567,Sainte-Marie-de-Vatimesnil,268,0,218,218,0.8
27584,Saint-Paul-de-Fourques,268,0,1155,1155,4.3
28060,Briconville,268,0,7809,7809,29.1
30322,Soudorgues,268,0,13406,13406,50
33134,Couquèques,268,0,2356,2356,8.8
34334,Vieussan,268,0,1014,1014,3.8
35185,Montautour,268,0,4026,4026,15
39141,Chevigny,268,1490,5439,6929,25.9
40199,Mouscardès,268,0,1994,1994,7.4
47085,Durance,268,0,4522,4522,16.9
50106,Cavigny,268,0,3964,3964,14.8
50195,Gathemo,268,0,6594,6594,24.6
51523,Sarcy,268,0,4763,4763,17.8
54363,Mercy-le-Haut,268,0,1181,1181,4.4
55025,Baâlon,268,0,9691,9691,36.2
57379,Landroff,268,0,4576,4576,17.1
60656,Varinfroy,268,0,1049,1049,3.9
62622,Nort-Leulinghem,268,0,23852,23852,89
62698,Recques-sur-Course,268,0,2851,2851,10.6
62886,Wicquinghem,268,0,15859,15859,59.2
63462,Virlet,268,0,416,416,1.6
64494,Saint-Pé-de-Léren,268,0,5602,5602,20.9
68106,Goldbach-Altenbach,268,0,2785,2785,10.4
70015,Amoncourt,268,0,1592,1592,5.9
70111,Calmoutier,268,0,992,992,3.7
72327,Sarcé,268,0,1344,1344,5
76162,Le Catelier,268,0,2163,2163,8.1
80002,Ablaincourt-Pressoir,268,0,4850,4850,18.1
80505,Carnoy-Mametz,268,0,300,300,1.1
80637,Port-le-Grand,268,0,6636,6636,24.8
80726,Sancourt,268,0,5108,5108,19.1
82043,Comberouger,268,0,3597,3597,13.4
84079,Monieux,268,0,4348,4348,16.2
88240,Herpelmont,268,0,352,352,1.3
88410,Sainte-Barbe,268,0,1337,1337,5
2445,Luzoir,267,0,4761,4761,17.8
3182,Monteignet-sur-l'Andelot,267,0,5461,5461,20.5
3191,Murat,267,0,9539,9539,35.7
10288,Plaines-Saint-Lange,267,0,4661,4661,17.5
10425,Villery,267,0,3813,3813,14.3
19223,Saint-Martin-Sepert,267,0,0,0,0
25257,Franey,267,0,180,180,0.7
25565,Touillon-et-Loutelet,267,0,15901,15901,59.6
27136,Chaignes,267,0,1403,1403,5.3
31143,Cier-de-Rivière,267,0,2556,2556,9.6
32457,Urdens,267,0,152,152,0.6
36081,Gargilesse-Dampierre,267,0,1960,1960,7.3
37255,Tavant,267,0,7245,7245,27.1
39253,Gigny,267,3630,7770,11400,42.7
40024,Banos,267,0,6169,6169,23.1
40204,Nerbis,267,0,4181,4181,15.7
51552,Songy,267,0,4212,4212,15.8
52237,Harréville-les-Chanteurs,267,0,4108,4108,15.4
54598,Xivry-Circourt,267,0,1176,1176,4.4
62018,Aix-en-Issart,267,0,4227,4227,15.8
62070,Bailleul-aux-Cornailles,267,0,2219,2219,8.3
62460,Hubersent,267,0,2840,2840,10.6
62760,Saint-Martin-d'Hardinghem,267,0,23763,23763,89
65189,Gayan,267,0,2551,2551,9.6
65301,Marseillan,267,0,1695,1695,6.3
66051,Clara-Villerach,267,0,7997,7997,30
67094,Dieffenthal,267,0,5137,5137,19.2
71389,Saint-Aubin-sur-Loire,267,0,1373,1373,5.1
71447,Saint-Mard-de-Vaux,267,0,7341,7341,27.5
73076,La Chapelle-du-Mont-du-Chat,267,0,1477,1477,5.5
76339,Le Hanouard,267,0,1729,1729,6.5
80835,Yzeux,267,0,459,459,1.7
88294,Mazeley,267,0,6714,6714,25.1
95024,Arthies,267,0,1688,1688,6.3
2801,Vigneux-Hocquet,266,0,2931,2931,11
3218,Saint-Aubin-le-Monial,266,0,4086,4086,15.4
8193,Givry,266,0,5834,5834,21.9
10300,Pougy,266,0,989,989,3.7
14202,Cricquebœuf,266,0,1988,1988,7.5
14744,Vienne-en-Bessin,266,0,10252,10252,38.5
15096,Lascelle,266,3750,9013,12763,48
17006,Allas-Champagne,266,0,3141,3141,11.8
19116,Liourdres,266,0,1341,1341,5
19241,Saint-Setiers,266,0,3647,3647,13.7
19271,Tudeils,266,0,1341,1341,5
24009,Anlhiac,266,0,3344,3344,12.6
24146,Creyssensac-et-Pissot,266,2236,1486,3722,14
25216,Écurcey,266,0,16839,16839,63.3
27490,Richeville,266,0,217,217,0.8
32243,Mauléon-d'Armagnac,266,0,0,0,0
38535,Vernas,266,0,1373,1373,5.2
40003,Angoumé,266,0,2277,2277,8.6
45174,Jouy-en-Pithiverais,266,1120,968,2088,7.8
47240,Saint-Étienne-de-Villeréal,266,0,6792,6792,25.5
51337,Magneux,266,0,4727,4727,17.8
51496,Saint-Lumier-en-Champagne,266,0,1561,1561,5.9
52118,Chatonrupt-Sommermont,266,0,985,985,3.7
54592,Vroncourt,266,0,0,0,0
55093,Buxières-sous-les-Côtes,266,0,3161,3161,11.9
57037,Aube,266,0,10187,10187,38.3
60186,Cuignières,266,0,1474,1474,5.5
60400,Le Mesnil-sur-Bulles,266,0,1474,1474,5.5
61213,Lalacelle,266,0,7861,7861,29.6
61435,Saint-Nicolas-de-Sommaire,266,4271,2742,7013,26.4
64073,Aubin,266,0,4165,4165,15.7
64426,Orin,266,0,5728,5728,21.5
67145,Friedolsheim,266,1500,18762,20262,76.2
70358,Montcey,266,0,13760,13760,51.7
72199,Moitron-sur-Sarthe,266,0,12521,12521,47.1
73090,La Compôte,266,0,3381,3381,12.7
80116,Bouchoir,266,0,4814,4814,18.1
81180,Montirat,266,0,6086,6086,22.9
88143,Domèvre-sur-Durbion,266,0,6689,6689,25.1
1206,Lantenay,265,0,10024,10024,37.8
8203,Guignicourt-sur-Vence,265,0,5812,5812,21.9
9009,Alzen,265,0,32113,32113,121.2
14602,Saint-Lambert,265,0,8012,8012,30.2
25583,Valonne,265,0,7306,7306,27.6
27063,Berville-la-Campagne,265,0,1142,1142,4.3
27204,Doudeauville-en-Vexin,265,0,216,216,0.8
27641,Le Tilleul-Lambert,265,0,1140,1140,4.3
30220,Roquedur,265,0,4274,4274,16.1
31008,Anan,265,0,5489,5489,20.7
33172,Fours,265,0,2712,2712,10.2
35114,Forges-la-Forêt,265,0,5159,5159,19.5
39449,Rainans,265,2400,5378,7778,29.4
43254,Vazeilles-Limandre,265,1450,11026,12476,47.1
59187,Éclaibes,265,0,9453,9453,35.7
61035,Beauvain,265,0,1192,1192,4.5
61281,Moncy,265,50,8953,9003,34
63053,Briffons,265,0,8961,8961,33.8
64358,Lucgarier,265,1800,2766,4566,17.2
65043,Astugue,265,0,1989,1989,7.5
65221,Hiis,265,0,1989,1989,7.5
77140,Coutençon,265,1440,3753,5193,19.6
80580,Nampont,265,0,6562,6562,24.8
81324,Viviers-lès-Lavaur,265,0,866,866,3.3
4162,Revest-des-Brousses,264,0,696,696,2.6
7153,Mayres,264,3346,1085,4431,16.8
7248,Saint-Jean-Roure,264,2050,5645,7695,29.1
11311,Ribaute,264,0,3577,3577,13.5
14723,Valsemé,264,0,4243,4243,16.1
18062,Le Chautay,264,0,84,84,0.3
18106,Grossouvre,264,0,4230,4230,16
23214,Saint-Martial-le-Mont,264,0,8278,8278,31.4
25263,Gellin,264,0,15723,15723,59.6
28308,Prudemanche,264,0,353,353,1.3
36023,Bouges-le-Château,264,0,43,43,0.2
46144,Lacave,264,0,8613,8613,32.6
46192,Meyronne,264,0,8613,8613,32.6
46312,Strenquels,264,0,8613,8613,32.6
48003,Allenc,264,8044,5350,13394,50.7
51550,Sompuis,264,0,4164,4164,15.8
54031,Autreville-sur-Moselle,264,0,2884,2884,10.9
54163,Domjevin,264,0,937,937,3.5
60263,Frétoy-le-Château,264,0,0,0,0
60289,Grez,264,0,1295,1295,4.9
62551,Marenla,264,0,4180,4180,15.8
62805,Tangry,264,0,5703,5703,21.6
63175,Herment,264,0,8927,8927,33.8
63402,Saint-Victor-Montvianeix,264,0,6121,6121,23.2
71071,Céron,264,0,5915,5915,22.4
71156,Cruzille,264,0,6144,6144,23.3
73314,Villard-d'Héry,264,0,4721,4721,17.9
76049,Avesnes-en-Val,264,0,1670,1670,6.3
76130,Bouelles,264,0,6167,6167,23.4
77416,Saint-Just-en-Brie,264,0,3399,3399,12.9
77424,Saint-Martin-du-Boschet,264,0,952,952,3.6
87037,La Chapelle-Montbrandeix,264,200,116,316,1.2
1067,Ceignes,263,0,9949,9949,37.8
1411,Souclin,263,0,4488,4488,17.1
2061,Becquigny,263,0,2383,2383,9.1
7196,Rocles,263,6118,18338,24456,93
8358,Remilly-les-Pothées,263,0,6876,6876,26.1
11398,Treilles,263,0,4067,4067,15.5
17388,Saint-Quantin-de-Rançanne,263,0,3105,3105,11.8
19204,Saint-Fréjoux,263,0,3605,3605,13.7
21004,Aignay-le-Duc,263,0,4388,4388,16.7
21150,Chassagne-Montrachet,263,0,1144,1144,4.3
28117,Crécy-Couvé,263,0,352,352,1.3
30150,Logrian-Florian,263,0,547,547,2.1
30205,Pougnadoresse,263,0,2021,2021,7.7
36209,Saint-Valentin,263,0,5342,5342,20.3
43022,Beaumont,263,0,12889,12889,49
45113,Courtemaux,263,0,797,797,3
47059,Caubon-Saint-Sauveur,263,0,2721,2721,10.3
50158,Cuves,263,0,6471,6471,24.6
51051,Berméricourt,263,0,4674,4674,17.8
62504,Leulinghem,263,0,569,569,2.2
63029,Bansat,263,0,1710,1710,6.5
64105,Béguios,263,0,6834,6834,26
64234,Garos,263,0,4118,4118,15.7
71422,Saint-Germain-lès-Buxy,263,0,4034,4034,15.3
72254,Rouessé-Fontaine,263,0,12380,12380,47.1
76175,Clais,263,0,1941,1941,7.4
77523,Villuis,263,2600,3725,6325,24
81020,Aussac,263,0,14450,14450,54.9
81287,Sieurac,263,0,5487,5487,20.9
86250,Saix,263,0,1343,1343,5.1
1198,Joyeux,262,0,4471,4471,17.1
1359,Saint-Germain-sur-Renon,262,0,55,55,0.2
2734,Taillefontaine,262,0,252,252,1
3071,Chavroches,262,0,4525,4525,17.3
3213,Reugny,262,0,366,366,1.4
7054,Chanéac,262,4204,5602,9806,37.4
7276,Saint-Michel-d'Aurance,262,2624,5602,8226,31.4
13011,Les Baux-de-Provence,262,0,482,482,1.8
14399,Manneville-la-Pipard,262,0,4211,4211,16.1
14605,Saint-Laurent-sur-Mer,262,0,1814,1814,6.9
21304,Grancey-le-Château-Neuvelle,262,0,181,181,0.7
23160,Reterre,262,0,3440,3440,13.1
26019,Aurel,262,0,7121,7121,27.2
27363,Le Landin,262,0,1073,1073,4.1
28028,Bazoches-en-Dunois,262,0,1376,1376,5.3
30079,Chambon,262,0,8189,8189,31.3
32452,Tournecoupe,262,0,989,989,3.8
36076,Fontgombault,262,0,1440,1440,5.5
39534,La Tour-du-Meix,262,2530,7625,10155,38.8
46112,Francoulès,262,0,2212,2212,8.4
50278,Le Loreur,262,0,6341,6341,24.2
51581,Treslon,262,0,4656,4656,17.8
55171,Eix,262,0,4733,4733,18.1
57497,Nelling,262,0,3581,3581,13.7
60304,Haute-Épine,262,2070,1285,3355,12.8
62406,Hamelincourt,262,0,1303,1303,5
62808,Teneur,262,0,5660,5660,21.6
63046,Boudes,262,0,1703,1703,6.5
64008,Ahaxe-Alciette-Bascassan,262,0,6808,6808,26
64244,Geüs-d'Oloron,262,5850,5642,11492,43.9
65248,Lahitte-Toupière,262,0,5918,5918,22.6
73042,Billième,262,0,1662,1662,6.3
76076,Bénarville,262,0,3103,3103,11.8
80640,Pozières,262,0,293,293,1.1
80659,Raincheval,262,0,293,293,1.1
86023,Berthegon,262,0,1338,1338,5.1
88400,Rouvres-en-Xaintois,262,0,3765,3765,14.4
2728,Sorbais,261,0,4654,4654,17.8
3024,Bert,261,0,525,525,2
7029,Beaumont,261,100,18199,18299,70.1
7044,Brossainc,261,1040,1345,2385,9.1
9204,Montesquieu-Avantès,261,0,31628,31628,121.2
10215,Magny-Fouchard,261,0,1553,1553,6
15259,Vieillespesse,261,2500,5773,8273,31.7
21367,Magny-Montarlot,261,0,0,0,0
21702,Villey-sur-Tille,261,0,3715,3715,14.2
22276,Saint-Bihy,261,0,4140,4140,15.9
24562,Vallereuil,261,900,1423,2323,8.9
27078,La Boissière,261,0,1371,1371,5.3
27083,Bonneville-Aptot,261,0,5896,5896,22.6
28166,Friaize,261,0,966,966,3.7
2B290,Speloncato,261,0,3663,3663,14
31511,Saint-Pierre,261,0,2927,2927,11.2
32112,Crastes,261,0,9196,9196,35.2
32133,Fourcès,261,0,1004,1004,3.8
32444,Thoux,261,0,985,985,3.8
34121,Joncels,261,0,2430,2430,9.3
38379,Saint-Clair-sur-Galaure,261,0,2848,2848,10.9
43240,Solignac-sous-Roche,261,540,23570,24110,92.4
47084,Douzains,261,0,6664,6664,25.5
55077,Breux,261,0,9331,9331,35.8
57291,Hangviller,261,0,524,524,2
62522,Loison-sur-Créquoise,261,0,4132,4132,15.8
62685,Radinghem,261,0,15445,15445,59.2
62867,Wacquinghen,261,0,1038,1038,4
66188,Saint-Pierre-dels-Forcats,261,0,0,0,0
70202,Demangevelle,261,0,1659,1659,6.4
76422,Melleville,261,0,751,751,2.9
76642,Saint-Pierre-le-Viger,261,0,1690,1690,6.5
77190,Fontains,261,0,3360,3360,12.9
81280,Le Ségur,261,0,5971,5971,22.9
89451,Villechétive,261,1888,506,2394,9.2
91508,Puiselet-le-Marais,261,0,657,657,2.5
2208,Concevreux,260,0,700,700,2.7
3114,La Ferté-Hauterive,260,0,5318,5318,20.5
6017,Bézaudun-les-Alpes,260,0,3151,3151,12.1
8148,L'Écaille,260,0,4972,4972,19.1
10234,Mesgrigny,260,0,267,267,1
10270,Onjon,260,0,967,967,3.7
10433,Villy-en-Trodes,260,0,4539,4539,17.5
19044,La Chapelle-aux-Saints,260,0,1311,1311,5
21636,Thury,260,0,1131,1131,4.4
24242,Liorac-sur-Louyre,260,5725,945,6670,25.7
25029,Aubonne,260,0,2847,2847,11
26352,La Touche,260,1840,2505,4345,16.7
27472,Portes,260,0,2313,2313,8.9
28296,Péronville,260,0,1366,1366,5.3
31289,Lécussan,260,0,5386,5386,20.7
34220,Le Puech,260,0,2920,2920,11.2
36092,Langé,260,0,3264,3264,12.6
36190,Sainte-Fauste,260,0,5281,5281,20.3
39172,Courtefontaine,260,754,4103,4857,18.7
40012,Artassenx,260,0,1215,1215,4.7
50421,Quinéville,260,0,8178,8178,31.5
51129,Charleville,260,0,8353,8353,32.1
51553,Souain-Perthes-lès-Hurlus,260,0,2446,2446,9.4
54287,Lachapelle,260,0,1149,1149,4.4
57747,Wintersbourg,260,0,522,522,2
61206,L'Hôme-Chamondot,260,4166,1107,5273,20.3
62871,Wambercourt,260,0,4116,4116,15.8
64219,Estialescq,260,0,5599,5599,21.5
71586,Viry,260,0,1008,1008,3.9
76578,Sainte-Geneviève,260,0,6074,6074,23.4
76664,Sasseville,260,0,1684,1684,6.5
77228,Hondevilliers,260,0,4281,4281,16.5
80593,La Neuville-lès-Bray,260,0,291,291,1.1
80662,Ramburelles,260,0,5,5,0
86085,Coussay,260,0,13511,13511,52
88256,Jussarupt,260,0,341,341,1.3
1387,Saint-Sulpice,259,0,5007,5007,19.3
3037,Braize,259,0,4072,4072,15.7
3239,Saint-Léger-sur-Vouzance,259,0,4473,4473,17.3
9322,Ustou,259,0,31385,31385,121.2
10076,Champignol-lez-Mondeville,259,0,0,0,0
10370,Soligny-les-Étangs,259,0,1600,1600,6.2
11035,Belvianes-et-Cavirac,259,0,2845,2845,11
11153,La Force,259,3847,767,4614,17.8
12039,Brusque,259,0,10134,10134,39.1
14368,Lisores,259,0,2883,2883,11.1
21002,Agey,259,0,1457,1457,5.6
23038,Bussière-Saint-Georges,259,0,3893,3893,15
24537,Siorac-de-Ribérac,259,802,1967,2769,10.7
25121,Chapelle-des-Bois,259,0,15425,15425,59.6
25246,Fontaine-lès-Clerval,259,0,597,597,2.3
28080,Charbonnières,259,0,101,101,0.4
2B332,Urtaca,259,0,3635,3635,14
33072,Brannens,259,0,2109,2109,8.1
36065,Diou,259,0,6115,6115,23.6
45205,Mézières-en-Gâtinais,259,0,2656,2656,10.3
51216,Dontrien,259,0,4603,4603,17.8
51654,Vouillers,259,0,2346,2346,9.1
54072,Bezaumont,259,0,2830,2830,10.9
57249,Glatigny,259,0,631,631,2.4
57590,Rolbing,259,0,5969,5969,23
60031,Autheuil-en-Valois,259,0,1014,1014,3.9
61054,Le Bosc-Renoult,259,1540,1872,3412,13.2
62015,Airon-Notre-Dame,259,0,2755,2755,10.6
62343,Fontaine-lès-Croisilles,259,0,1288,1288,5
63130,La Crouzille,259,0,402,402,1.6
65406,Sarniguet,259,0,2474,2474,9.6
65415,Ségus,259,0,2474,2474,9.6
68105,Gildwiller,259,3770,3688,7458,28.8
71547,Trivy,259,0,3520,3520,13.6
72076,Chenay,259,0,7654,7654,29.6
76062,Beaumont-le-Hareng,259,3264,177,3441,13.3
76177,Claville-Motteville,259,0,177,177,0.7
79256,Saint-Germier,259,0,6790,6790,26.2
89352,Saint-Martin-des-Champs,259,2400,11695,14095,54.4
1282,Outriaz,258,0,9760,9760,37.8
2341,Gercy,258,0,4601,4601,17.8
12069,Combret,258,0,10095,10095,39.1
14706,Tourville-en-Auge,258,0,4147,4147,16.1
15041,La Chapelle-d'Alagnon,258,1080,58,1138,4.4
15149,Paulhenc,258,1750,5707,7457,28.9
16246,Nonac,258,2200,12132,14332,55.6
18200,Saint-Bouize,258,0,4648,4648,18
18225,Saint-Maur,258,3780,692,4472,17.3
19084,Forgès,258,0,766,766,3
21284,Francheville,258,0,0,0,0
22285,Saint-Connec,258,0,1796,1796,7
25517,Saint-Gorgon-Main,258,0,2825,2825,10.9
27594,Saint-Pierre-des-Ifs,258,0,3973,3973,15.4
30016,Arre,258,0,4161,4161,16.1
31108,Cardeilhac,258,0,5344,5344,20.7
38366,Saint-Baudille-et-Pipet,258,1640,7228,8868,34.4
38513,Treffort,258,0,7228,7228,28
39024,Audelange,258,1725,5236,6961,27
39159,Colonne,258,1300,5706,7006,27.2
47009,Andiran,258,0,1251,1251,4.8
48139,Saint Bonnet-Laval,258,2550,2311,4861,18.8
48152,Ventalon en Cévennes,258,0,14052,14052,54.5
52538,Villiers-sur-Suize,258,0,1415,1415,5.5
54104,Buissoncourt,258,0,1527,1527,5.9
59556,Sassegnies,258,0,9203,9203,35.7
62146,Boiry-Saint-Martin,258,0,7257,7257,28.1
64292,Labatmale,258,0,2759,2759,10.7
64452,Ponson-Dessus,258,0,2693,2693,10.4
66063,Les Cluses,258,0,10700,10700,41.5
67166,Grassendorf,258,180,8670,8850,34.3
70196,Dampierre-lès-Conflans,258,0,1640,1640,6.4
70215,Errevet,258,0,437,437,1.7
80043,Authie,258,0,288,288,1.1
80176,Carrépuis,258,0,311,311,1.2
82160,Saint-Clair,258,0,27720,27720,107.4
88123,Damblain,258,0,2006,2006,7.8
88521,Vomécourt,258,0,1287,1287,5
2006,Aisonville-et-Bernoville,257,0,1417,1417,5.5
2060,Beauvois-en-Vermandois,257,0,2328,2328,9.1
7147,Malarce-sur-la-Thines,257,5080,6289,11369,44.2
8163,Faissault,257,0,5637,5637,21.9
8413,Seraincourt,257,0,4915,4915,19.1
11183,Ladern-sur-Lauquet,257,0,3383,3383,13.2
11263,Nébias,257,0,2823,2823,11
14096,Brémoy,257,0,9530,9530,37.1
18163,Neuvy-Deux-Clochers,257,0,1948,1948,7.6
21441,Mont-Saint-Jean,257,0,3906,3906,15.2
25298,Grosbois,257,0,12810,12810,49.8
27501,Rouvray,257,0,1350,1350,5.3
28344,Saint-Léger-des-Aubées,257,0,7489,7489,29.1
33427,Saint-Laurent-du-Bois,257,0,2552,2552,9.9
33536,Le Tuzan,257,0,2628,2628,10.2
34252,Saint-Étienne-Estréchoux,257,0,2393,2393,9.3
36193,Sainte-Gemme,257,0,1274,1274,5
48026,Blavignac,257,0,2640,2640,10.3
50574,Servon,257,0,6323,6323,24.6
50598,Tocqueville,257,1870,8084,9954,38.7
52504,Varennes-sur-Amance,257,0,5069,5069,19.7
53230,Saint-Julien-du-Terroux,257,0,9550,9550,37.2
54249,Hannonville-Suzémont,257,0,1534,1534,6
57307,Hayes,257,0,626,626,2.4
60654,Vandélicourt,257,0,1306,1306,5.1
61384,Saint-Ellier-les-Bois,257,0,7595,7595,29.6
62539,Maisnil,257,0,5552,5552,21.6
62859,Villers-l'Hôpital,257,0,5552,5552,21.6
65230,Izaourt,257,0,1682,1682,6.5
70037,Autet,257,0,1319,1319,5.1
76104,Blosseville,257,0,1664,1664,6.5
81279,La Sauzière-Saint-Jean,257,0,14120,14120,54.9
89463,Villeneuve-Saint-Salves,257,2000,5028,7028,27.3
2813,Villers-le-Sec,256,0,0,0,0
4027,Bevons,256,0,5638,5638,22
4216,Thèze,256,10050,7632,17682,69.1
6093,La Penne,256,0,5769,5769,22.5
7034,Bidon,256,0,20407,20407,79.7
7039,Bozas,256,0,11264,11264,44
10132,Droupt-Sainte-Marie,256,0,263,263,1
14639,Saint-Ouen-le-Pin,256,0,2850,2850,11.1
16147,Gardes-le-Pontaroux,256,3149,0,3149,12.3
19155,Orliac-de-Bar,256,0,4858,4858,19
23236,Saint-Priest-la-Plaine,256,0,1418,1418,5.5
24245,Loubejac,256,6100,438,6538,25.5
24535,Simeyrols,256,500,980,1480,5.8
30099,Cros,256,0,532,532,2.1
31496,Sainte-Livrade,256,0,78,78,0.3
31568,Varennes,256,0,4174,4174,16.3
33467,Saint-Quentin-de-Caplong,256,0,1932,1932,7.5
36213,Sauzelles,256,0,1407,1407,5.5
38243,Monestier-du-Percy,256,0,7172,7172,28
45256,Presnoy,256,0,2625,2625,10.3
46337,Mayrac,256,0,8352,8352,32.6
47218,Puysserampion,256,0,4767,4767,18.6
51163,Congy,256,0,371,371,1.4
52370,Osne-le-Val,256,0,2319,2319,9.1
55040,Beausite,256,0,3465,3465,13.5
59010,Anneux,256,0,3328,3328,13
62152,Boisleux-Saint-Marc,256,0,7200,7200,28.1
63340,Saint-Étienne-sur-Usson,256,0,1664,1664,6.5
65281,Loucrup,256,0,2446,2446,9.6
73190,Notre-Dame-du-Pré,256,0,19859,19859,77.6
73252,Saint-Léger,256,0,9711,9711,37.9
79200,Pamplie,256,0,2110,2110,8.2
84022,Buisson,256,0,299,299,1.2
88205,Girmont-Val-d'Ajol,256,0,653,653,2.6
88489,Valleroy-aux-Saules,256,0,3679,3679,14.4
2478,Merlieux-et-Fouquerolles,255,0,252,252,1
2787,Verneuil-sur-Serre,255,0,1285,1285,5
7026,Le Béage,255,750,1994,2744,10.8
14198,Cresseveuille,255,0,3239,3239,12.7
18091,Farges-Allichamps,255,0,1124,1124,4.4
21236,Ébaty,255,0,1109,1109,4.3
21340,Lanthes,255,0,1912,1912,7.5
21432,Montigny-sur-Aube,255,0,4254,4254,16.7
21446,Moutiers-Saint-Jean,255,0,4967,4967,19.5
23049,Champsanglard,255,0,686,686,2.7
23083,Fontanières,255,0,3348,3348,13.1
24132,Conne-de-Labarde,255,650,478,1128,4.4
26020,La Répara-Auriples,255,0,3089,3089,12.1
30115,Fontarèches,255,0,1960,1960,7.7
30124,Le Garn,255,0,3721,3721,14.6
31412,Péguilhan,255,0,5282,5282,20.7
32066,Brugnens,255,0,145,145,0.6
33115,Cazalis,255,0,2608,2608,10.2
38173,Le Freney-d'Oisans,255,6630,14504,21134,82.9
39048,Belmont,255,4250,2469,6719,26.3
39477,Saint-Baraing,255,1200,1510,2710,10.6
39581,Vitreux,255,510,4024,4534,17.8
40047,Bonnegarde,255,0,692,692,2.7
41278,Villechauve,255,0,3154,3154,12.4
42058,Chazelles-sur-Lavieu,255,0,2285,2285,9
43118,Lavoûte-Chilhac,255,21135,2322,23457,92
47184,Montaut,255,0,6511,6511,25.5
47247,Saint-Jean-de-Duras,255,0,12561,12561,49.3
51527,Savigny-sur-Ardres,255,0,4532,4532,17.8
53242,Saint-Michel-de-la-Roë,255,0,1688,1688,6.6
54015,Anderny,255,0,1123,1123,4.4
60320,Ivors,255,0,998,998,3.9
62010,Affringues,255,0,552,552,2.2
62012,Agnières,255,0,2119,2119,8.3
62149,Boisdinghem,255,0,552,552,2.2
62169,Bouvelinghem,255,0,552,552,2.2
62527,Longvilliers,255,0,2713,2713,10.6
62789,Senlecques,255,0,736,736,2.9
65245,Lagrange,255,0,762,762,3
70229,Faymont,255,0,11209,11209,44
70452,Rosey,255,0,655,655,2.6
71186,Écuelles,255,0,2943,2943,11.5
72072,Château-l'Hermitage,255,0,1279,1279,5
72222,Nouans,255,0,4729,4729,18.5
73139,Jarsy,255,0,3241,3241,12.7
76450,Montroty,255,0,4817,4817,18.9
77112,Chevrainvilliers,255,0,130,130,0.5
77364,Le Plessis-aux-Bois,255,0,194,194,0.8
79198,Paizay-le-Chapt,255,0,7364,7364,28.9
81186,Moularès,255,0,5834,5834,22.9
89061,Butteaux,255,0,1648,1648,6.5
89361,Saint-Maurice-Thizouaille,255,550,6031,6581,25.8
4156,Puimichel,254,0,2953,2953,11.6
4240,Villars-Colmars,254,7520,8981,16501,65
8175,Foisches,254,0,1631,1631,6.4
10361,Saint-Remy-sous-Barbuise,254,0,216,216,0.9
11042,Blomac,254,0,1648,1648,6.5
14484,Ouilly-du-Houley,254,0,2827,2827,11.1
15174,Saint-Bonnet-de-Salers,254,8850,4205,13055,51.4
27162,Collandres-Quincarnon,254,0,2260,2260,8.9
28265,Montlandon,254,0,181,181,0.7
30265,Saint-Jean-de-Crieulon,254,0,528,528,2.1
36082,Gehée,254,0,3189,3189,12.6
37265,Varennes,254,0,4409,4409,17.4
38268,Le Moutaret,254,3260,4720,7980,31.4
46052,Camboulit,254,0,7501,7501,29.5
47071,Coulx,254,0,2050,2050,8.1
51604,Ventelay,254,0,4514,4514,17.8
53047,Carelles,254,0,3349,3349,13.2
54346,Manoncourt-en-Woëvre,254,0,530,530,2.1
55264,Kœur-la-Petite,254,0,3743,3743,14.7
55571,Vilosnes-Haraumont,254,0,9185,9185,36.2
58030,Biches,254,0,13102,13102,51.6
59077,Bettrechies,254,0,717,717,2.8
60199,Doméliers,254,0,5728,5728,22.6
60381,Margny-aux-Cerises,254,0,2221,2221,8.7
60466,Noroy,254,0,1407,1407,5.5
62319,Éterpigny,254,0,316,316,1.2
62858,Villers-lès-Cagnicourt,254,0,316,316,1.2
63166,Gignat,254,0,1651,1651,6.5
65020,Arcizac-ez-Angles,254,0,2427,2427,9.6
65045,Aucun,254,0,10401,10401,40.9
71341,Palleau,254,0,2931,2931,11.5
77224,Hautefeuille,254,0,989,989,3.9
80351,Fréchencourt,254,0,990,990,3.9
82055,Esparsac,254,0,5954,5954,23.4
2390,Jeancourt,253,0,2292,2292,9.1
6086,Moulinet,253,0,1420,1420,5.6
9145,Les Issards,253,0,1139,1139,4.5
10178,Jessains,253,0,1506,1506,6
11015,Arques,253,1459,3330,4789,18.9
11207,Loupia,253,0,3330,3330,13.2
11209,Luc-sur-Aude,253,0,3330,3330,13.2
12064,Le Cayrol,253,0,1253,1253,5
14121,Cahagnolles,253,0,1751,1751,6.9
16260,Pillac,253,4400,11897,16297,64.4
21406,Mesmont,253,0,1423,1423,5.6
22269,Runan,253,0,4530,4530,17.9
25154,Chouzelot,253,0,1844,1844,7.3
25439,Ougney-Douvot,253,0,12611,12611,49.8
31085,Boutx,253,0,2422,2422,9.6
31138,Charlas,253,0,5241,5241,20.7
37040,Brizay,253,0,6865,6865,27.1
41090,Fortan,253,0,3129,3129,12.4
42105,Grézieux-le-Fromental,253,0,2267,2267,9
43207,Saint-Laurent-Chabreuges,253,0,12399,12399,49
50471,Saint-Georges-de-la-Rivière,253,5217,7958,13175,52.1
51121,Champvoisy,253,0,366,366,1.4
51134,Châtelraould-Saint-Louvent,253,0,3991,3991,15.8
60627,Tartigny,253,0,5705,5705,22.5
61328,Le Pin-au-Haras,253,0,534,534,2.1
62633,Œuf-en-Ternois,253,0,5466,5466,21.6
62695,Rebreuviette,253,0,2102,2102,8.3
62868,Wail,253,0,4006,4006,15.8
70284,Hautevelle,253,0,1608,1608,6.4
80445,Humbercourt,253,0,986,986,3.9
81083,Durfort,253,0,5144,5144,20.3
81158,Le Masnau-Massuguiès,253,0,2364,2364,9.3
83109,La Roque-Esclapon,253,0,3152,3152,12.5
86022,Berrie,253,0,1292,1292,5.1
87100,Montrol-Sénard,253,2500,4306,6806,26.9
90098,Urcerey,253,0,8827,8827,34.9
2148,Celles-sur-Aisne,252,0,497,497,2
7244,Saint-Jean-Chambre,252,0,841,841,3.3
9158,Lasserre,252,0,30537,30537,121.2
10055,Bourguignons,252,0,4399,4399,17.5
10429,Villette-sur-Aube,252,0,214,214,0.8
11032,Bellegarde-du-Razès,252,3510,3317,6827,27.1
11431,Villeneuve-les-Corbières,252,0,388,388,1.5
12116,Huparlac,252,0,8539,8539,33.9
14252,Estrées-la-Campagne,252,0,7619,7619,30.2
14565,Saint-Côme-de-Fresné,252,0,9713,9713,38.5
15185,Saint-Étienne-de-Chomeil,252,4240,3886,8126,32.2
17450,Torxé,252,0,7019,7019,27.9
21682,Viévigne,252,0,1098,1098,4.4
21685,Villaines-en-Duesmois,252,0,4204,4204,16.7
23196,Saint-Frion,252,0,9531,9531,37.8
23254,Toulx-Sainte-Croix,252,0,3788,3788,15
24408,Saint-Front-d'Alemps,252,625,831,1456,5.8
26309,Saint-Julien-en-Vercors,252,0,15783,15783,62.6
27318,La Haye-de-Calleville,252,0,1086,1086,4.3
30025,Aumessas,252,0,4065,4065,16.1
36077,Fontguenand,252,0,3164,3164,12.6
41069,Cour-sur-Loire,252,0,759,759,3
42188,Roche,252,0,2258,2258,9
45005,Andonville,252,0,917,917,3.6
46134,Les Junies,252,0,2128,2128,8.4
47037,Bournel,252,0,6435,6435,25.5
47197,Nomdieu,252,0,1222,1222,4.8
54023,Arracourt,252,0,3779,3779,15
57728,Voimhaut,252,0,11694,11694,46.4
58235,Saint-Brisson,252,0,2969,2969,11.8
71485,Saint-Vallerin,252,0,3865,3865,15.3
79278,Saint-Martin-du-Fouilloux,252,0,6607,6607,26.2
80018,Allenay,252,0,725,725,2.9
80051,Bailleul,252,0,769,769,3.1
80824,Wiencourt-l'Équipée,252,0,4561,4561,18.1
81322,Virac,252,0,5765,5765,22.9
82024,Brassac,252,0,7890,7890,31.3
7119,Le Lac-d'Issarlès,251,809,1963,2772,11
9270,Saint-Martin-d'Oydes,251,0,1130,1130,4.5
10133,Eaux-Puiseaux,251,0,4673,4673,18.6
11236,Molandier,251,3450,743,4193,16.7
14389,Maisoncelles-Pelvey,251,0,9308,9308,37.1
15137,Moussages,251,18670,4747,23417,93.3
15245,Vabres,251,3700,5552,9252,36.9
16229,Montjean,251,0,5494,5494,21.9
16256,Passirac,251,0,13421,13421,53.5
18006,Annoix,251,582,4808,5390,21.5
18199,Saint-Baudel,251,0,4544,4544,18.1
19144,Montgibaud,251,0,2414,2414,9.6
22041,Coatascorn,251,0,4986,4986,19.9
22109,Lanloup,251,0,4495,4495,17.9
23041,La Cellette,251,0,675,675,2.7
26373,Vesc,251,0,8750,8750,34.9
27435,La Noë-Poulain,251,0,3865,3865,15.4
27445,Noyers,251,0,205,205,0.8
28421,Voise,251,0,7314,7314,29.1
33479,Saint-Sève,251,0,2044,2044,8.1
37145,Marcé-sur-Esves,251,0,4357,4357,17.4
40258,Sainte-Foy,251,0,2398,2398,9.6
45151,Gaubertin,251,0,1902,1902,7.6
50315,Le Mesnillard,251,0,6176,6176,24.6
54399,Neuviller-sur-Moselle,251,0,0,0,0
54434,Praye,251,0,0,0,0
55526,Vadonville,251,0,1013,1013,4
57293,Han-sur-Nied,251,0,11647,11647,46.4
57442,Many,251,0,11647,11647,46.4
62466,Humbert,251,0,14853,14853,59.2
64308,Lalonquette,251,0,3930,3930,15.7
64441,Pagolle,251,0,6522,6522,26
65338,Orignac,251,0,1884,1884,7.5
66112,Montauriol,251,0,3364,3364,13.4
67044,Bischholtz,251,2191,6764,8955,35.7
67555,Zehnacker,251,0,13632,13632,54.3
68025,Bendorf,251,0,6733,6733,26.8
71206,La Frette,251,0,1463,1463,5.8
71311,Montcony,251,0,1033,1033,4.1
74059,La Chapelle-Rambaud,251,0,1829,1829,7.3
76204,Cropus,251,0,2025,2025,8.1
77314,Montolivet,251,0,4133,4133,16.5
80723,Saisseval,251,0,432,432,1.7
89266,Montillot,251,600,544,1144,4.6
2084,Bézu-le-Guéry,250,0,136,136,0.5
2589,Pargny-Filain,250,0,493,493,2
3142,Lenax,250,0,4318,4318,17.3
10251,Montigny-les-Monts,250,1038,4654,5692,22.8
11058,Cailhau,250,0,3291,3291,13.2
14419,Le Mesnil-Eudes,250,0,2783,2783,11.1
14677,Soulangy,250,0,3916,3916,15.7
15179,Saint-Cirgues-de-Malbert,250,2615,4139,6754,27
21327,Val-Mont,250,0,1087,1087,4.3
21556,Saint-Léger-Triey,250,0,0,0,0
23148,Nouziers,250,0,672,672,2.7
25116,Champlive,250,0,12461,12461,49.8
28053,Le Boullay-les-Deux-Églises,250,0,334,334,1.3
32339,Razengues,250,0,17784,17784,71.1
35190,Monthault,250,0,3061,3061,12.2
36100,Lourouer-Saint-Laurent,250,0,5491,5491,22
38472,Sarcenas,250,0,9658,9658,38.6
39180,Cressia,250,950,7276,8226,32.9
40092,Dumes,250,0,5776,5776,23.1
45078,Chapelon,250,0,2563,2563,10.3
48087,Prinsuéjols-Malbouzon,250,3560,9239,12799,51.2
50347,Montjoie-Saint-Martin,250,0,6151,6151,24.6
51433,Plichancourt,250,0,1467,1467,5.9
52455,Saint-Thiébault,250,0,3846,3846,15.4
53156,Montflours,250,0,10880,10880,43.5
53191,La Roë,250,0,1655,1655,6.6
54502,Serres,250,0,3749,3749,15
54515,Thélod,250,0,2546,2546,10.2
55255,Jametz,250,0,8938,8938,35.8
55405,Pillon,250,0,4569,4569,18.3
55554,Villécloye,250,0,8938,8938,35.8
60552,Rouville,250,0,979,979,3.9
61164,La Ferrière-Béchet,250,4770,1568,6338,25.4
68181,Levoncourt,250,0,6706,6706,26.8
70097,Briaucourt,250,0,1589,1589,6.4
70187,Crevans-et-la-Chapelle-lès-Granges,250,0,79,79,0.3
72049,La Bruère-sur-Loir,250,0,1253,1253,5
72070,Chassillé,250,0,2272,2272,9.1
72114,Dehault,250,0,1525,1525,6.1
73214,Rochefort,250,0,370,370,1.5
76358,Le Héron,250,0,0,0,0
79164,Maisonnay,250,0,7220,7220,28.9
80135,Bray-lès-Mareuil,250,0,763,763,3.1
80252,Douilly,250,0,4765,4765,19.1
86020,Bellefonds,250,0,5690,5690,22.8
88128,Denipaire,250,0,2431,2431,9.7
90101,Vellescot,250,0,1487,1487,5.9
2310,Fieulaine,249,0,35588,35588,142.9
2599,Pierremande,249,0,4474,4474,18
3177,Monétay-sur-Loire,249,0,4301,4301,17.3
8138,Les Deux-Villes,249,0,8816,8816,35.4
8376,Sailly,249,0,8816,8816,35.4
9342,Sainte-Suzanne,249,0,4429,4429,17.8
12303,Vimenet,249,0,23583,23583,94.7
14045,Basseneville,249,0,3163,3163,12.7
16180,Laprade,249,2240,11709,13949,56
18232,Saint-Priest-la-Marche,249,3659,667,4326,17.4
24045,Boisse,249,654,467,1121,4.5
25599,Vennans,249,0,12412,12412,49.8
2B084,Cateri,249,0,0,0,0
30262,Saint-Hippolyte-de-Montaigu,249,0,1913,1913,7.7
33450,Saint-Michel-de-Castelnau,249,0,83,83,0.3
40205,Nousse,249,0,3900,3900,15.7
40324,Vicq-d'Auribat,249,0,3900,3900,15.7
48188,Serverette,249,2300,2558,4858,19.5
55389,Nubécourt,249,0,3371,3371,13.5
57087,Bisten-en-Lorraine,249,0,1544,1544,6.2
57713,Vieux-Lixheim,249,0,1621,1621,6.5
58039,Brèves,249,0,5210,5210,20.9
60399,Le Mesnil-Saint-Firmin,249,0,5615,5615,22.6
60514,Prévillers,249,0,1222,1222,4.9
61319,Origny-le-Roux,249,0,4617,4617,18.5
61373,Sainte-Céronne-lès-Mortagne,249,2255,874,3129,12.6
62483,Lacres,249,0,719,719,2.9
62709,Riencourt-lès-Cagnicourt,249,0,310,310,1.2
62834,Vacqueriette-Erquières,249,0,3942,3942,15.8
63142,Échandelys,249,0,2250,2250,9
70189,Cromary,249,0,2086,2086,8.4
71147,Cortevaix,249,1250,1731,2981,12
74045,Le Bouchet-Mont-Charvin,249,12109,12649,24758,99.4
81191,Mouzieys-Panens,249,0,6336,6336,25.4
89316,Provency,249,0,540,540,2.2
89392,Sermizelles,249,90,540,630,2.5
2403,Landifay-et-Bertaignemont,248,0,4422,4422,17.8
2413,Laval-en-Laonnois,248,0,9471,9471,38.2
4148,Peyroules,248,0,8769,8769,35.4
8452,Thugny-Trugny,248,0,4743,4743,19.1
9221,Ornolac-Ussat-les-Bains,248,0,957,957,3.9
10056,Bouy-Luxembourg,248,0,922,922,3.7
12097,Espeyrac,248,0,1228,1228,5
14506,Planquery,248,0,1717,1717,6.9
14684,Tessel,248,0,3040,3040,12.3
16050,Bonneuil,248,2495,9279,11774,47.5
18085,Dampierre-en-Graçay,248,435,3583,4018,16.2
18288,Vorly,248,977,4750,5727,23.1
21074,Billey,248,0,0,0,0
21407,Messanges,248,0,1189,1189,4.8
21587,Saulx-le-Duc,248,0,3530,3530,14.2
24124,Clermont-d'Excideuil,248,1150,3118,4268,17.2
25099,Bugny,248,0,2716,2716,11
25314,Indevillers,248,0,1728,1728,7
27194,Cuverville,248,0,1303,1303,5.3
2B173,Muro,248,0,3480,3480,14
31554,Touille,248,0,13329,13329,53.7
32158,L'Isle-Bouzon,248,0,936,936,3.8
32181,Laguian-Mazous,248,0,549,549,2.2
32424,Ségos,248,0,7764,7764,31.3
34316,Usclas-du-Bosc,248,0,2785,2785,11.2
43201,Saint-Julien-d'Ance,248,0,10319,10319,41.6
48178,Saint-Privat-de-Vallongue,248,2150,13507,15657,63.1
50522,Saint-Maurice-en-Cotentin,248,7515,7801,15316,61.8
51035,Bannes,248,0,467,467,1.9
52422,Richebourg,248,0,1360,1360,5.5
54463,Rosières-en-Haye,248,0,2710,2710,10.9
55262,Juvigny-sur-Loison,248,0,8866,8866,35.8
58179,Montreuillon,248,0,3857,3857,15.6
60410,Mondescourt,248,0,0,0,0
60677,Villembray,248,0,2033,2033,8.2
62885,Westrehem,248,0,4093,4093,16.5
63383,Saint-Pierre-Colamine,248,0,1811,1811,7.3
63409,Saurier,248,0,1612,1612,6.5
64116,Bescat,248,2100,3148,5248,21.2
64276,Issor,248,0,5341,5341,21.5
64321,Lasclaveries,248,0,3883,3883,15.7
65322,Montoussé,248,0,741,741,3
65400,Salles,248,0,10155,10155,40.9
66109,Molitg-les-Bains,248,0,7428,7428,30
71142,La Comelle,248,0,5549,5549,22.4
77421,Saint-Mars-Vieux-Maisons,248,0,4084,4084,16.5
80112,Bonnay,248,0,33,33,0.1
86138,Luchapt,248,0,10030,10030,40.4
86191,Pindray,248,2000,10030,12030,48.5
89292,Percey,248,1005,1603,2608,10.5
89350,Saint-Loup-d'Ordon,248,1680,752,2432,9.8
90015,Botans,248,50,8652,8702,35.1
90066,Leval,248,0,7387,7387,29.8
2142,Castres,247,0,35302,35302,142.9
2585,Parcy-et-Tigny,247,0,825,825,3.3
3277,Target,247,0,5052,5052,20.5
4219,Thorame-Haute,247,17070,8734,25804,104.5
7040,Boucieu-le-Roi,247,0,10868,10868,44
8004,Aire,247,0,4724,4724,19.1
9314,Tourtrol,247,0,5116,5116,20.7
10150,Fontaine,247,0,0,0,0
22088,Kerien,247,0,4423,4423,17.9
24208,Grun-Bordas,247,0,1379,1379,5.6
24576,Veyrines-de-Vergt,247,4080,1379,5459,22.1
25001,Abbans-Dessous,247,0,1800,1800,7.3
25174,Courtefontaine,247,3525,1721,5246,21.2
25597,Vellevans,247,0,6810,6810,27.6
26346,Suze,247,0,2992,2992,12.1
28215,Louville-la-Chenard,247,0,1297,1297,5.3
28310,La Puisaye,247,0,4409,4409,17.9
29286,Tréflévénez,247,5120,1914,7034,28.5
31283,Lautignac,247,0,8650,8650,35
32203,Lauraët,247,0,950,950,3.8
32341,Réjaumont,247,0,140,140,0.6
32396,Saint-Mézard,247,0,140,140,0.6
34071,Ceilhes-et-Rocozels,247,0,2300,2300,9.3
34105,Fouzilhon,247,0,483,483,2
38209,Lentiol,247,0,2695,2695,10.9
39039,La Barre,247,2030,3898,5928,24
39211,Les Essards-Taignevaux,247,600,1463,2063,8.4
42252,Saint-Laurent-Rochefort,247,0,0,0,0
46270,Saint-Jean-de-Laur,247,0,7294,7294,29.5
47115,Guérin,247,0,4168,4168,16.9
51019,Aubérive,247,0,4390,4390,17.8
54014,Ancerviller,247,0,876,876,3.5
58020,Avril-sur-Loire,247,0,637,637,2.6
60109,Brombos,247,0,1212,1212,4.9
61014,Aunou-le-Faucon,247,0,522,522,2.1
62723,Roussent,247,0,3911,3911,15.8
62887,Widehem,247,0,2628,2628,10.6
63333,Saint-Denis-Combarnazat,247,0,1010,1010,4.1
63391,Saint-Rémy-de-Blot,247,0,1629,1629,6.6
65242,Lacassagne,247,0,5579,5579,22.6
66060,Corsavy,247,0,0,0,0
73001,Aiguebelette-le-Lac,247,0,12654,12654,51.2
76151,Cailleville,247,0,1600,1600,6.5
76182,Cliponville,247,0,1882,1882,7.6
80267,Ennemain,247,0,4708,4708,19.1
80830,Yaucourt-Bussus,247,0,0,0,0
81090,Fénols,247,0,13571,13571,54.9
2338,Froidmont-Cohartille,246,0,1239,1239,5
2364,Guyencourt,246,0,662,662,2.7
7151,Mars,246,0,5260,5260,21.4
7221,Saint-Cierge-la-Serre,246,1600,821,2421,9.8
10246,Montceaux-lès-Vaudes,246,0,3513,3513,14.3
14248,Espins,246,0,7437,7437,30.2
16189,Londigny,246,960,5385,6345,25.8
18021,Bannegon,246,0,2291,2291,9.3
18162,Neuilly-en-Sancerre,246,0,1864,1864,7.6
19026,Bilhac,246,0,1240,1240,5
22132,Lohuec,246,0,4405,4405,17.9
2B002,Aghione,246,0,1873,1873,7.6
30218,Rochegude,246,0,9985,9985,40.6
32035,Beaucaire,246,0,946,946,3.8
32397,Saint-Michel,246,0,544,544,2.2
39162,Condamine,246,1750,7753,9503,38.6
39479,Saint-Cyr-Montmalin,246,0,5441,5441,22.1
40082,Classun,246,0,7701,7701,31.3
41293,Villiersfaux,246,890,3043,3933,16
45189,Louzouer,246,0,746,746,3
45260,Ramoulu,246,105,306,411,1.7
46159,Latouille-Lentillac,246,0,8026,8026,32.6
47064,Cazideroque,246,0,1417,1417,5.8
50361,La Mouche,246,0,5954,5954,24.2
52113,Chassigny,246,0,3047,3047,12.4
54568,Ville-au-Montois,246,0,3123,3123,12.7
57099,Bourdonnay,246,0,814,814,3.3
57587,Rodalbe,246,0,814,814,3.3
63342,Saint-Floret,246,0,1599,1599,6.5
64039,Aren,246,0,5298,5298,21.5
71246,Juif,246,0,1013,1013,4.1
71517,Sermesse,246,0,2839,2839,11.5
71581,Vindecy,246,0,5512,5512,22.4
72265,Saint-Aignan,246,0,4562,4562,18.5
76293,Fultot,246,0,542,542,2.2
78072,Boinvilliers,246,0,2467,2467,10
87053,Cromac,246,3850,4187,8037,32.7
1310,Prémeyzel,245,0,2731,2731,11.1
2281,L'Épine-aux-Bois,245,0,133,133,0.5
3226,Saint-Didier-en-Donjon,245,0,4232,4232,17.3
8045,Ballay,245,0,5928,5928,24.2
8379,Saint-Étienne-à-Arnes,245,0,5928,5928,24.2
14322,Guéron,245,0,9443,9443,38.5
14640,Saint-Pair,245,0,1972,1972,8
16251,Oriolles,245,0,13100,13100,53.5
19199,Saint-Étienne-aux-Clos,245,0,3359,3359,13.7
21692,Villecomte,245,0,3487,3487,14.2
24317,Paulin,245,1650,937,2587,10.6
24365,Saint-Amand-de-Vergt,245,3650,1368,5018,20.5
25460,Le Val,245,0,1785,1785,7.3
25559,Thiébouhans,245,0,1707,1707,7
27201,Daubeuf-la-Campagne,245,0,1054,1054,4.3
27555,Saint-Laurent-des-Bois,245,0,2881,2881,11.8
27569,Saint-Martin-du-Tilleul,245,0,1056,1056,4.3
2B182,Occhiatana,245,4575,3438,8013,32.7
31368,Montclar-Lauragais,245,0,1195,1195,4.9
32143,Gazaupouy,245,0,942,942,3.8
32432,Seysses-Savès,245,0,1529,1529,6.2
32440,Tasque,245,0,4517,4517,18.4
33158,Les Esseintes,245,0,1995,1995,8.1
37280,Vou,245,1630,4253,5883,24
39446,Pupillin,245,200,5419,5619,22.9
42116,Juré,245,250,4596,4846,19.8
43117,Lavaudieu,245,0,12007,12007,49
47281,Saint-Urcisse,245,0,5609,5609,22.9
51479,Saint-Euphraise-et-Clairizet,245,0,4354,4354,17.8
54417,Parey-Saint-Césaire,245,0,0,0,0
55335,Ménil-sur-Saulx,245,0,4789,4789,19.5
55387,Nouillonpont,245,0,4478,4478,18.3
57686,Vahl-lès-Faulquemont,245,0,11369,11369,46.4
59667,Zermezeele,245,0,1497,1497,6.1
60152,Choisy-la-Victoire,245,350,229,579,2.4
60158,Coivrel,245,0,1357,1357,5.5
60201,Dompierre,245,0,1357,1357,5.5
60657,Vauchelles,245,0,0,0,0
61099,La Chapelle-Souëf,245,540,2845,3385,13.8
62163,Bouret-sur-Canche,245,1340,5293,6633,27.1
64187,Charritte-de-Bas,245,0,6367,6367,26
65268,Layrisse,245,0,2341,2341,9.6
67369,Ottwiller,245,450,3071,3521,14.4
67491,Tieffenbach,245,90,6602,6692,27.3
70020,Andelarrot,245,0,12674,12674,51.7
70263,Genevrey,245,0,906,906,3.7
70403,Palante,245,0,10770,10770,44
71387,Saint-André-le-Désert,245,0,1703,1703,7
73318,Villarembert,245,37100,6579,43679,178.3
80196,Citerne,245,0,747,747,3
86154,Mazeuil,245,0,1252,1252,5.1
87056,Dinsac,245,810,4170,4980,20.3
88275,Lubine,245,0,2382,2382,9.7
2172,Chaudun,244,0,815,815,3.3
3171,Mercy,244,0,4214,4214,17.3
5165,Savournon,244,0,7274,7274,29.8
7306,Sampzon,244,2550,14900,17450,71.5
8350,Quatre-Champs,244,0,5904,5904,24.2
10005,Amance,244,0,1452,1452,6
14569,Sainte-Croix-sur-Mer,244,0,2991,2991,12.3
15103,Leucamp,244,2150,2139,4289,17.6
17467,Vervant,244,0,6796,6796,27.9
19120,Louignac,244,0,3894,3894,16
21615,Sussey,244,0,7526,7526,30.8
24407,Sainte-Foy-de-Longas,244,1450,887,2337,9.6
25339,Lods,244,0,1778,1778,7.3
26073,Chantemerle-lès-Grignan,244,0,6569,6569,26.9
27560,Saint-Luc,244,0,2870,2870,11.8
27660,La Trinité-de-Réville,244,0,1052,1052,4.3
31258,Lacaugne,244,0,420,420,1.7
31463,Roumens,244,0,4961,4961,20.3
33255,Lucmau,244,0,2495,2495,10.2
34004,Agel,244,0,924,924,3.8
37121,Jaulnay,244,0,6621,6621,27.1
40028,Bastennes,244,0,662,662,2.7
43191,Saint-Géron,244,0,11958,11958,49
46164,Lavercantière,244,0,6901,6901,28.3
50121,La Chapelle-Cécelin,244,0,4123,4123,16.9
50268,Lestre,244,0,7675,7675,31.5
50442,Le Rozel,244,875,7675,8550,35
54134,Colmey,244,0,3098,3098,12.7
54333,Mailly-sur-Seille,244,0,1444,1444,5.9
57070,Bettange,244,0,1470,1470,6
57175,Diane-Capelle,244,0,1589,1589,6.5
60426,Montreuil-sur-Thérain,244,175,1013,1188,4.9
60485,Oursel-Maison,244,0,5502,5502,22.5
62221,Chelers,244,0,2028,2028,8.3
62459,Houvin-Houvigneul,244,0,2028,2028,8.3
68057,Buethwiller,244,1250,3474,4724,19.4
71005,Aluze,244,0,6709,6709,27.5
76432,Mesnil-Mauger,244,0,4609,4609,18.9
77137,Courtacon,244,0,880,880,3.6
77348,Ormesson,244,0,125,125,0.5
77417,Saint-Léger,244,0,4018,4018,16.5
80022,Andainville,244,0,337,337,1.4
80461,Lamotte-Brebière,244,0,32,32,0.1
82185,Valeilles,244,0,7639,7639,31.3
89442,Vernoy,244,0,866,866,3.5
2030,Aubencheul-aux-Bois,243,0,2202,2202,9.1
2369,Harcigny,243,0,4333,4333,17.8
2790,Vesles-et-Caumont,243,0,1224,1224,5
5114,Réallon,243,0,19418,19418,79.9
9065,Boussenac,243,0,29447,29447,121.2
11257,Monze,243,0,1576,1576,6.5
16346,Saint-Quentin-de-Chalais,243,1900,11427,13327,54.8
21622,Tart-le-Bas,243,0,5,5,0
23047,Chamborand,243,0,1346,1346,5.5
24025,Bars,243,1888,4250,6138,25.3
24420,Saint-Géry,243,3670,5410,9080,37.4
25351,Le Luhier,243,0,4081,4081,16.8
25600,Vennes,243,0,2871,2871,11.8
28074,La Chapelle-d'Aunainville,243,0,1410,1410,5.8
28274,Moutiers,243,0,1276,1276,5.3
28341,Saint-Jean-de-Rebervilliers,243,0,325,325,1.3
31114,Castelbiague,243,0,13060,13060,53.7
33094,Caplong,243,0,1834,1834,7.5
33136,Cours-de-Monségur,243,0,2413,2413,9.9
34167,Montels,243,0,1374,1374,5.7
34261,Saint-Guilhem-le-Désert,243,0,1313,1313,5.4
34306,Soumont,243,0,2729,2729,11.2
36030,Buxières-d'Aillac,243,0,713,713,2.9
39436,Pont-d'Héry,243,890,5375,6265,25.8
41112,Lassay-sur-Croisne,243,0,4465,4465,18.4
45214,Montigny,243,0,749,749,3.1
52167,Darmannes,243,0,3739,3739,15.4
52171,Dommartin-le-Franc,243,0,2201,2201,9.1
52318,Melay,243,0,4792,4792,19.7
54221,Gerbécourt-et-Haplemont,243,0,0,0,0
54359,Méhoncourt,243,0,1004,1004,4.1
55011,Andernay,243,0,5393,5393,22.2
58297,Trois-Vèvres,243,0,1218,1218,5
59072,Bersillies,243,0,8668,8668,35.7
61436,Sainte-Opportune,243,2142,6508,8650,35.6
62296,Enquin-sur-Baillons,243,0,14380,14380,59.2
62501,Lespinoy,243,0,3847,3847,15.8
62855,Villers-au-Flos,243,0,1208,1208,5
65131,Castelvieilh,243,0,1543,1543,6.3
65353,Ozon,243,0,1543,1543,6.3
65398,Saléchan,243,0,1590,1590,6.5
66194,Serralongue,243,0,0,0,0
67424,Saint-Blaise-la-Roche,243,4273,17585,21858,90
69134,Moiré,243,0,2190,2190,9
76118,Bornambusc,243,0,2878,2878,11.8
80369,Frohen-sur-Authie,243,0,947,947,3.9
80599,Noyelles-en-Chaussée,243,0,6017,6017,24.8
80651,Le Quesne,243,0,336,336,1.4
81185,Montvalen,243,0,13351,13351,54.9
89202,Irancy,243,2250,4754,7004,28.8
89303,Poilly-sur-Serein,243,0,33,33,0.1
90020,Buc,243,0,8478,8478,34.9
95110,Brignancourt,243,0,11165,11165,45.9
2156,Chalandry,242,0,1219,1219,5
4231,Valernes,242,0,7215,7215,29.8
5072,Laye,242,0,16101,16101,66.5
10086,Charny-le-Bachot,242,0,249,249,1
10402,La Vendue-Mignot,242,2598,3456,6054,25
11055,Bugarach,242,6701,3186,9887,40.9
11428,Villemagne,242,0,2126,2126,8.8
16420,Voulgézac,242,0,6292,6292,26
18171,Orcenais,242,0,1066,1066,4.4
21045,Barbirey-sur-Ouche,242,0,1361,1361,5.6
21092,Bouilland,242,0,1052,1052,4.3
21198,Corrombles,242,0,5139,5139,21.2
21437,Montmançon,242,0,0,0,0
22148,Mérillac,242,0,0,0,0
22291,Saint-Gildas,242,0,3838,3838,15.9
25172,Courchapon,242,0,164,164,0.7
32289,Montpezat,242,0,1510,1510,6.2
36110,Maillet,242,0,710,710,2.9
39493,Saint-Maurice-Crillat,242,1374,7043,8417,34.8
40321,Urgons,242,0,5591,5591,23.1
46085,Cuzac,242,0,7146,7146,29.5
46161,Lauresses,242,0,7146,7146,29.5
46318,Thémines,242,0,7146,7146,29.5
47287,Saumont,242,0,1173,1173,4.8
48129,Rocles,242,2250,2168,4418,18.3
51235,Les Essarts-lès-Sézanne,242,0,3158,3158,13
55378,Nettancourt,242,0,5371,5371,22.2
57377,Landange,242,0,1575,1575,6.5
59083,Bissezeele,242,0,4661,4661,19.3
60194,Dargies,242,0,1187,1187,4.9
62167,Boursin,242,0,1481,1481,6.1
62299,Eps,242,0,5228,5228,21.6
62872,Wamin,242,0,3831,3831,15.8
63057,Le Brugeron,242,4150,2187,6337,26.2
63062,Buxières-sous-Montaigut,242,0,376,376,1.6
63264,Orcival,242,0,758,758,3.1
63401,Saint-Victor-la-Rivière,242,0,1767,1767,7.3
64420,Ogenne-Camptort,242,0,5059,5059,20.9
67475,Sparsbach,242,54,6521,6575,27.2
70029,Arpenans,242,0,10638,10638,44
77518,Villiers-en-Bière,242,0,3372,3372,13.9
79338,Vanzay,242,0,6989,6989,28.9
80052,Baizieux,242,0,32,32,0.1
80792,La Vicogne,242,0,943,943,3.9
2560,Nouvion-le-Comte,241,0,1214,1214,5
8057,Belleville-et-Châtillon-sur-Bar,241,0,5831,5831,24.2
21134,Chamesson,241,0,4021,4021,16.7
22335,Senven-Léhart,241,0,4315,4315,17.9
23086,Fransèches,241,0,7557,7557,31.4
23104,Lavaufranche,241,0,3622,3622,15
25316,Issans,241,240,15256,15496,64.3
30316,Sénéchas,241,0,7533,7533,31.3
31190,Fos,241,0,2307,2307,9.6
31468,Saint-André,241,0,4992,4992,20.7
31536,Saux-et-Pomarède,241,0,4992,4992,20.7
37229,Saint-Nicolas-des-Motets,241,5990,1058,7048,29.2
38420,Saint-Martin-de-Vaulserre,241,0,2113,2113,8.8
40289,Sarraziet,241,0,5568,5568,23.1
45177,Laas,241,0,300,300,1.2
45250,Pers-en-Gâtinais,241,0,731,731,3
46049,Calvignac,241,0,7117,7117,29.5
47108,Gaujac,241,0,2493,2493,10.3
52235,Hallignicourt,241,0,2183,2183,9.1
55007,Ambly-sur-Meuse,241,0,1534,1534,6.4
55442,Raival,241,0,3262,3262,13.5
57388,Launstroff,241,0,3469,3469,14.4
58006,Anlezy,241,0,1208,1208,5
58142,Limanton,241,0,12431,12431,51.6
61274,Les Menus,241,3405,1027,4432,18.4
61507,Villiers-sous-Mortagne,241,2870,846,3716,15.4
62664,Pommier,241,0,2003,2003,8.3
66019,Bélesta,241,0,325,325,1.3
70431,Quenoche,241,0,2019,2019,8.4
71312,Montcoy,241,1850,2781,4631,19.2
71453,Saint-Martin-du-Lac,241,0,5400,5400,22.4
71548,Tronchy,241,0,1405,1405,5.8
74071,Chessenaz,241,0,5821,5821,24.2
80287,Estrébœuf,241,0,735,735,3
81058,Carbes,241,0,3604,3604,15
86063,Chatain,241,0,5427,5427,22.5
86156,Messemé,241,0,1231,1231,5.1
88141,Dombrot-sur-Vair,241,0,85,85,0.4
89123,Courgis,241,350,33,383,1.6
2410,Largny-sur-Automne,240,0,231,231,1
2638,Remies,240,0,1209,1209,5
2672,Saint-Bandry,240,0,231,231,1
7166,Nozières,240,0,6871,6871,28.6
8405,Sauville,240,0,5807,5807,24.2
8481,Villers-sur-Bar,240,0,5513,5513,23
9170,Lissac,240,0,1081,1081,4.5
10416,Villemereuil,240,0,3427,3427,14.3
11385,Soupex,240,6500,2109,8609,35.9
15025,Albepierre-Bredons,240,1030,54,1084,4.5
16390,Tusson,240,1400,3017,4417,18.4
17047,Biron,240,0,2834,2834,11.8
17470,Villars-les-Bois,240,0,7606,7606,31.7
21201,Coulmier-le-Sec,240,0,4004,4004,16.7
21480,Pernand-Vergelesses,240,0,1044,1044,4.4
23115,Magnat-l'Étrange,240,0,3290,3290,13.7
24056,Le Bourdeix,240,0,1608,1608,6.7
24567,Vaunac,240,0,792,792,3.3
26233,Piégon,240,0,12332,12332,51.4
28207,Léthuin,240,0,1393,1393,5.8
31002,Aignes,240,0,1171,1171,4.9
37023,Beaumont-Village,240,0,4166,4166,17.4
39571,Villers-Robert,240,260,4871,5131,21.4
40057,Buanes,240,0,7513,7513,31.3
40144,Larbey,240,0,3759,3759,15.7
42078,Le Crozet,240,0,7082,7082,29.5
42113,Jas,240,900,4350,5250,21.9
43237,Sembadel,240,2120,9986,12106,50.4
46106,Floirac,240,0,7830,7830,32.6
50101,Carneville,240,3320,7549,10869,45.3
51588,Valmy,240,0,3564,3564,14.8
51657,Vrigny,240,0,4265,4265,17.8
54177,Emberménil,240,0,851,851,3.5
55327,Mauvages,240,0,4691,4691,19.5
59649,Wattignies-la-Victoire,240,0,1901,1901,7.9
60499,Plessis-de-Roye,240,0,2098,2098,8.7
62475,Ivergny,240,0,1994,1994,8.3
65306,Mauvezin,240,0,717,717,3
65371,Préchac,240,0,9828,9828,41
70040,Autrey-lès-Cerre,240,0,888,888,3.7
71089,La Chapelle-de-Bragny,240,0,2907,2907,12.1
73313,Verthemex,240,0,1523,1523,6.3
74066,Chavannaz,240,0,5797,5797,24.2
77193,Forfry,240,0,3273,3273,13.6
80087,Bernay-en-Ponthieu,240,0,5943,5943,24.8
80836,Yonval,240,0,732,732,3
82041,Cazals,240,0,3394,3394,14.1
85134,Mallièvre,240,0,3075,3075,12.8
87006,Azat-le-Ris,240,2410,4085,6495,27.1
88152,Dompierre,240,0,6035,6035,25.1
1268,Murs-et-Gélignieux,239,0,2664,2664,11.1
2032,Aubigny-aux-Kaisnes,239,0,34158,34158,142.9
2362,Guivry,239,0,4294,4294,18
4229,Valbelle,239,0,5264,5264,22
14606,Saint-Léger-Dubosq,239,0,3036,3036,12.7
15042,La Chapelle-Laurent,239,7000,54,7054,29.5
19216,Saint-Julien-le-Vendômois,239,0,2298,2298,9.6
19287,Vitrac-sur-Montane,239,0,4535,4535,19
21655,Vanvey,239,0,3987,3987,16.7
24305,Nanthiat,239,50,789,839,3.5
24429,Saint-Jory-las-Bloux,239,7500,3005,10505,44
26181,Mévouillon,239,0,12281,12281,51.4
28026,Baudreville,239,0,1255,1255,5.3
31105,Caragoudes,239,0,1166,1166,4.9
31196,Francon,239,0,8370,8370,35
31530,Sana,239,0,8370,8370,35
32458,Urgosse,239,0,159,159,0.7
36027,Brives,239,0,4855,4855,20.3
36085,Guilly,239,0,4855,4855,20.3
36227,Urciers,239,0,5250,5250,22
37107,Ferrière-Larçon,239,1605,4149,5754,24.1
38391,Saint-Guillaume,239,0,6695,6695,28
39291,Lemuy,239,150,5286,5436,22.7
39490,Saint-Loup,239,1080,1416,2496,10.4
47196,Nicole,239,0,2296,2296,9.6
51040,Bassuet,239,0,1402,1402,5.9
51244,Faux-Vésigneul,239,0,399,399,1.7
54348,Manonville,239,0,499,499,2.1
54508,Sivry,239,0,1414,1414,5.9
59333,Larouillies,239,0,1893,1893,7.9
61453,Saint-Sauveur-de-Carrouges,239,2990,1075,4065,17
62353,Frémicourt,239,0,1188,1188,5
62362,Frévillers,239,0,1986,1986,8.3
62729,Rumilly,239,0,14143,14143,59.2
63230,Le Monestier,239,1510,2160,3670,15.4
65049,Auriébat,239,0,5399,5399,22.6
65206,Goudon,239,0,1517,1517,6.3
67279,Maennolsheim,239,1070,16857,17927,75
67559,Zittersheim,239,1495,6440,7935,33.2
69002,Aigueperse,239,3480,0,3480,14.6
70080,Bouhans-et-Feurg,239,0,1206,1206,5
76691,Le Thil-Riberpré,239,0,4515,4515,18.9
76756,Yquebeuf,239,0,163,163,0.7
77090,La Chapelle-Saint-Sulpice,239,0,862,862,3.6
81146,Livers-Cazelles,239,0,6081,6081,25.4
82010,Bardigues,239,0,25678,25678,107.4
87076,Jabreilles-les-Bordes,239,0,387,387,1.6
2198,Clamecy,238,0,469,469,2
2658,Roupy,238,0,2156,2156,9.1
2766,Vaudesson,238,0,469,469,2
4133,Moriez,238,10186,8416,18602,78.2
7192,Rochepaule,238,0,5089,5089,21.4
8478,Villers-le-Tilleul,238,0,5220,5220,21.9
14595,Saint-Jean-de-Livet,238,0,2649,2649,11.1
15061,Dienne,238,1630,54,1684,7.1
15069,Ferrières-Saint-Mary,238,2690,54,2744,11.5
16164,Hiesse,238,750,4897,5647,23.7
17068,Brie-sous-Mortagne,238,0,3748,3748,15.7
23146,Nouzerines,238,0,3577,3577,15
24514,Saint-Vivien,238,0,829,829,3.5
25042,Le Barboux,238,0,3997,3997,16.8
25325,Landresse,238,0,2811,2811,11.8
25331,Lavans-Vuillafans,238,0,1734,1734,7.3
25550,La Sommette,238,0,2811,2811,11.8
27403,Le Mesnil-Jourdain,238,0,7058,7058,29.7
30314,Savignargues,238,0,495,495,2.1
31309,Lussan-Adeilhac,238,0,8335,8335,35
33440,Saint-Martial,238,0,2434,2434,10.2
36008,Arpheuilles,238,0,5944,5944,25
37181,Paulmy,238,0,4131,4131,17.4
39269,Jeurre,238,200,6927,7127,29.9
40323,Vert,238,0,1873,1873,7.9
46075,Corn,238,0,7028,7028,29.5
50405,Le Plessis-Lastelle,238,0,4973,4973,20.9
52276,Laville-aux-Bois,238,0,26143,26143,109.8
53105,Gesnes,238,0,1702,1702,7.2
54021,Armaucourt,238,0,1408,1408,5.9
60110,Broquiers,238,0,1168,1168,4.9
60311,La Hérelle,238,0,5367,5367,22.6
60663,Velennes,238,0,9333,9333,39.2
60702,Welles-Pérennes,238,0,1319,1319,5.5
62182,Buire-au-Bois,238,0,5142,5142,21.6
62514,Ligny-Saint-Flochel,238,0,5142,5142,21.6
62596,Mouriez,238,0,3768,3768,15.8
64047,Arnéguy,238,0,6185,6185,26
64369,Maspie-Lalonquère-Juillacq,238,0,2484,2484,10.4
64465,Riupeyrous,238,0,2484,2484,10.4
65318,Montastruc,238,0,711,711,3
68165,Kiffis,238,0,6384,6384,26.8
70115,Cerre-lès-Noroy,238,0,881,881,3.7
70349,Moimay,238,0,75,75,0.3
70426,Provenchère,238,0,1413,1413,5.9
72307,Saint-Ouen-en-Champagne,238,0,2163,2163,9.1
76438,Millebosc,238,0,684,684,2.9
79357,Xaintray,238,0,1962,1962,8.2
82003,Angeville,238,0,3057,3057,12.8
88130,Destord,238,0,312,312,1.3
89312,Précy-le-Sec,238,1680,1149,2829,11.9
91374,Marolles-en-Beauce,238,0,599,599,2.5
95447,Neuilly-en-Vexin,238,0,10935,10935,45.9
2438,Longpont,237,0,228,228,1
3307,Verneuil-en-Bourbonnais,237,0,4848,4848,20.5
9022,Arvigna,237,0,1067,1067,4.5
10441,Vosnon,237,0,4412,4412,18.6
14501,Pierrefitte-en-Cinglais,237,0,3713,3713,15.7
15176,Saint-Chamant,237,2940,3924,6864,29
15246,Valette,237,5674,3655,9329,39.4
19235,Saint-Paul,237,0,4497,4497,19
19260,Sioniac,237,0,1195,1195,5
24058,Bourg-du-Bost,237,150,1800,1950,8.2
24532,Serres-et-Montguyard,237,600,444,1044,4.4
25013,Allondans,237,1397,15003,16400,69.2
32193,Larée,237,0,0,0,0
37087,Courcoué,237,0,6431,6431,27.1
39401,Oussières,237,1465,5242,6707,28.3
39421,Le Pin,237,0,7469,7469,31.5
39464,Romain,237,1300,3740,5040,21.3
40223,Peyre,237,0,5476,5476,23.1
50326,Le Mesnil-Villeman,237,0,6857,6857,28.9
51342,Mancy,237,0,4710,4710,19.9
54002,Abbéville-lès-Conflans,237,0,2201,2201,9.3
54394,Murville,237,0,1044,1044,4.4
58311,Ville-Langy,237,0,1188,1188,5
59164,Croix-Caluyau,237,0,669,669,2.8
60035,Avricourt,237,0,2072,2072,8.7
60561,Russy-Bémont,237,0,928,928,3.9
61210,Joué-du-Plain,237,0,501,501,2.1
61307,Neuville-sur-Touques,237,0,1713,1713,7.2
62326,Favreuil,237,0,1178,1178,5
63331,Saint-Clément-de-Valorgue,237,733,2142,2875,12.1
64190,Claracq,237,0,3711,3711,15.7
64205,Escos,237,0,4954,4954,20.9
70043,Auvet-et-la-Chapelotte,237,0,1196,1196,5
73152,Marcieux,237,0,12141,12141,51.2
73177,Montvernier,237,0,6364,6364,26.9
76732,Butot-Vénesville,237,0,1535,1535,6.5
77303,Montdauphin,237,0,3903,3903,16.5
79343,Vernoux-sur-Boutonne,237,0,6845,6845,28.9
80540,Mesnil-Martinsart,237,0,265,265,1.1
81001,Aguts,237,0,264,264,1.1
81035,Bournazel,237,0,6030,6030,25.4
83014,Baudinard-sur-Verdon,237,0,923,923,3.9
88295,Mazirot,237,0,3406,3406,14.4
89147,Dracy,237,0,10701,10701,45.2
90013,Bethonvilliers,237,450,8268,8718,36.8
90050,Frais,237,950,8268,9218,38.9
95543,Saint-Cyr-en-Arthies,237,0,1498,1498,6.3
1210,Lélex,236,0,3038,3038,12.9
3054,Chapeau,236,0,3177,3177,13.5
3122,Gipcy,236,0,3625,3625,15.4
5022,Bréziers,236,0,2105,2105,8.9
7141,Lentillères,236,0,4028,4028,17.1
8166,Fépin,236,0,1515,1515,6.4
12099,Fayet,236,0,9234,9234,39.1
14269,Fierville-les-Parcs,236,0,3793,3793,16.1
14498,Pertheville-Ners,236,0,3697,3697,15.7
17227,Mazerolles,236,0,2787,2787,11.8
18168,Le Noyer,236,3610,4252,7862,33.3
19238,Saint-Rémy,236,0,3235,3235,13.7
22024,Calanhel,236,0,4226,4226,17.9
23007,Ars,236,0,7400,7400,31.4
23111,Lizières,236,0,1307,1307,5.5
24307,Naussannes,236,5100,857,5957,25.2
26340,Séderon,236,0,12127,12127,51.4
27495,La Roquette,236,0,1240,1240,5.3
28092,Châtenay,236,0,1369,1369,5.8
2B109,Farinole,236,0,1427,1427,6
31237,His,236,0,12684,12684,53.7
31474,Saint-Christaud,236,0,406,406,1.7
32065,Le Brouilh-Monbert,236,0,2785,2785,11.8
33053,Birac,236,0,78,78,0.3
34200,Pézènes-les-Mines,236,0,2197,2197,9.3
38564,Voissant,236,0,4009,4009,17
39458,Revigny,236,0,7437,7437,31.5
39463,Rogna,236,1500,869,2369,10
39513,Sermange,236,1000,3724,4724,20
42106,Grézolles,236,3015,1948,4963,21
47026,Beauziac,236,0,3982,3982,16.9
49038,Bourg-l'Évêque,236,0,235,235,1
51130,Charmont,236,0,1385,1385,5.9
51587,Vadenay,236,0,11995,11995,50.8
51616,Vésigneul-sur-Marne,236,0,394,394,1.7
52446,Saint-Broingt-les-Fosses,236,0,2923,2923,12.4
55221,Guerpont,236,0,2845,2845,12.1
55286,Lemmes,236,0,1502,1502,6.4
57506,Niederstinzel,236,0,1536,1536,6.5
70025,Arbecey,236,0,715,715,3
70133,Chargey-lès-Port,236,0,1402,1402,5.9
70351,Mollans,236,0,873,873,3.7
71561,Vauban,236,0,4581,4581,19.4
76091,Beuzeville-la-Guérard,236,0,1528,1528,6.5
76411,Marques,236,0,4,4,0
76424,Ménonval,236,0,5513,5513,23.4
80380,Gorenflos,236,0,5844,5844,24.8
80617,Parvillers-le-Quesnoy,236,0,4271,4271,18.1
89004,Aisy-sur-Armançon,236,4970,548,5518,23.4
6100,Revest-les-Roches,235,0,5296,5296,22.5
9132,Gaudiès,235,0,1058,1058,4.5
9213,Moulin-Neuf,235,0,4868,4868,20.7
9327,Ventenac,235,0,6316,6316,26.9
10225,Marnay-sur-Seine,235,0,1452,1452,6.2
16075,Champagne-Vigny,235,0,12566,12566,53.5
16221,Mons,235,4714,16291,21005,89.4
16423,Xambes,235,3640,2954,6594,28.1
17116,Consac,235,0,2775,2775,11.8
17229,Mérignac,235,0,2775,2775,11.8
17334,Saint-Georges-de-Longuepierre,235,0,0,0,0
18054,Charly,235,0,460,460,2
19003,Albignac,235,0,1185,1185,5
19170,Queyssac-les-Vignes,235,0,1185,1185,5
21421,Moloy,235,0,3345,3345,14.2
24438,Saint-Laurent-la-Vallée,235,2848,402,3250,13.8
24575,Veyrines-de-Domme,235,2388,402,2790,11.9
27590,Saint-Pierre-de-Cernières,235,0,1013,1013,4.3
28210,Levesville-la-Chenard,235,0,1234,1234,5.3
30035,Belvézet,235,0,1806,1806,7.7
35160,Loutehel,235,0,2121,2121,9
35192,Montreuil-des-Landes,235,0,3531,3531,15
39156,Cogna,235,200,6839,7039,30
41088,Fontaine-Raoul,235,0,1194,1194,5.1
42282,Saint-Romain-d'Urfé,235,5154,4408,9562,40.7
43245,Thoras,235,0,2140,2140,9.1
46130,Grézels,235,0,8544,8544,36.4
46174,Linac,235,0,6940,6940,29.5
51254,Fontaine-Denis-Nuisy,235,0,3066,3066,13
51288,Heiltz-le-Hutier,235,0,1460,1460,6.2
57494,Munster,235,0,778,778,3.3
60240,Fontaine-Bonneleau,235,0,5300,5300,22.6
62293,Embry,235,0,13906,13906,59.2
64081,Aussurucq,235,0,6107,6107,26
67385,Ratzwiller,235,13159,2946,16105,68.5
69181,Saint-Appolinaire,235,0,2778,2778,11.8
76582,Saint-Germain-d'Étables,235,0,1896,1896,8.1
77119,Clos-Fontaine,235,0,3025,3025,12.9
82086,Lafitte,235,0,3018,3018,12.8
83122,Les Salles-sur-Verdon,235,0,916,916,3.9
88479,Trémonzey,235,0,5910,5910,25.1
88512,Viménil,235,3992,308,4300,18.3
2663,Rozières-sur-Crise,234,0,782,782,3.3
2677,Saint-Eugène,234,0,5409,5409,23.1
7033,Bessas,234,0,14289,14289,61.1
8342,Pouru-aux-Bois,234,0,5375,5375,23
11307,Raissac-d'Aude,234,0,3619,3619,15.5
11328,Routier,234,3347,3080,6427,27.5
12141,Martrin,234,0,490,490,2.1
14159,Chouain,234,0,9019,9019,38.5
18056,Chassy,234,0,458,458,2
18169,Nozières,234,0,1031,1031,4.4
22141,Mantallot,234,0,4649,4649,19.9
25377,Mésandans,234,0,540,540,2.3
27346,Houville-en-Vexin,234,0,1540,1540,6.6
27683,Vézillon,234,0,1230,1230,5.3
28143,Escorpain,234,0,313,313,1.3
2A160,Moca-Croce,234,0,0,0,0
33481,Saint-Sulpice-de-Guilleragues,234,0,2324,2324,9.9
36054,Cléré-du-Bois,234,0,5844,5844,25
36186,Saint-Christophe-en-Boucherie,234,0,5140,5140,22
39086,Cernon,234,2090,6810,8900,38
39355,Montigny-lès-Arsures,234,0,5176,5176,22.1
46171,Lherm,234,0,1976,1976,8.4
46260,Sainte-Colombe,234,0,6910,6910,29.5
51314,Lagery,234,0,4159,4159,17.8
51572,Tilloy-et-Bellay,234,0,2202,2202,9.4
54565,Vigneulles,234,0,967,967,4.1
57448,Marsal,234,0,774,774,3.3
60183,Croissy-sur-Celle,234,0,5277,5277,22.6
61379,Saint-Cyr-la-Rosière,234,2530,2742,5272,22.5
62358,Fresnoy-en-Gohelle,234,0,291,291,1.2
62696,Reclinghem,234,0,20826,20826,89
64078,Auriac,234,0,3664,3664,15.7
64380,Méracq,234,0,3664,3664,15.7
67353,Obersteinbach,234,0,5662,5662,24.2
71572,Vers,234,0,2835,2835,12.1
72201,Moncé-en-Saosnois,234,0,4339,4339,18.5
76211,Dancourt,234,0,4,4,0
77286,Meigneux,234,0,3314,3314,14.2
80767,Le Translay,234,0,323,323,1.4
88040,Bayecourt,234,0,5884,5884,25.1
89098,Cheney,234,1250,544,1794,7.7
90059,Lacollonge,234,0,8164,8164,34.9
2452,Maissemy,233,0,2111,2111,9.1
2765,Vaucelles-et-Beffecourt,233,0,8898,8898,38.2
8249,Laval-Morency,233,0,3627,3627,15.6
8456,Tournavaux,233,0,3627,3627,15.6
9165,Lesparrou,233,0,2069,2069,8.9
11130,Espezel,233,0,2560,2560,11
19071,Davignac,233,0,3194,3194,13.7
21344,Lechâtelet,233,0,1747,1747,7.5
21368,Magny-lès-Villers,233,0,1117,1117,4.8
21592,Savigny-sous-Mâlain,233,0,1310,1310,5.6
23029,Le Bourg-d'Hem,233,0,6956,6956,29.9
23210,Saint-Maixant,233,0,8812,8812,37.8
24051,Bosset,233,1960,5187,7147,30.7
24303,Nanteuil-Auriac-de-Bourzac,233,3350,1769,5119,22
27411,Moisville,233,0,2740,2740,11.8
27695,Villez-sur-le-Neubourg,233,0,1002,1002,4.3
2B112,Feliceto,233,0,3270,3270,14
30354,Montagnac,233,0,858,858,3.7
31472,Saint-Bertrand-de-Comminges,233,0,2230,2230,9.6
32183,Lahitte,233,0,8210,8210,35.2
38418,Sainte-Marie-du-Mont,233,1200,4329,5529,23.7
39555,Vers-sous-Sellières,233,350,6193,6543,28.1
47182,Montastruc,233,0,1880,1880,8.1
50384,Octeville-l'Avenel,233,630,7329,7959,34.2
51016,Arrigny,233,0,1448,1448,6.2
51070,Boissy-le-Repos,233,0,7486,7486,32.1
51286,Hauteville,233,0,2110,2110,9.1
52267,Laneuville-au-Pont,233,0,2110,2110,9.1
54404,Noviant-aux-Prés,233,0,486,486,2.1
55495,Sorbey,233,0,4258,4258,18.3
59060,Beaurain,233,0,59,59,0.3
59643,Warneton,233,0,3858,3858,16.6
60229,Le Fayel,233,0,218,218,0.9
60292,Gury,233,1050,2037,3087,13.2
60549,Rotangy,233,0,9137,9137,39.2
61284,Montchevrel,233,0,82,82,0.4
62074,Bailleulval,233,0,1936,1936,8.3
62599,Nabringhen,233,0,673,673,2.9
62843,Verchin,233,0,13788,13788,59.2
63098,Chastreix,233,0,1701,1701,7.3
63105,Chaumont-le-Bourg,233,1305,2106,3411,14.6
65220,Hibarette,233,0,2226,2226,9.6
65343,Ossen,233,0,2226,2226,9.6
66193,Serdinya,233,0,6978,6978,29.9
70074,Blondefontaine,233,0,705,705,3
71567,Vergisson,233,0,5952,5952,25.5
76205,Crosville-sur-Scie,233,0,1880,1880,8.1
76483,Oherville,233,0,1509,1509,6.5
76601,Saint-Lucien,233,0,4402,4402,18.9
80335,Foucaucourt-en-Santerre,233,0,4217,4217,18.1
80736,Sorel-en-Vimeu,233,0,711,711,3.1
81221,Rayssac,233,0,2931,2931,12.6
2553,Nizy-le-Comte,232,0,624,624,2.7
7059,Châteaubourg,232,0,4533,4533,19.5
8032,Aussonce,232,0,4437,4437,19.1
10082,Chapelle-Vallon,232,0,239,239,1
14184,Cottun,232,0,8942,8942,38.5
14482,Ouézy,232,0,1867,1867,8
14745,Vierville-sur-Mer,232,0,1606,1606,6.9
16290,Rouzède,232,3100,4137,7237,31.2
19133,Mercœur,232,0,689,689,3
21333,Labruyère,232,0,1740,1740,7.5
23072,Domeyrot,232,0,3487,3487,15
25535,Saules,232,0,1691,1691,7.3
34112,Garrigues,232,0,2536,2536,10.9
34170,Montouliers,232,0,1312,1312,5.7
36164,Pouligny-Saint-Martin,232,0,5096,5096,22
39304,Le Louverot,232,1500,6166,7666,33
40093,Escalans,232,0,2650,2650,11.4
46226,Prendeignes,232,0,6851,6851,29.5
48074,Hures-la-Parade,232,0,5690,5690,24.5
54444,Raucourt,232,0,1373,1373,5.9
55061,Le Bouchon-sur-Saulx,232,0,4535,4535,19.5
55237,Haudiomont,232,0,3003,3003,12.9
55459,Saint-Joire,232,0,4535,4535,19.5
57743,Waltembourg,232,0,466,466,2
59006,Amfroipret,232,0,655,655,2.8
59342,Lez-Fontaine,232,0,1838,1838,7.9
60389,Maucourt,232,0,0,0,0
61053,Bonsmoulins,232,2830,2392,5222,22.5
61442,Saint-Patrice-du-Désert,232,1300,1044,2344,10.1
62093,Beaulencourt,232,0,1153,1153,5
62302,Ergny,232,0,13729,13729,59.2
62492,Lebiez,232,0,13729,13729,59.2
62493,Lebucquière,232,0,1153,1153,5
62824,Tortefontaine,232,0,3673,3673,15.8
64330,Lées-Athas,232,0,4996,4996,21.5
65310,Mérilheu,232,0,1741,1741,7.5
70516,Vallerois-le-Bois,232,0,858,858,3.7
71112,Château,232,0,1612,1612,6.9
77489,Vaux-sur-Lunain,232,0,244,244,1.1
78305,Herbeville,232,0,544,544,2.3
81129,Lagardiolle,232,0,258,258,1.1
82153,Saint-Amans-du-Pech,232,0,7264,7264,31.3
86084,Coulonges-les-Hérolles,232,0,9383,9383,40.4
86109,Guesnes,232,0,1185,1185,5.1
86196,Pouançay,232,0,1185,1185,5.1
87145,Saint-Georges-les-Landes,232,2860,3949,6809,29.3
88172,Fiménil,232,0,304,304,1.3
3058,Chappes,231,0,8253,8253,35.7
8291,Mogues,231,0,8178,8178,35.4
10290,Planty,231,0,4030,4030,17.4
10348,Saint-Lupien,231,0,0,0,0
14131,Canapville,231,0,3713,3713,16.1
14216,Damblainville,231,0,3619,3619,15.7
15186,Sainte-Eulalie,231,0,3825,3825,16.6
21270,Flavignerot,231,0,6703,6703,29
21399,Meilly-sur-Rouvres,231,0,3511,3511,15.2
26282,Romeyer,231,400,12843,13243,57.3
26327,Saint-Roman,231,1461,12843,14304,61.9
27592,Saint-Pierre-de-Salerne,231,0,996,996,4.3
31018,Arnaud-Guilhem,231,0,12415,12415,53.7
32222,Magnan,231,0,154,154,0.7
32390,Saint-Martin-d'Armagnac,231,0,154,154,0.7
39179,Crenans,231,0,6723,6723,29.1
42337,Vivans,231,0,6817,6817,29.5
55521,Troyon,231,0,3404,3404,14.7
57086,Belles-Forêts,231,0,1504,1504,6.5
57281,Haboudange,231,0,764,764,3.3
57532,Pagny-lès-Goin,231,0,8846,8846,38.3
57612,Saint-Hubert,231,0,562,562,2.4
60262,Le Frestoy-Vaux,231,0,1280,1280,5.5
60596,Saint-Samson-la-Poterie,231,0,1133,1133,4.9
62574,Mingoval,231,0,1919,1919,8.3
64049,Aroue-Ithorots-Olhaïby,231,0,6003,6003,26
65238,Labassère,231,0,1734,1734,7.5
65374,Puydarrieux,231,0,7483,7483,32.4
71338,Ozenay,231,0,5376,5376,23.3
72273,Saint-Christophe-du-Jambet,231,0,10873,10873,47.1
77263,Luisetaines,231,820,3271,4091,17.7
80006,Agenvillers,231,0,5720,5720,24.8
80330,Forceville-en-Vimeu,231,0,319,319,1.4
81165,Milhars,231,0,5878,5878,25.4
82068,Gimat,231,0,5415,5415,23.4
88446,Saulxures-lès-Bulgnéville,231,0,81,81,0.4
2320,Fontaine-lès-Clercs,230,0,32872,32872,142.9
2356,Grisolles,230,0,5316,5316,23.1
3078,Chouvigny,230,0,4704,4704,20.5
5171,Théus,230,0,2052,2052,8.9
10320,Rilly-Sainte-Syre,230,0,236,236,1
17060,Boutenac-Touvent,230,0,3622,3622,15.7
19039,Champagnac-la-Noaille,230,0,2951,2951,12.8
21062,Bellenot-sous-Pouilly,230,0,3496,3496,15.2
31083,Boussan,230,0,4764,4764,20.7
32206,Laymont,230,0,1435,1435,6.2
33432,Saint-Loubert,230,0,2352,2352,10.2
35261,Saint-Christophe-de-Valains,230,0,2816,2816,12.2
37069,Chemillé-sur-Indrois,230,0,3992,3992,17.4
39554,Vers-en-Montagne,230,1580,2329,3909,17
40058,Cachen,230,0,2627,2627,11.4
40170,Maillères,230,0,1810,1810,7.9
41048,Chauvigny-du-Perche,230,0,1168,1168,5.1
45215,Montliard,230,0,1743,1743,7.6
46060,Carnac-Rouffiac,230,0,8363,8363,36.4
50152,Les Cresnays,230,0,5659,5659,24.6
51168,Coolus,230,0,11690,11690,50.8
53148,Mée,230,0,1523,1523,6.6
53187,Ravigny,230,0,2046,2046,8.9
54433,Port-sur-Seille,230,0,2513,2513,10.9
57703,Veckersviller,230,0,1497,1497,6.5
63119,Condat-lès-Montboissier,230,1370,2078,3448,15
63123,Cournols,230,0,4123,4123,17.9
63253,Noalhat,230,0,5333,5333,23.2
64201,Dognen,230,0,4808,4808,20.9
64266,Hours,230,0,2401,2401,10.4
65299,Marsac,230,0,5195,5195,22.6
65330,Nouilhan,230,0,5195,5195,22.6
65442,Thermes-Magnoac,230,0,7451,7451,32.4
65462,Vidouze,230,0,5195,5195,22.6
67274,Lorentzen,230,365,2883,3248,14.1
70137,Chassey-lès-Montbozon,230,0,736,736,3.2
71060,Briant,230,0,6518,6518,28.3
71130,Chissey-lès-Mâcon,230,0,1599,1599,7
71435,Saint-Julien-sur-Dheune,230,0,3696,3696,16.1
76703,Touffreville-sur-Eu,230,1170,1455,2625,11.4
77198,Fromont,230,0,118,118,0.5
77476,Trocy-en-Multien,230,0,3377,3377,14.7
81262,Saint-Marcel-Campes,230,0,5852,5852,25.4
81316,Vieux,230,0,12637,12637,54.9
86090,Curçay-sur-Dive,230,0,1175,1175,5.1
86110,Haims,230,0,9302,9302,40.4
3021,Bègues,229,0,4684,4684,20.5
3032,Blomard,229,0,8181,8181,35.7
8336,Osnes,229,0,8108,8108,35.4
10335,Saint-Benoist-sur-Vanne,229,0,3995,3995,17.4
12015,Auriac-Lagast,229,0,12496,12496,54.6
15189,Saint-Gérons,229,6533,2008,8541,37.3
16352,Saint-Simon,229,1840,8568,10408,45.4
19259,Sexcles,229,0,680,680,3
23018,Bazelat,229,0,4334,4334,18.9
28045,Boissy-en-Drouais,229,0,306,306,1.3
2A071,Casalabriva,229,0,0,0,0
30058,La Cadière-et-Cambo,229,0,476,476,2.1
31006,Albiac,229,0,1117,1117,4.9
31155,Couret,229,0,12307,12307,53.7
32101,Céran,229,0,130,130,0.6
32165,Juilles,229,0,2909,2909,12.7
32258,Mirepoix,229,0,8069,8069,35.2
33235,Lavazan,229,0,76,76,0.3
33426,Saint-Laurent-des-Combes,229,0,8897,8897,38.9
36222,Thizay,229,0,4651,4651,20.3
46227,Promilhanes,229,0,668,668,2.9
48111,Pelouse,229,2565,9034,11599,50.7
50296,Maupertus-sur-Mer,229,470,7203,7673,33.5
51072,Bouilly,229,0,4070,4070,17.8
55332,Menaucourt,229,0,2761,2761,12.1
58166,Mhère,229,0,3561,3561,15.6
59198,Eppe-Sauvage,229,0,3757,3757,16.4
59563,Semousies,229,0,1814,1814,7.9
59655,Wemaers-Cappel,229,0,1399,1399,6.1
60550,Rothois,229,0,1124,1124,4.9
61233,Lonlay-le-Tesson,229,0,6133,6133,26.8
63441,Valcivières,229,0,2069,2069,9
70017,Anchenoncourt-et-Chazel,229,0,1360,1360,5.9
70193,Cult,229,0,155,155,0.7
70511,Vaite,229,0,1175,1175,5.1
72017,Auvers-sous-Montfaucon,229,0,2081,2081,9.1
76283,Fresles,229,0,5349,5349,23.4
76510,Prétot-Vicquemare,229,0,505,505,2.2
80054,Barleux,229,0,1641,1641,7.2
85074,La Couture,229,0,4840,4840,21.1
88488,Valfroicourt,229,0,81,81,0.4
2661,Royaucourt-et-Chailvet,228,0,226,226,1
3152,Louroux-de-Bouble,228,0,4664,4664,20.5
13061,Saint-Pierre-de-Mézoargues,228,0,4298,4298,18.9
14040,Barbeville,228,0,8788,8788,38.5
14260,Fauguernon,228,0,2538,2538,11.1
17062,Bresdon,228,0,6351,6351,27.9
18135,Maisonnais,228,0,611,611,2.7
18192,Reigny,228,0,611,611,2.7
21058,Belan-sur-Ource,228,0,3804,3804,16.7
21205,Courcelles-lès-Semur,228,0,4841,4841,21.2
21459,Noiron-sur-Bèze,228,0,993,993,4.4
21571,Saint-Sauveur,228,0,0,0,0
23144,La Nouaille,228,0,8623,8623,37.8
24465,Saint-Michel-de-Double,228,6760,10918,17678,77.5
25026,Arc-sous-Montenot,228,0,5153,5153,22.6
26236,Pierrelongue,228,0,11716,11716,51.4
27281,Gaudreville-la-Rivière,228,0,2028,2028,8.9
30113,Fons-sur-Lussan,228,0,1752,1752,7.7
30198,Les Plantiers,228,0,11405,11405,50
31102,Cambiac,228,3801,1112,4913,21.5
31142,Cier-de-Luchon,228,0,2182,2182,9.6
33223,Landerrouat,228,0,1721,1721,7.5
33278,Mauriac,228,0,2264,2264,9.9
34066,Cazevieille,228,0,4248,4248,18.6
36124,Migné,228,0,1130,1130,5
36160,Pommiers,228,0,1674,1674,7.3
40153,Le Leuy,228,0,5363,5363,23.5
41172,Ouzouer-le-Doyen,228,0,1158,1158,5.1
43210,Saint-Martin-de-Fugères,228,0,1265,1265,5.5
45094,Chevry-sous-le-Bignon,228,0,2236,2236,9.8
46020,Beauregard,228,0,1282,1282,5.6
50135,Clitourps,228,800,7172,7972,35
51056,Bethon,228,0,2975,2975,13
51307,Jonchery-sur-Suippe,228,0,2145,2145,9.4
53118,Le Housseau-Brétignolles,228,0,8473,8473,37.2
53178,Peuton,228,0,10236,10236,44.9
53235,Sainte-Marie-du-Bois,228,0,8473,8473,37.2
55191,Foameix-Ornel,228,0,4119,4119,18.1
57158,Craincourt,228,0,754,754,3.3
57424,Lucy,228,0,754,754,3.3
58017,Aunay-en-Bazois,228,0,11761,11761,51.6
58090,Courcelles,228,0,4770,4770,20.9
58115,Fleury-sur-Loire,228,0,588,588,2.6
58140,Larochemillay,228,0,11761,11761,51.6
60316,Hodenc-l'Évêque,228,0,947,947,4.2
61480,Tanville,228,1140,1430,2570,11.3
62095,Beaumetz-lès-Aire,228,0,20292,20292,89
62690,Raye-sur-Authie,228,0,3610,3610,15.8
62888,Wierre-au-Bois,228,0,658,658,2.9
64110,Béost,228,0,2894,2894,12.7
64435,Osserain-Rivareyte,228,0,5925,5925,26
64515,Sedze-Maubecq,228,0,5150,5150,22.6
67006,Altenheim,228,300,16082,16382,71.9
68303,Schwoben,228,0,6116,6116,26.8
77313,Montmachoux,228,0,161,161,0.7
88222,Gugnécourt,228,0,299,299,1.3
90044,Felon,228,0,6791,6791,29.8
10052,Boulages,227,0,233,233,1
14637,Saint-Ouen-du-Mesnil-Oger,227,0,1827,1827,8
15170,Saint-Amandin,227,8720,3501,12221,53.8
16052,Bors (Canton de Tude-et-Lavalette),227,2348,10674,13022,57.4
17122,Coulonges,227,0,2680,2680,11.8
18072,Cornusse,227,0,444,444,2
21707,Villy-en-Auxois,227,0,4820,4820,21.2
25303,Hauterive-la-Fresse,227,0,0,0,0
25626,Villers-Saint-Martin,227,0,11315,11315,49.8
28087,Châtaincourt,227,0,304,304,1.3
29013,Botmeur,227,0,11801,11801,52
32075,Cassaigne,227,0,873,873,3.8
32373,Sainte-Dode,227,0,502,502,2.2
36059,Condé,227,0,4611,4611,20.3
36104,Lurais,227,0,1248,1248,5.5
39504,Sarrogna,227,1429,6606,8035,35.4
48063,Fontans,227,0,2332,2332,10.3
48173,Saint-Michel-de-Dèze,227,0,12363,12363,54.5
50186,Flottemanville,227,0,7140,7140,31.5
50423,Rampan,227,0,3357,3357,14.8
51270,Gigny-Bussy,227,0,1410,1410,6.2
51521,Saint-Vrain,227,0,2056,2056,9.1
51603,Vélye,227,0,4511,4511,19.9
53266,Trans,227,0,1624,1624,7.2
55383,Neuvilly-en-Argonne,227,0,2373,2373,10.5
57203,Évrange,227,0,5527,5527,24.3
58110,Epiry,227,0,3530,3530,15.6
59415,Montrécourt,227,0,57,57,0.3
59496,Rejet-de-Beaulieu,227,0,1560,1560,6.9
61358,Sai,227,0,479,479,2.1
62185,Bullecourt,227,0,1129,1129,5
63450,Verneugheol,227,0,7676,7676,33.8
64149,Bugnein,227,0,4745,4745,20.9
64554,Viellenave-d'Arthez,227,0,6112,6112,26.9
65010,Angos,227,0,2169,2169,9.6
71098,Charbonnat,227,0,5079,5079,22.4
71229,Les Guerreaux,227,0,880,880,3.9
80357,Fresnoy-au-Val,227,0,313,313,1.4
80821,Warlus,227,0,313,313,1.4
81313,Le Verdier,227,0,12472,12472,54.9
87074,Les Grands-Chézeaux,227,1580,3863,5443,24
88167,Faucompierre,227,0,298,298,1.3
4182,Saint-Julien-d'Asse,226,0,9473,9473,41.9
4234,Venterol,226,0,2016,2016,8.9
8058,Belval,226,0,5191,5191,23
8207,Ham-sur-Meuse,226,0,1451,1451,6.4
8352,Raillicourt,226,0,4957,4957,21.9
12151,Montézic,226,0,7658,7658,33.9
18122,Lapan,226,0,4091,4091,18.1
18129,Lissay-Lochy,226,1600,4329,5929,26.2
19109,Lascaux,226,0,3607,3607,16
19186,Saint-Bonnet-Elvert,226,0,671,671,3
23027,Bosmoreau-les-Mines,226,0,7086,7086,31.4
24119,Cherval,226,2200,1716,3916,17.3
24385,Saint-Cernin-de-Labarde,226,0,424,424,1.9
26175,Marignac-en-Diois,226,400,12565,12965,57.4
27605,Saint-Sylvestre-de-Cormeilles,226,0,3480,3480,15.4
31119,Castelnau-Picampeau,226,0,7914,7914,35
31141,Ciadoux,226,0,4681,4681,20.7
32078,Castelnau-d'Arbieu,226,0,128,128,0.6
32221,Lussan,226,0,2871,2871,12.7
37033,Boussay,226,0,3923,3923,17.4
38089,Chassignieu,226,0,1982,1982,8.8
41122,Maray,226,0,4762,4762,21.1
46295,Saint-Vincent-du-Pendit,226,0,7373,7373,32.6
47282,Saint-Vincent-de-Lamontjoie,226,0,1096,1096,4.8
48121,Prunières,226,0,2321,2321,10.3
51073,Bouleuse,226,0,4016,4016,17.8
51429,Pévy,226,0,4016,4016,17.8
53087,La Cropte,226,0,1358,1358,6
54299,Laneuveville-devant-Bayon,226,0,0,0,0
54313,Létricourt,226,0,1337,1337,5.9
54370,Minorville,226,0,471,471,2.1
55397,Pagny-la-Blanche-Côte,226,0,912,912,4
57098,Bourgaltroff,226,0,748,748,3.3
57121,Burtoncourt,226,0,550,550,2.4
58132,Guipy,226,0,3514,3514,15.5
62165,Bournonville,226,0,653,653,2.9
63209,Mareugheol,226,0,1469,1469,6.5
63238,Montfermy,226,0,7642,7642,33.8
67556,Zeinheim,226,540,12275,12815,56.7
69130,Meaux-la-Montagne,226,0,2671,2671,11.8
71228,Guerfand,226,0,2608,2608,11.5
76297,Gancourt-Saint-Étienne,226,0,4269,4269,18.9
76544,Rouvray-Catillon,226,0,4269,4269,18.9
76584,Saint-Germain-sur-Eaulne,226,0,5279,5279,23.4
78194,Dannemarie,226,0,2266,2266,10
79040,La Boissière-en-Gâtine,226,0,1863,1863,8.2
80671,Ribeaucourt,226,0,389,389,1.7
81025,Belcastel,226,0,738,738,3.3
81259,Saint-Julien-Gaulène,226,0,6983,6983,30.9
2693,Saint-Rémy-Blanzy,225,0,752,752,3.3
2779,Vénérolles,225,0,1240,1240,5.5
3299,Varennes-sur-Tèche,225,0,3886,3886,17.3
8450,This,225,0,3503,3503,15.6
10122,Davrey,225,0,4189,4189,18.6
10444,Vulaines,225,0,3926,3926,17.4
11342,Saint-Frichoux,225,0,1459,1459,6.5
14093,Branville,225,0,3616,3616,16.1
15002,Alleuze,225,2630,4977,7607,33.8
16099,Chillac,225,0,12031,12031,53.5
17066,Brie-sous-Archiac,225,0,2657,2657,11.8
17135,Cressé,225,0,6267,6267,27.9
17374,Sainte-Même,225,0,6267,6267,27.9
18064,Chéry,225,0,3053,3053,13.6
18161,Neuilly-en-Dun,225,0,3605,3605,16
21712,Volnay,225,0,978,978,4.3
22043,Coëtlogon,225,0,0,0,0
23202,Saint-Hilaire-le-Château,225,0,7055,7055,31.4
24257,Marsalès,225,2350,818,3168,14.1
26238,Les Pilles,225,0,11562,11562,51.4
26316,Saint-Martin-le-Colonel,225,590,14092,14682,65.3
27190,Croisy-sur-Eure,225,0,1182,1182,5.3
2A108,Évisa,225,0,1036,1036,4.6
31544,Sengouagnet,225,0,12092,12092,53.7
32089,Castillon-Massas,225,0,7928,7928,35.2
32264,Monclar,225,0,0,0,0
34271,Saint-Julien,225,0,852,852,3.8
36145,Obterre,225,0,1115,1115,5
38154,Entraigues,225,0,2356,2356,10.5
39570,Villers-les-Bois,225,525,4977,5502,24.5
41030,Cellé,225,0,2783,2783,12.4
47308,Thouars-sur-Garonne,225,0,1091,1091,4.8
48193,Vebron,225,9310,5519,14829,65.9
49288,Saint-Jean-de-la-Croix,225,0,4467,4467,19.9
51154,Clamanges,225,0,4471,4471,19.9
51188,Courmas,225,0,3999,3999,17.8
55109,Chauvency-le-Château,225,0,8044,8044,35.8
55386,Nonsard-Lamarche,225,0,2674,2674,11.9
60236,Flavy-le-Meldeux,225,0,0,0,0
64069,Aste-Béon,225,0,2856,2856,12.7
64251,Guinarthe-Parenties,225,0,4703,4703,20.9
64411,Musculdy,225,0,5847,5847,26
65133,Castéra-Lou,225,0,1429,1429,6.4
65445,Tilhouse,225,0,672,672,3
67249,Krautwiller,225,0,2736,2736,12.2
71088,La Chapelle-au-Mans,225,0,1157,1157,5.1
72120,Doucelles,225,0,10591,10591,47.1
72292,Saint-Jean-des-Échelles,225,0,1373,1373,6.1
72312,Saint-Pierre-des-Bois,225,0,2045,2045,9.1
74129,La Forclaz,225,3490,15722,19212,85.4
76630,Saint-Ouen-sous-Bailly,225,0,1423,1423,6.3
79336,Vançais,225,0,6498,6498,28.9
81272,Saint-Urcisse,225,0,12362,12362,54.9
89247,Mélisey,225,0,523,523,2.3
95309,Hodent,225,0,1422,1422,6.3
2391,Jeantes,224,0,4397,4397,19.6
2418,Lerzy,224,0,3994,3994,17.8
3303,Venas,224,1750,8002,9752,43.5
8085,Brieulles-sur-Bar,224,0,5420,5420,24.2
8333,Olizy-Primat,224,0,5420,5420,24.2
10438,Vitry-le-Croisé,224,0,3910,3910,17.5
11310,Rennes-les-Bains,224,1780,2949,4729,21.1
14033,Auvillars,224,0,3600,3600,16.1
15049,Cheylade,224,18525,3454,21979,98.1
17162,Fontaine-Chalendray,224,0,6239,6239,27.9
18266,Touchay,224,1761,600,2361,10.5
19099,Lagleygeolle,224,0,1129,1129,5
22378,Trévérec,224,0,4536,4536,20.2
28289,Ormoy,224,0,300,300,1.3
2B088,Chiatra,224,0,1705,1705,7.6
31504,Saint-Médard,224,0,12039,12039,53.7
33137,Cours-les-Bains,224,0,74,74,0.3
34055,Castanet-le-Haut,224,0,3963,3963,17.7
36248,Vouillon,224,0,4550,4550,20.3
40327,Vielle-Soubiran,224,0,2558,2558,11.4
41118,Loreux,224,0,4720,4720,21.1
43172,Saint-Bonnet-le-Froid,224,9000,1794,10794,48.2
46059,Carlucet,224,0,7308,7308,32.6
46169,Léobard,224,0,6335,6335,28.3
47303,Soumensac,224,0,11034,11034,49.3
59493,Ramousies,224,0,1774,1774,7.9
60058,Beauvoir,224,0,5051,5051,22.5
60128,Canny-sur-Thérain,224,0,1099,1099,4.9
64019,Amorots-Succos,224,0,5821,5821,26
64437,Ostabat-Asme,224,0,5821,5821,26
64481,Saint-Goin,224,0,4824,4824,21.5
66030,Calce,224,0,1866,1866,8.3
67386,Rauwiller,224,1763,2808,4571,20.4
68261,Rammersmatt,224,0,3770,3770,16.8
73147,Loisieux,224,0,1421,1421,6.3
76746,Vinnemerville,224,2960,1451,4411,19.7
77033,Bezalles,224,0,808,808,3.6
77103,Châtillon-la-Borde,224,0,212,212,0.9
87179,Saint-Sornin-la-Marche,224,0,3812,3812,17
88454,Sercœur,224,0,5633,5633,25.1
89017,Argenteuil-sur-Armançon,224,0,520,520,2.3
89131,Cruzy-le-Châtel,224,700,520,1220,5.4
1193,Izieu,223,0,2485,2485,11.1
2462,Mareuil-en-Dôle,223,0,5154,5154,23.1
3219,Saint-Bonnet-de-Four,223,0,7967,7967,35.7
7336,Vernon,223,2870,15549,18419,82.6
8170,Fleigneux,223,0,5123,5123,23
9198,Montardit,223,0,27023,27023,121.2
10002,Ailleville,223,0,0,0,0
10306,Proverville,223,0,0,0,0
12027,Bessuéjouls,223,0,1104,1104,5
12229,Saint-Jean-d'Alcapiès,223,0,467,467,2.1
14667,Saon,223,0,1544,1544,6.9
15046,Chaussenac,223,5940,3692,9632,43.2
16237,Mouton,223,550,2803,3353,15
17137,La Croix-Comtesse,223,0,6212,6212,27.9
21139,Champeau-en-Morvan,223,0,640,640,2.9
21547,Saint-Euphrône,223,0,4735,4735,21.2
26028,Bathernay,223,0,9812,9812,44
27124,Cailly-sur-Eure,223,0,6613,6613,29.7
28049,Boncé,223,0,6498,6498,29.1
28163,Fresnay-le-Gilmert,223,0,6498,6498,29.1
28270,Moriers,223,0,410,410,1.8
31386,Montoulieu-Saint-Bernard,223,0,4619,4619,20.7
33171,Fossès-et-Baleyssac,223,0,1816,1816,8.1
33283,Mesterrieux,223,0,2215,2215,9.9
45076,La Chapelle-Saint-Sépulcre,223,0,676,676,3
47103,Fréchou,223,0,1081,1081,4.8
50150,Crasville,223,660,7014,7674,34.4
51145,Chenay,223,0,3963,3963,17.8
52311,Marcilly-en-Bassigny,223,0,1023,1023,4.6
53198,Saint-Aubin-du-Désert,223,0,1983,1983,8.9
54210,Fréménil,223,0,791,791,3.5
54243,Hablainville,223,0,985,985,4.4
54408,Olley,223,0,2071,2071,9.3
55276,Landrecourt-Lempire,223,0,1419,1419,6.4
57189,Eincheville,223,0,3808,3808,17.1
58276,Sémelay,223,0,11503,11503,51.6
60217,Escames,223,0,1094,1094,4.9
62898,Wisques,223,0,482,482,2.2
63186,Landogne,223,0,7541,7541,33.8
67022,Bassemberg,223,427,35371,35798,160.5
71195,Farges-lès-Mâcon,223,0,5190,5190,23.3
71407,Saint-Didier-sur-Arroux,223,0,4989,4989,22.4
72322,Saint-Ulphace,223,0,1360,1360,6.1
80521,Maurepas,223,0,1598,1598,7.2
87043,Cheissoux,223,0,3176,3176,14.2
7190,Rochecolombe,222,1000,13556,14556,65.6
7258,Saint-Julien-Vocance,222,360,1144,1504,6.8
8418,Sévigny-Waleppe,222,0,4246,4246,19.1
8427,Sorbon,222,0,4246,4246,19.1
10090,Chauchigny,222,0,228,228,1
10196,Lignières,222,0,4133,4133,18.6
10308,Prunay-Belleville,222,0,0,0,0
11043,Bouilhonnac,222,0,1440,1440,6.5
12095,Escandolières,222,0,478,478,2.2
12128,Lescure-Jaoul,222,0,5150,5150,23.2
14196,Crépon,222,0,2722,2722,12.3
14546,Rouvres,222,0,3478,3478,15.7
14756,La Villette,222,0,101,101,0.5
15019,Bassignac,222,5380,1136,6516,29.4
16035,Beaulieu-sur-Sonnette,222,1595,4567,6162,27.8
19022,Benayes,222,0,2135,2135,9.6
25619,Les Villedieu,222,0,13221,13221,59.6
28108,Cormainville,222,0,1166,1166,5.3
28169,Garancières-en-Beauce,222,0,1166,1166,5.3
31034,Auzas,222,0,11931,11931,53.7
31487,Saint-Ignan,222,0,4598,4598,20.7
34030,Berlou,222,0,840,840,3.8
37037,Brèches,222,0,2059,2059,9.3
40032,Belhade,222,0,1747,1747,7.9
41290,Villeromain,222,0,2746,2746,12.4
45065,Césarville-Dossainville,222,0,276,276,1.2
46040,Cabrerets,222,0,1874,1874,8.4
47010,Antagnac,222,0,3746,3746,16.9
47183,Montauriol,222,0,5669,5669,25.5
50193,Le Fresne-Poret,222,0,5462,5462,24.6
50311,Le Mesnil-Garnier,222,0,6423,6423,28.9
50618,Varouville,222,885,6983,7868,35.4
54539,Vacqueville,222,0,981,981,4.4
55069,Brabant-le-Roi,222,0,4927,4927,22.2
55474,Sauvigny,222,0,896,896,4
57404,Lindre-Basse,222,0,735,735,3.3
57718,Villers-Stoncourt,222,0,541,541,2.4
60363,Lierville,222,4555,4875,9430,42.5
62234,Conchy-sur-Canche,222,0,4796,4796,21.6
62496,Lefaux,222,0,2362,2362,10.6
64347,Lonçon,222,0,3476,3476,15.7
65334,Omex,222,0,2121,2121,9.6
76139,Bradiancourt,222,0,5186,5186,23.4
76569,Sainte-Colombe,222,0,1438,1438,6.5
80232,Damery,222,0,268,268,1.2
80477,Ligescourt,222,0,5497,5497,24.8
89222,Levis,222,0,10024,10024,45.2
2628,Puiseux-en-Retz,221,0,213,213,1
2740,Thenailles,221,0,3941,3941,17.8
4059,Clumanc,221,0,7814,7814,35.4
8401,Saulces-Champenoises,221,0,4847,4847,21.9
10058,Bragelogne-Beauvoir,221,0,3858,3858,17.5
10181,Jully-sur-Sarce,221,0,3858,3858,17.5
11157,Fraissé-des-Corbières,221,0,340,340,1.5
12017,Ayssènes,221,0,3970,3970,18
12183,Plaisance,221,0,463,463,2.1
14227,Douville-en-Auge,221,0,2807,2807,12.7
14559,Saint-Aubin-des-Bois,221,0,101,101,0.5
16279,Rioux-Martin,221,5047,10392,15439,69.9
18185,Presly,221,0,0,0,0
21619,Tanay,221,0,963,963,4.4
23249,Saint-Yrieix-la-Montagne,221,0,8358,8358,37.8
25621,Villeneuve-d'Amont,221,0,4995,4995,22.6
26154,Lachau,221,0,6589,6589,29.8
26304,Saint-Ferréol-Trente-Pas,221,0,11356,11356,51.4
28216,Louvilliers-en-Drouais,221,0,296,296,1.3
29246,Saint-Eloy,221,1954,1713,3667,16.6
2B350,Vignale,221,0,4121,4121,18.6
30318,Servas,221,0,6908,6908,31.3
31332,Mauvaisin,221,0,1078,1078,4.9
36029,Buxeuil,221,0,4489,4489,20.3
37191,Razines,221,0,5996,5996,27.1
39543,Vannoz,221,0,2238,2238,10.1
40297,Le Sen,221,0,1739,1739,7.9
46004,Anglars,221,0,6526,6526,29.5
47132,Lalandusse,221,0,5643,5643,25.5
48032,Le Buisson,221,7400,5269,12669,57.3
54411,Ormes-et-Ville,221,0,0,0,0
54441,Puxieux,221,0,1319,1319,6
55244,Herméville-en-Woëvre,221,0,3992,3992,18.1
55396,Ourches-sur-Meuse,221,0,892,892,4
62211,Capelle-Fermont,221,0,1836,1836,8.3
63011,Ars-les-Favets,221,0,343,343,1.6
63059,Busséol,221,0,3962,3962,17.9
70213,Éhuns,221,0,818,818,3.7
70338,Melincourt,221,0,1404,1404,6.4
70384,Neuvelle-lès-la-Charité,221,0,568,568,2.6
73189,Notre-Dame-du-Cruet,221,0,31662,31662,143.3
76052,Bailleul-Neuville,221,0,1631,1631,7.4
80161,Cahon,221,0,1469,1469,6.6
80776,Varennes,221,0,247,247,1.1
82016,Belvèze,221,0,6919,6919,31.3
82183,Tréjouls,221,0,6919,6919,31.3
83074,La Martre,221,0,861,861,3.9
83142,Trigance,221,0,861,861,3.9
86038,Brion,221,0,4977,4977,22.5
88318,Moyemont,221,0,1103,1103,5
3124,Gouise,220,0,2961,2961,13.5
3260,Saint-Sornin,220,0,3379,3379,15.4
4128,Montfuron,220,2000,2557,4557,20.7
7114,Labatie-d'Andaure,220,600,6299,6899,31.4
8305,Montigny-sur-Vence,220,0,4825,4825,21.9
8368,Roizy,220,0,4207,4207,19.1
10169,Gumery,220,0,1359,1359,6.2
10171,Hampigny,220,0,4644,4644,21.1
11079,Caudebronde,220,0,2842,2842,12.9
15232,Tanavelle,220,1670,4866,6536,29.7
16139,Fleurac,220,0,8231,8231,37.4
17173,La Genétouze,220,0,2598,2598,11.8
18099,Garigny,220,0,759,759,3.4
19157,Palisse,220,0,3016,3016,13.7
21366,Magny-lès-Aubigny,220,0,1650,1650,7.5
22312,Saint-Maden,220,0,5861,5861,26.6
24511,Saint-Vincent-Jalmoutiers,220,2770,769,3539,16.1
25371,Mazerolles-le-Salin,220,0,3876,3876,17.6
29261,Saint-Rivoal,220,0,11437,11437,52
2A186,Olivese,220,0,165,165,0.8
32174,Ladevèze-Rivière,220,684,4056,4740,21.5
32192,Lannux,220,0,6887,6887,31.3
32414,Sarragachies,220,0,2202,2202,10
33326,Pleine-Selve,220,0,2051,2051,9.3
38192,Hurtières,220,930,4088,5018,22.8
41081,Faye,220,0,2721,2721,12.4
41190,Rocé,220,0,2721,2721,12.4
45305,Seichebrières,220,0,428,428,1.9
57302,Hattigny,220,0,1432,1432,6.5
58089,Couloutre,220,0,4386,4386,19.9
60174,Crapeaumesnil,220,0,1923,1923,8.7
60434,Mortemer,220,0,1923,1923,8.7
60520,Le Quesnel-Aubry,220,0,4961,4961,22.6
62002,Ablainzevelle,220,0,1094,1094,5
62303,Érin,220,0,4753,4753,21.6
62444,Hervelinghen,220,0,875,875,4
64186,Charre,220,0,4599,4599,20.9
66070,Espira-de-Conflent,220,0,6589,6589,30
70077,Borey,220,0,814,814,3.7
70134,Chariez,220,0,11381,11381,51.7
71357,Pourlans,220,0,27,27,0.1
73192,Le Noyer,220,0,2796,2796,12.7
76129,Boudeville,220,160,485,645,2.9
79167,Marnes,220,0,3423,3423,15.6
89036,La Belliole,220,1400,780,2180,9.9
90100,Vauthiermont,220,3100,7675,10775,49
2121,Breny,219,0,731,731,3.3
2207,Commenchon,219,0,3935,3935,18
2386,Iron,219,0,1207,1207,5.5
2388,Iviers,219,0,4299,4299,19.6
8103,Charbogne,219,0,4803,4803,21.9
8126,Condé-lès-Herpy,219,0,4188,4188,19.1
8255,Linay,219,0,7753,7753,35.4
9228,Perles-et-Castelet,219,0,31540,31540,144
10369,Semoine,219,0,186,186,0.8
12250,Saint-Symphorien-de-Thénières,219,0,7421,7421,33.9
15201,Saint-Martin-sous-Vigouroux,219,360,4844,5204,23.8
16302,Saint-Avit,219,2755,10298,13053,59.6
17069,Brives-sur-Charente,219,0,2586,2586,11.8
19014,Auriac,219,0,650,650,3
22383,Troguéry,219,0,4351,4351,19.9
26141,Gigors-et-Lozeron,219,0,2653,2653,12.1
32007,Ardizas,219,0,826,826,3.8
39019,Les Arsures,219,645,4844,5489,25.1
40232,Poudenx,219,0,5060,5060,23.1
43136,Monistrol-d'Allier,219,5926,9112,15038,68.7
46126,Goujounac,219,0,6194,6194,28.3
48190,Termes,219,0,8093,8093,37
50146,Courtils,219,0,5388,5388,24.6
51203,Cuperly,219,0,2061,2061,9.4
51246,Favresse,219,0,1361,1361,6.2
52087,Buxières-lès-Villiers,219,0,24056,24056,109.8
52524,Vignory,219,0,24056,24056,109.8
53206,Saint-Charles-la-Forêt,219,0,1316,1316,6
55300,Longeaux,219,0,2640,2640,12.1
58244,Saint-Hilaire-en-Morvan,219,0,2581,2581,11.8
62450,Hestrus,219,0,4731,4731,21.6
62465,Humbercamps,219,0,1820,1820,8.3
64232,Garlède-Mondebat,219,0,3429,3429,15.7
65156,Dours,219,0,1390,1390,6.3
67231,Kauffenheim,219,0,2654,2654,12.1
70234,Filain,219,0,701,701,3.2
70525,Vauconcourt-Nervezain,219,0,1124,1124,5.1
76197,Criquetot-sur-Longueville,219,0,1767,1767,8.1
79212,Pliboux,219,0,0,0,0
80150,Buire-Courcelles,219,0,1569,1569,7.2
80200,Cocquerel,219,0,5423,5423,24.8
80703,Saint-Germain-sur-Bresle,219,0,302,302,1.4
80769,Treux,219,0,29,29,0.1
81247,Saint-Cirgue,219,0,6767,6767,30.9
88110,Clézentaine,219,0,1093,1093,5
88169,Fays,219,0,287,287,1.3
95054,Le Bellay-en-Vexin,219,0,10062,10062,45.9
2433,Lislet,218,0,2402,2402,11
2761,Variscourt,218,0,587,587,2.7
7335,Vaudevant,218,2650,9592,12242,56.2
8347,Puilly-et-Charbeaux,218,0,7718,7718,35.4
10250,Montier-en-l'Isle,218,0,0,0,0
11316,Rivel,218,0,2395,2395,11
16301,Saint-Aulais-la-Chapelle,218,5131,11657,16788,77
21020,Arconcey,218,0,3313,3313,15.2
23203,Saint-Julien-la-Genête,218,0,3277,3277,15
23223,Saint-Moreil,218,0,6835,6835,31.4
28276,Neuvy-en-Beauce,218,0,0,0,0
32197,Larroque-sur-l'Osse,218,0,838,838,3.8
33210,Juillac,218,0,1521,1521,7
39014,Archelange,218,1050,4425,5475,25.1
39063,Bonlieu,218,0,6344,6344,29.1
39472,Rye,218,400,5794,6194,28.4
45152,Gémigny,218,0,307,307,1.4
46092,Esclauzels,218,0,1226,1226,5.6
54103,Bruville,218,0,2024,2024,9.3
58075,Chitry-les-Mines,218,0,3390,3390,15.6
58299,Trucy-l'Orgueilleux,218,0,4561,4561,20.9
60407,Monceaux-l'Abbaye,218,0,1070,1070,4.9
61072,Canapville,218,0,1576,1576,7.2
62307,Escalles,218,0,6552,6552,30.1
62316,Estrée-Wamin,218,0,1811,1811,8.3
62521,La Loge,218,0,3452,3452,15.8
64243,Géus-d'Arzacq,218,1260,3413,4673,21.4
67227,Itterswiller,218,30,6742,6772,31.1
67483,Struth,218,1808,5875,7683,35.2
67502,Uttenhoffen,218,0,7984,7984,36.6
71085,Change,218,0,948,948,4.3
71577,Villegaudin,218,0,2516,2516,11.5
72326,Saosnes,218,0,4042,4042,18.5
73005,Aillon-le-Vieux,218,0,2771,2771,12.7
76086,Bertrimont,218,0,1759,1759,8.1
78385,Ménerville,218,0,1114,1114,5.1
80030,Arry,218,0,5398,5398,24.8
80179,Caulières,218,0,301,301,1.4
80781,Vauvillers,218,0,3945,3945,18.1
81047,Cadix,218,0,6736,6736,30.9
86181,Nueil-sous-Faye,218,0,1114,1114,5.1
89302,Plessis-Saint-Jean,218,225,40,265,1.2
3004,Andelaroche,217,0,436,436,2
5184,Vitrolles,217,0,308,308,1.4
7222,Saint-Cierge-sous-le-Cheylard,217,1030,4640,5670,26.1
7233,Saint-Étienne-de-Serre,217,4601,724,5325,24.5
8380,Saint-Fergeux,217,0,4150,4150,19.1
12072,Comprégnac,217,0,2243,2243,10.3
14282,Foulognes,217,0,1502,1502,6.9
14283,Fourches,217,0,3399,3399,15.7
15033,Cézens,217,5800,4800,10600,48.8
15223,Sauvat,217,6710,1110,7820,36
16029,Bardenac,217,2820,10204,13024,60
17095,Chatenet,217,0,2562,2562,11.8
18182,Poisieux,217,1180,2944,4124,19
21426,Montberthault,217,0,4608,4608,21.2
22069,Guenroc,217,0,5781,5781,26.6
23134,Le Monteil-au-Vicomte,217,0,6804,6804,31.4
24066,Brouchaud,217,0,2728,2728,12.6
27176,Coudray,217,1050,177,1227,5.7
31189,Forgues,217,0,7599,7599,35
33131,Coirac,217,0,2155,2155,9.9
33277,Massugas,217,0,1638,1638,7.5
34049,Camplong,217,0,2020,2020,9.3
37246,Sennevières,217,1460,3767,5227,24.1
39053,Bief-du-Fourg,217,19883,2197,22080,101.8
39102,Chancia,217,780,6315,7095,32.7
39206,Écleux,217,500,2101,2601,12
39403,Pagnoz,217,3200,2101,5301,24.4
42007,Arcinges,217,0,5630,5630,25.9
43023,Beaune-sur-Arzon,217,4399,9029,13428,61.9
48097,Moissac-Vallée-Française,217,3830,11819,15649,72.1
51253,Florent-en-Argonne,217,0,3222,3222,14.8
51455,Reims-la-Brûlée,217,0,1273,1273,5.9
52494,Treix,217,0,23836,23836,109.8
52541,Vitry-lès-Nogent,217,0,23836,23836,109.8
60227,Évricourt,217,1215,1897,3112,14.3
60248,Fouilloy,217,0,1065,1065,4.9
60275,Glatigny,217,0,1065,1065,4.9
60279,Gondreville,217,0,850,850,3.9
61020,Avoine,217,0,458,458,2.1
61242,Le Mage,217,3370,924,4294,19.8
62337,Flers,217,0,4688,4688,21.6
64167,Carrère,217,0,3398,3398,15.7
64539,Uhart-Mixe,217,0,5639,5639,26
70268,Gézier-et-Fontenelay,217,0,147,147,0.7
70485,Selles,217,0,1379,1379,6.4
71395,Saint-Bonnet-de-Vieille-Vigne,217,0,841,841,3.9
76530,Robertot,217,0,478,478,2.2
76745,Villy-sur-Yères,217,2325,1373,3698,17
80068,Beaumetz,217,0,846,846,3.9
80154,Bussu,217,0,1555,1555,7.2
80208,Conteville,217,0,846,846,3.9
80558,Monsures,217,0,300,300,1.4
80698,Saint-Aubin-Montenoy,217,0,300,300,1.4
86134,Linazay,217,0,4887,4887,22.5
2493,Monceau-le-Waast,216,0,1088,1088,5
8479,Villers-le-Tourneur,216,0,4738,4738,21.9
9062,Bordes-Uchentein,216,0,26175,26175,121.2
11071,Cascastel-des-Corbières,216,0,2927,2927,13.6
14019,Arganchy,216,0,8325,8325,38.5
15072,Freix-Anglards,216,0,3576,3576,16.6
17039,Belluire,216,0,2550,2550,11.8
18114,Ineuil,216,0,579,579,2.7
21109,Brion-sur-Ource,216,0,3604,3604,16.7
21306,Grenant-lès-Sombernon,216,0,1215,1215,5.6
26025,Barnave,216,885,12009,12894,59.7
27327,Hectomare,216,0,929,929,4.3
28019,Baigneaux,216,0,1134,1134,5.2
2B239,Poggio-d'Oletta,216,0,1306,1306,6
32379,Saint-Germier,216,0,815,815,3.8
33510,Semens,216,0,2209,2209,10.2
34257,Saint-Geniès-de-Varensal,216,0,2011,2011,9.3
34342,Viols-en-Laval,216,0,4025,4025,18.6
37146,Marcilly-sur-Maulne,216,0,2004,2004,9.3
39105,Chapois,216,1565,2187,3752,17.4
41168,Orçay,216,1915,1841,3756,17.4
45013,Augerville-la-Rivière,216,0,1637,1637,7.6
47082,Dondas,216,0,4945,4945,22.9
48004,Altier,216,0,4377,4377,20.3
50096,Canteloup,216,862,6794,7656,35.4
55110,Chauvency-Saint-Hubert,216,0,7722,7722,35.8
57008,Adelange,216,0,10023,10023,46.4
57029,Arriance,216,0,10023,10023,46.4
57536,Petit-Tenquin,216,0,3688,3688,17.1
58248,Saint-Laurent-l'Abbaye,216,0,4306,4306,19.9
60192,Cuy,216,0,1888,1888,8.7
60673,Viefvillers,216,0,4871,4871,22.6
62072,Bailleulmont,216,0,1795,1795,8.3
62816,Tilloy-lès-Hermaville,216,0,1795,1795,8.3
63015,Aubusson-d'Auvergne,216,0,5008,5008,23.2
63293,Le Quartier,216,0,335,335,1.6
66098,La Llagonne,216,0,0,0,0
66116,Montferrer,216,0,0,0,0
70002,Aboncourt-Gesincourt,216,0,654,654,3
70512,La Vaivre,216,0,1373,1373,6.4
71272,Malay,216,0,2617,2617,12.1
73083,Les Chavannes-en-Maurienne,216,0,30946,30946,143.3
73091,Conjux,216,0,1195,1195,5.5
76405,Manéhouville,216,0,1743,1743,8.1
76733,Ventes-Saint-Rémy,216,0,5046,5046,23.4
78478,Paray-Douaville,216,0,421,421,1.9
80560,Montauban-de-Picardie,216,0,242,242,1.1
81187,Moulayrès,216,0,3231,3231,15
88105,Claudon,216,0,1679,1679,7.8
88293,Maxey-sur-Meuse,216,0,2413,2413,11.2
1150,Drom,215,0,4156,4156,19.3
1437,Vescours,215,0,4156,4156,19.3
2528,Mortefontaine,215,0,207,207,1
2782,Le Verguier,215,0,1948,1948,9.1
7224,Saint-Cirgues-en-Montagne,215,0,1681,1681,7.8
8011,Anchamps,215,0,1380,1380,6.4
9276,Saint-Victor-Rouzaud,215,0,968,968,4.5
10145,Faux-Villecerf,215,0,0,0,0
15225,Ségur-les-Villas,215,0,48,48,0.2
18228,Saint-Outrille,215,2880,3106,5986,27.8
18284,Villegenon,215,0,3873,3873,18
19067,Curemonte,215,0,1084,1084,5
21630,Thoisy-le-Désert,215,0,3268,3268,15.2
21673,Veuvey-sur-Ouche,215,0,3268,3268,15.2
22124,Lescouët-Gouarec,215,0,19799,19799,92.1
24381,Saint-Barthélemy-de-Bussière,215,1450,1441,2891,13.4
24531,Sergeac,215,1040,2985,4025,18.7
27376,Louye,215,0,288,288,1.3
28212,Loigny-la-Bataille,215,0,1129,1129,5.3
28243,Mérouville,215,0,1129,1129,5.3
30304,Salazac,215,0,3137,3137,14.6
31534,Saussens,215,0,1049,1049,4.9
32018,Aurimont,215,0,2731,2731,12.7
32130,Faget-Abbatial,215,0,2537,2537,11.8
32224,Maignaut-Tauzia,215,0,827,827,3.8
34026,Beaufort,215,0,814,814,3.8
39076,La Bretenière,215,3985,3393,7378,34.3
39166,Cornod,215,2494,6257,8751,40.7
39313,Marigny,215,1272,2177,3449,16
40106,Garrey,215,0,3367,3367,15.7
42229,Saint-Germain-la-Montagne,215,0,5578,5578,25.9
47030,Blaymont,215,0,4922,4922,22.9
51632,Villers-en-Argonne,215,0,3192,3192,14.8
54034,Avrainville,215,0,449,449,2.1
54326,Lubey,215,0,1996,1996,9.3
55456,Saint-Germain-sur-Meuse,215,0,868,868,4
57318,Hermelange,215,0,1400,1400,6.5
60097,Boutencourt,215,0,4721,4721,22
62109,Bergueneuse,215,0,4645,4645,21.6
62346,Fortel-en-Artois,215,0,4645,4645,21.6
62416,Hautecloque,215,0,4645,4645,21.6
62641,Ostreville,215,0,4645,4645,21.6
62683,Quœux-Haut-Maînil,215,0,4645,4645,21.6
62879,Warluzel,215,0,1787,1787,8.3
64003,Abidos,215,0,5789,5789,26.9
65142,Chelle-Debat,215,0,1365,1365,6.3
70147,Chavanne,215,0,1404,1404,6.5
70278,Grattery,215,0,1277,1277,5.9
70340,Membrey,215,0,1104,1104,5.1
72353,Théligny,215,0,1312,1312,6.1
80099,Bettencourt-Rivière,215,0,656,656,3.1
80299,La Faloise,215,0,1321,1321,6.1
81216,Puycalvel,215,0,3216,3216,15
83013,La Bastide,215,0,2678,2678,12.5
1356,Saint-Georges-sur-Renon,214,0,45,45,0.2
3076,Chézy,214,0,2881,2881,13.5
9016,Arnave,214,0,826,826,3.9
9071,Cadarcet,214,0,25932,25932,121.2
10188,Lantages,214,0,3984,3984,18.6
10202,Les Loges-Margueron,214,0,3984,3984,18.6
11357,Saint-Martin-le-Vieil,214,0,1388,1388,6.5
12088,Curières,214,0,7251,7251,33.9
14205,Cristot,214,0,2624,2624,12.3
16254,Palluaud,214,5740,10063,15803,73.8
17087,Chantemerle-sur-la-Soie,214,0,5961,5961,27.9
17379,Saint-Palais-de-Phiolin,214,0,2527,2527,11.8
17381,Saint-Pardoult,214,0,5961,5961,27.9
17433,Sousmoulins,214,0,2527,2527,11.8
19054,Chenailler-Mascheix,214,0,1079,1079,5
21125,Cérilly,214,0,3570,3570,16.7
21387,Marigny-lès-Reullée,214,0,931,931,4.4
25162,Corcelles-Ferrières,214,0,145,145,0.7
26239,Plaisians,214,0,10996,10996,51.4
26335,Salles-sous-Bois,214,0,5761,5761,26.9
27552,Saint-Jean-du-Thenney,214,0,923,923,4.3
28076,La Chapelle-Forainvilliers,214,0,286,286,1.3
30017,Arrigas,214,0,3452,3452,16.1
32156,Idrac-Respaillès,214,0,474,474,2.2
32175,Ladevèze-Ville,214,0,3945,3945,18.4
38289,Oz,214,0,12172,12172,56.9
39356,Montigny-sur-l'Ain,214,1563,2167,3730,17.4
39465,Romange,214,2440,4343,6783,31.7
39492,Saint-Maur,214,1630,6228,7858,36.7
40005,Arboucave,214,0,4944,4944,23.1
43121,Léotoing,214,2100,10488,12588,58.8
45114,Courtempierre,214,0,2099,2099,9.8
46008,Les Arques,214,0,6052,6052,28.3
47294,Savignac-de-Duras,214,0,10542,10542,49.3
50269,Liesville-sur-Douve,214,0,1160,1160,5.4
51640,Ville-sur-Tourbe,214,0,3178,3178,14.9
54126,Chenicourt,214,0,1266,1266,5.9
56086,Île-d'Houat,214,0,8281,8281,38.7
58005,Amazy,214,0,3328,3328,15.6
60391,Maysel,214,0,2201,2201,10.3
60630,Thibivillers,214,300,4699,4999,23.4
61301,Neauphe-sous-Essai,214,590,1343,1933,9
62076,Bainghen,214,0,1310,1310,6.1
62668,Prédefin,214,0,4623,4623,21.6
62761,Saint-Martin-sur-Cojeul,214,0,6019,6019,28.1
63140,Durmignat,214,0,332,332,1.6
63355,Saint-Gervais-sous-Meymont,214,1199,1934,3133,14.6
65294,Lutilhous,214,0,639,639,3
72274,Saint-Christophe-en-Champagne,214,0,1945,1945,9.1
77133,Courcelles-en-Bassée,214,0,151,151,0.7
80133,Brailly-Cornehotte,214,0,5299,5299,24.8
80596,Neuvillette,214,0,834,834,3.9
82095,Lavaurette,214,0,6327,6327,29.6
82154,Saint-Amans-de-Pellagal,214,0,6700,6700,31.3
83010,Bargème,214,0,2666,2666,12.5
87172,Saint-Ouen-sur-Gartempe,214,2985,3642,6627,31
88083,Certilleux,214,0,2391,2391,11.2
89117,Coulangeron,214,650,9663,10313,48.2
90086,Romagny-sous-Rougemont,214,1470,6374,7844,36.7
2407,Laniscourt,213,0,8134,8134,38.2
2473,Mayot,213,0,3827,3827,18
2645,Reuilly-Sauvigny,213,0,4923,4923,23.1
3256,Saint-Priest-en-Murat,213,0,7609,7609,35.7
5116,Réotier,213,0,6925,6925,32.5
7273,Saint-Maurice-d'Ibie,213,556,6607,7163,33.6
8225,Herpy-l'Arlésienne,213,0,4073,4073,19.1
10109,Courtenot,213,0,3718,3718,17.5
10157,La Fosse-Corduan,213,0,0,0,0
10347,Saint-Loup-de-Buffigny,213,0,0,0,0
12163,Murasson,213,0,8334,8334,39.1
17427,Siecq,213,0,5933,5933,27.9
23232,Saint-Pierre-Bellevue,213,0,6679,6679,31.4
27508,Saint-Antonin-de-Sommaire,213,0,5990,5990,28.1
30143,Laval-Saint-Roman,213,0,3108,3108,14.6
31352,Mondouzil,213,0,5207,5207,24.4
31519,Saint-Vincent,213,0,1039,1039,4.9
31538,Savères,213,0,7459,7459,35
32150,Goutz,213,0,121,121,0.6
32173,Labrihe,213,0,804,804,3.8
32194,Larressingle,213,0,819,819,3.8
36014,Bazaiges,213,0,1564,1564,7.3
37080,Civray-sur-Esves,213,410,3697,4107,19.3
42339,Chausseterre,213,3281,3996,7277,34.2
45323,Thou,213,0,2479,2479,11.6
46203,Montet-et-Bouxal,213,0,6290,6290,29.5
47207,Pompiey,213,0,1033,1033,4.8
47229,Saint-Astier,213,0,10493,10493,49.3
50072,Brainville,213,0,6163,6163,28.9
54259,Herbéviller,213,0,756,756,3.5
57063,Bérig-Vintrange,213,0,3637,3637,17.1
57246,Gelucourt,213,0,705,705,3.3
57335,Honskirch,213,0,705,705,3.3
57367,Klang,213,0,1365,1365,6.4
61510,Vitrai-sous-Laigle,213,3300,2196,5496,25.8
62106,Bellonne,213,0,265,265,1.2
62368,Gaudiempré,213,0,1770,1770,8.3
63115,Combrailles,213,0,7203,7203,33.8
64083,Autevielle-Saint-Martin-Bideren,213,0,4452,4452,20.9
64180,Castetpugon,213,0,3335,3335,15.7
72074,Chemiré-en-Charnie,213,0,1935,1935,9.1
77068,Cessoy-en-Montois,213,0,3016,3016,14.2
79108,Doux,213,0,5584,5584,26.2
81006,Algans,213,0,237,237,1.1
86051,Champagné-le-Sec,213,0,4797,4797,22.5
2205,Colligis-Crandelain,212,0,8096,8096,38.2
2443,Lucy-le-Bocage,212,0,115,115,0.5
4102,Le Lauzet-Ubaye,212,6350,63313,69663,328.6
9076,Canté,212,0,954,954,4.5
10228,Mathaux,212,0,4476,4476,21.1
12186,Pousthomy,212,0,8295,8295,39.1
14064,Bernières-d'Ailly,212,0,3321,3321,15.7
14669,Sassy,212,0,3321,3321,15.7
14716,Trungy,212,0,1468,1468,6.9
16310,Saint-Coutant,212,1690,4362,6052,28.5
17282,Pommiers-Moulons,212,0,2503,2503,11.8
21637,Tichey,212,0,1590,1590,7.5
22289,Saint-Fiacre,212,0,4293,4293,20.2
24083,Carsac-de-Gurson,212,3392,739,4131,19.5
24508,Saint-Victor,212,605,1610,2215,10.4
28153,Flacey,212,0,390,390,1.8
30005,Aiguèze,212,0,3094,3094,14.6
30297,Saint-Sauveur-Camprieu,212,0,10605,10605,50
32038,Beaupuy,212,0,15081,15081,71.1
32073,Campagne-d'Armagnac,212,0,0,0,0
33117,Cazaugitat,212,0,2105,2105,9.9
33453,Saint-Michel-de-Lapujade,212,0,1726,1726,8.1
39273,Montlainsia,212,2660,6170,8830,41.7
43044,Cerzat,212,429,1930,2359,11.1
51008,Ambrières,212,0,1920,1920,9.1
51534,Serzy-et-Prin,212,0,3768,3768,17.8
52271,Lanques-sur-Rognon,212,0,23287,23287,109.8
53199,Saint-Aubin-Fosse-Louvain,212,0,2795,2795,13.2
54396,Neufmaisons,212,0,752,752,3.5
55200,Fromeréville-les-Vallons,212,0,13140,13140,62
55570,Villotte-sur-Aire,212,0,2870,2870,13.5
60168,Courcelles-Epayelles,212,0,1175,1175,5.5
61123,Coulonces,212,0,448,448,2.1
62027,Ambrines,212,0,1762,1762,8.3
62665,Le Ponchel,212,0,4580,4580,21.6
65324,Moulédous,212,0,1346,1346,6.3
70169,Confracourt,212,0,545,545,2.6
72313,Saint-Pierre-des-Ormes,212,0,3931,3931,18.5
76058,Baromesnil,212,0,610,610,2.9
80095,Bertrancourt,212,0,237,237,1.1
80475,Liéramont,212,0,1519,1519,7.2
80734,Sentelie,212,0,293,293,1.4
88145,Domfaing,212,0,278,278,1.3
89402,Soumaintrain,212,935,1370,2305,10.9
91613,Congerville-Thionville,212,0,534,534,2.5
2016,Andelain,211,0,3791,3791,18
2708,Sequehart,211,0,1912,1912,9.1
2749,Troësnes,211,0,203,203,1
3278,Taxat-Senat,211,0,4316,4316,20.5
4130,Montlaux,211,0,4285,4285,20.3
7212,Saint-André-en-Vivarais,211,0,4511,4511,21.4
8489,Voncq,211,0,4628,4628,21.9
10004,Allibaudières,211,0,180,180,0.9
14007,Amayé-sur-Seulles,211,0,7824,7824,37.1
14063,Bernesq,211,0,1461,1461,6.9
14435,Les Monceaux,211,0,2349,2349,11.1
22036,La Chapelle-Blanche,211,0,5621,5621,26.6
23201,Saint-Hilaire-la-Plaine,211,0,6616,6616,31.4
23227,Saint-Pardoux-Morterolles,211,0,6616,6616,31.4
25458,Les Plains-et-Grands-Essarts,211,0,1470,1470,7
26059,Bouvante,211,0,13215,13215,62.6
26112,Curnier,211,0,10842,10842,51.4
27134,Cauverville-en-Roumois,211,0,864,864,4.1
31170,Escanecrabe,211,0,4371,4371,20.7
31363,Montbernard,211,0,4371,4371,20.7
33044,Bellefond,211,0,2095,2095,9.9
33127,Civrac-sur-Dordogne,211,0,1472,1472,7
33271,Marions,211,0,70,70,0.3
34233,Roqueredonde,211,0,2370,2370,11.2
34264,Saint-Jean-de-Buèges,211,0,3931,3931,18.6
36179,Saint-Aoustrille,211,0,4286,4286,20.3
38073,Chantepérier,211,1900,2209,4109,19.5
39079,Briod,211,1100,6650,7750,36.7
39296,Lombard,211,3267,5608,8875,42.1
41037,La Chapelle-Enchérie,211,0,1072,1072,5.1
48169,Saint-Léger-du-Malzieu,211,0,2167,2167,10.3
50461,Saint-Cyr,211,0,6637,6637,31.5
52347,Narcy,211,0,1911,1911,9.1
54088,Bouvron,211,0,440,440,2.1
54545,Vandeléville,211,0,6996,6996,33.2
57687,Vallerange,211,0,3603,3603,17.1
58192,Neuville-lès-Decize,211,0,1410,1410,6.7
60461,Nivillers,211,0,8274,8274,39.2
60497,Le Plessier-sur-Bulles,211,0,1169,1169,5.5
60556,Royaucourt,211,0,1169,1169,5.5
61419,Sainte-Marguerite-de-Carrouges,211,0,949,949,4.5
64071,Athos-Aspis,211,0,4411,4411,20.9
64154,Bussunarits-Sarrasquette,211,0,5483,5483,26
64309,Lamayou,211,2555,4766,7321,34.7
64334,Léren,211,0,4411,4411,20.9
68086,Falkwiller,211,3210,3005,6215,29.5
68274,Rimbach-près-Guebwiller,211,1400,5207,6607,31.3
70438,Ray-sur-Saône,211,0,1083,1083,5.1
79177,Messé,211,495,6094,6589,31.2
80337,Fouencamps,211,0,1296,1296,6.1
80354,Fresnes-Tilloloy,211,0,291,291,1.4
80541,Mesnil-Saint-Georges,211,0,255,255,1.2
81022,Bannières,211,0,689,689,3.3
88434,Saint-Remimont,211,0,74,74,0.4
2176,Chavonne,210,0,414,414,2
2804,Villemontoire,210,0,701,701,3.3
8275,Margny,210,0,7435,7435,35.4
9150,Lagarde,210,0,4350,4350,20.7
12235,Saint-Just-sur-Viaur,210,0,6427,6427,30.6
16241,Nanclars,210,1950,2640,4590,21.9
19179,Saillac,210,0,1059,1059,5
21195,Cormot-Vauchignon,210,0,913,913,4.3
21266,Flacey,210,0,5,5,0
21674,Veuxhaulles-sur-Aube,210,0,3504,3504,16.7
27071,Le Bois-Hellain,210,0,3234,3234,15.4
28008,Ardelles,210,0,281,281,1.3
29126,Loc-Brévalaire,210,0,1644,1644,7.8
2B238,Poggio-di-Venaco,210,0,3628,3628,17.3
39200,Dompierre-sur-Mont,210,4349,6112,10461,49.8
45330,Trinay,210,0,296,296,1.4
51071,Bouchy-Saint-Genest,210,0,2740,2740,13
51087,Breuvery-sur-Coole,210,0,351,351,1.7
51466,Romigny,210,0,3732,3732,17.8
52307,Marac,210,0,964,964,4.6
56056,Évriguet,210,0,3162,3162,15.1
62216,La Cauchie,210,0,1745,1745,8.3
62591,Morchies,210,0,1044,1044,5
62700,Regnauville,210,0,3325,3325,15.8
64283,Jaxu,210,0,5457,5457,26
64514,Séby,210,0,3288,3288,15.7
65092,Beyrède-Jumet-Camous,210,0,10096,10096,48.1
65231,Izaux,210,0,627,627,3
65279,Lortet,210,0,627,627,3
65329,Nistos,210,0,1374,1374,6.5
70054,Battrans,210,0,1060,1060,5
76242,Ernemont-la-Villette,210,0,3967,3967,18.9
82056,Espinas,210,0,2970,2970,14.1
88015,Attignéville,210,0,2346,2346,11.2
88221,Gruey-lès-Surance,210,0,5281,5281,25.1
88232,Harmonville,210,0,2346,2346,11.2
88399,Le Roulier,210,0,275,275,1.3
3188,Montord,209,0,4275,4275,20.5
5024,Valdoule,209,0,6231,6231,29.8
7130,Lanarce,209,500,1634,2134,10.2
7235,Sainte-Eulalie,209,15000,1634,16634,79.6
9073,Camarade,209,0,3717,3717,17.8
10023,Avon-la-Pèze,209,0,0,0,0
10185,Lagesse,209,0,3891,3891,18.6
14360,Leffard,209,0,3274,3274,15.7
15226,Sénezergues,209,2920,1833,4753,22.7
16142,La Forêt-de-Tessé,209,1500,4575,6075,29.1
19008,Ambrugeat,209,0,2865,2865,13.7
21676,Vic-de-Chassenay,209,0,4438,4438,21.2
23170,Savennes,209,0,3413,3413,16.3
26180,Mérindol-les-Oliviers,209,0,10739,10739,51.4
27471,Porte-de-Seine,209,7800,6198,13998,67
31542,Seilhan,209,0,2001,2001,9.6
39134,Chavéria,209,1410,6083,7493,35.9
39533,Toulouse-le-Château,209,1100,5555,6655,31.8
45011,Attray,209,0,760,760,3.6
46091,Escamps,209,0,1175,1175,5.6
47307,Thézac,209,0,1204,1204,5.8
48072,Grèzes,209,0,4983,4983,23.8
50476,Saint-Germain-d'Elle,209,0,3091,3091,14.8
50504,Saint-Louet-sur-Vire,209,0,3091,3091,14.8
54211,Frémonville,209,0,741,741,3.5
54290,Laix,209,0,1952,1952,9.3
54344,Mangonville,209,0,0,0,0
57493,Mulcey,209,0,692,692,3.3
58120,Gâcogne,209,0,3250,3250,15.6
58219,Préporché,209,0,10781,10781,51.6
60530,Rémérangles,209,0,8196,8196,39.2
67383,Rangen,209,510,11351,11861,56.8
70469,Sainte-Marie-en-Chanois,209,0,201,201,1
71424,Saint-Gervais-sur-Couches,209,0,4676,4676,22.4
76440,Molagnies,209,0,3948,3948,18.9
79141,Irais,209,0,5345,5345,25.6
80682,Rouvroy-en-Santerre,209,0,3783,3783,18.1
88005,Allarmont,209,0,2032,2032,9.7
89485,Voutenay-sur-Cure,209,468,453,921,4.4
2505,Montfaucon,208,0,113,113,0.5
4150,Piégut,208,8960,1855,10815,52
4218,Thorame-Basse,208,9950,7355,17305,83.2
8041,Baâlons,208,0,4562,4562,21.9
8404,Sault-Saint-Remy,208,0,3978,3978,19.1
9328,Verdun,208,5000,29955,34955,168.1
10316,Rhèges,208,0,214,214,1
11275,Payra-sur-l'Hers,208,0,1828,1828,8.8
15070,Fontanges,208,2600,3444,6044,29.1
16044,Bioussac,208,0,4553,4553,21.9
16250,Orgedeuil,208,3778,3709,7487,36
19034,Camps-Saint-Mathurin-Léobazel,208,0,617,617,3
21050,Baubigny,208,0,904,904,4.3
24334,Pontours,208,2816,756,3572,17.2
27366,Letteguives,208,0,1369,1369,6.6
27531,Saint-Denis-des-Monts,208,0,852,852,4.1
2A359,Zicavo,208,0,156,156,0.8
32346,Roquebrune,208,0,1513,1513,7.3
34132,Lauroux,208,0,2336,2336,11.2
36073,Feusines,208,0,4569,4569,22
42035,Cezay,208,0,1864,1864,9
42158,Les Noës,208,0,6138,6138,29.5
42194,Sail-les-Bains,208,0,6138,6138,29.5
45059,Bucy-Saint-Liphard,208,0,293,293,1.4
46239,Le Roc,208,0,6786,6786,32.6
47124,Lacaussade,208,0,5311,5311,25.5
50336,Montaigu-les-Bois,208,0,6018,6018,28.9
50422,Raids,208,0,4346,4346,20.9
51137,Châtillon-sur-Morin,208,0,2714,2714,13
51175,Corrobert,208,0,6683,6683,32.1
51310,Jouy-lès-Reims,208,0,3697,3697,17.8
51359,Mécringes,208,0,6683,6683,32.1
52134,Cohons,208,0,2576,2576,12.4
52547,Vouécourt,208,0,22847,22847,109.8
55583,Woël,208,0,2693,2693,12.9
59503,Robersart,208,0,587,587,2.8
60460,La Neuville-Vault,208,0,1020,1020,4.9
61036,Belfonds,208,2640,1305,3945,19
62726,Ruisseauville,208,0,12309,12309,59.2
64346,Lombia,208,0,2171,2171,10.4
65093,Bize,208,0,1361,1361,6.5
66078,Fillols,208,0,6230,6230,30
70289,Igny,208,0,1050,1050,5
71082,Champlecy,208,0,806,806,3.9
71124,Chenôves,208,0,3190,3190,15.3
80758,Thory,208,0,1278,1278,6.1
88332,Norroy,208,0,73,73,0.4
88380,Rehaupal,208,0,350,350,1.7
95012,Amenucourt,208,0,1315,1315,6.3
1200,Labalme,207,0,2966,2966,14.3
2099,Bonnesvalyn,207,0,4785,4785,23.1
2294,Étouvelles,207,0,7905,7905,38.2
2704,Selens,207,0,205,205,1
2727,Sons-et-Ronchères,207,0,1043,1043,5
5090,La Motte-en-Champsaur,207,0,13772,13772,66.5
7025,Barnas,207,0,851,851,4.1
11078,Castelreng,207,0,2725,2725,13.2
11378,Serviès-en-Val,207,0,1343,1343,6.5
14054,Beaumesnil,207,0,95,95,0.5
19012,Astaillac,207,0,1044,1044,5
21258,Étrochey,207,0,3454,3454,16.7
21518,Quincy-le-Vicomte,207,0,4032,4032,19.5
21640,Torcy-et-Pouligny,207,0,4395,4395,21.2
23109,Linard-Malval,207,0,557,557,2.7
24415,Saint-Géraud-de-Corps,207,5223,721,5944,28.7
25189,Dammartin-les-Templiers,207,0,10318,10318,49.8
25465,Pont-les-Moulins,207,0,10318,10318,49.8
27048,Beauficel-en-Lyons,207,0,1362,1362,6.6
27137,Chaise-Dieu-du-Theil,207,300,5822,6122,29.6
27488,Renneville,207,0,1362,1362,6.6
28237,Marolles-les-Buis,207,0,147,147,0.7
2A118,Fozzano,207,0,0,0,0
31140,Chein-Dessus,207,0,11125,11125,53.7
31329,Maurens,207,0,4208,4208,20.3
32322,Pompiac,207,0,1292,1292,6.2
39318,Martigna,207,300,6024,6324,30.6
41089,La Fontenelle,207,0,1051,1051,5.1
46013,Bach,207,0,1164,1164,5.6
47014,Armillac,207,0,3855,3855,18.6
48086,Luc,207,1300,1854,3154,15.2
50397,Perriers-en-Beauficel,207,0,5093,5093,24.6
51177,Coulommes-la-Montagne,207,0,3679,3679,17.8
52394,Poinson-lès-Fayl,207,0,4082,4082,19.7
54173,Drouville,207,0,3104,3104,15
55359,Morley,207,0,4046,4046,19.5
57149,Colmen,207,0,2980,2980,14.4
57374,Lafrimbolle,207,0,1348,1348,6.5
60113,Bucamps,207,0,4668,4668,22.6
61505,Villedieu-lès-Bailleul,207,0,437,437,2.1
62441,Hermin,207,0,3416,3416,16.5
62468,Humières,207,0,4472,4472,21.6
64015,Alçay-Alçabéhéty-Sunharette,207,0,5379,5379,26
64103,Bédeille,207,0,2161,2161,10.4
64378,Menditte,207,0,5379,5379,26
65051,Aventignan,207,0,1354,1354,6.5
65270,Lespouey,207,0,1314,1314,6.3
70063,Belonchamp,207,0,2381,2381,11.5
70542,Venère,207,0,1045,1045,5
71531,La Tagnière,207,0,4631,4631,22.4
71562,Vaudebarrier,207,0,803,803,3.9
72202,Monhoudou,207,0,3839,3839,18.5
76190,Crasville-la-Rocquefort,207,0,1341,1341,6.5
80215,Coulonvillers,207,0,5126,5126,24.8
80607,Oissy,207,0,286,286,1.4
81197,Noailles,207,0,5267,5267,25.4
82082,Lacapelle-Livron,207,0,2927,2927,14.1
84114,Saint-Pantaléon,207,0,4219,4219,20.4
88022,Auzainvilliers,207,0,73,73,0.4
88133,Dignonville,207,0,5205,5205,25.1
88263,Laveline-du-Houx,207,0,271,271,1.3
2067,Bergues-sur-Sambre,206,0,3673,3673,17.8
3136,Lamaids,206,0,4849,4849,23.5
3150,Louroux-Bourbonnais,206,0,3164,3164,15.4
9067,Brie,206,0,927,927,4.5
9308,Taurignan-Vieux,206,0,24963,24963,121.2
14168,Colombières,206,0,1426,1426,6.9
18088,Ennordres,206,0,0,0,0
18119,Jussy-Champagne,206,0,949,949,4.6
21142,Chanceaux,206,0,0,0,0
21268,Flagey-lès-Auxonne,206,0,0,0,0
21455,Nod-sur-Seine,206,0,3437,3437,16.7
23053,Chard,206,0,2704,2704,13.1
25485,Rémondans-Vaivre,206,0,13041,13041,63.3
25562,Thulay,206,0,13041,13041,63.3
27345,La Houssaye,206,0,888,888,4.3
27444,Le Noyer-en-Ouche,206,0,888,888,4.3
27460,Plainville,206,0,888,888,4.3
27527,Saint-Cyr-de-Salerne,206,0,888,888,4.3
2B352,Ville-di-Paraso,206,0,2891,2891,14
32128,Estipouy,206,0,3123,3123,15.2
32212,Ligardes,206,0,792,792,3.8
32302,Ornézan,206,0,2431,2431,11.8
39229,Fontainebrux,206,1005,5475,6480,31.5
47148,Leyritz-Moncassin,206,0,3476,3476,16.9
50513,Saint-Martin-de-Cenilly,206,0,5960,5960,28.9
51258,La Forestière,206,0,2688,2688,13
51392,Mutigny,206,0,509,509,2.5
54262,Hoéville,206,0,3089,3089,15
55507,Thillot,206,0,2667,2667,12.9
60066,Béthancourt-en-Valois,206,0,807,807,3.9
60422,Montlognon,206,0,0,0,0
61195,Le Grais,206,3470,5517,8987,43.6
62798,Sombrin,206,0,1712,1712,8.3
64360,Lurbe-Saint-Christau,206,0,4436,4436,21.5
65352,Ouzous,206,0,8435,8435,40.9
70192,Cugney,206,0,139,139,0.7
71100,Chardonnay,206,0,4794,4794,23.3
81023,Barre,206,0,3644,3644,17.7
82181,Sistels,206,0,22133,22133,107.4
87162,Sainte-Marie-de-Vaux,206,449,91,540,2.6
89233,Lucy-sur-Cure,206,500,28,528,2.6
95303,Le Heaulme,206,0,9465,9465,45.9
17405,Saint-Sorlin-de-Conac,205,0,2421,2421,11.8
21440,Montot,205,0,1537,1537,7.5
23006,Arrènes,205,0,1135,1135,5.5
24022,Badefols-sur-Dordogne,205,2200,745,2945,14.4
24525,Savignac-de-Nontron,205,0,1374,1374,6.7
25086,Braillans,205,300,3612,3912,19.1
26321,Saint-Nazaire-le-Désert,205,17075,11398,28473,138.9
31266,Lahage,205,0,7179,7179,35
31482,Saint-Frajou,205,0,4246,4246,20.7
32060,Boucagnères,205,0,2419,2419,11.8
35346,Trimer,205,0,2566,2566,12.5
36133,Mouhers,205,0,601,601,2.9
39540,Valempoulières,205,1000,2076,3076,15
40050,Bostens,205,0,2537,2537,12.4
40052,Bourdalat,205,0,1958,1958,9.6
41012,Baillou,205,616,6123,6739,32.9
45266,Ruan,205,430,289,719,3.5
46162,Lauzès,205,0,1186,1186,5.8
46279,Saint-Maurice-en-Quercy,205,0,6054,6054,29.5
48135,Saint-André-Capcèze,205,0,4154,4154,20.3
50472,Saint-Georges-de-Livoye,205,0,5044,5044,24.6
55416,Rarécourt,205,0,2143,2143,10.5
56225,Saint-Léry,205,0,3087,3087,15.1
57586,Rochonvillers,205,0,2155,2155,10.5
59169,Damousies,205,0,1624,1624,7.9
60184,Croutoy,205,0,1389,1389,6.8
60518,Puits-la-Vallée,205,0,4623,4623,22.6
61170,Fleuré,205,0,433,433,2.1
62517,Linghem,205,0,3383,3383,16.5
63095,Charnat,205,0,4753,4753,23.2
63320,Saint-Avit,205,0,6932,6932,33.8
63324,Saint-Bonnet-le-Chastel,205,6290,1852,8142,39.7
63346,Saint-Genès-Champespe,205,0,1497,1497,7.3
66223,Villefranche-de-Conflent,205,0,6140,6140,30
67380,Printzheim,205,65,14459,14524,70.8
69186,Saint-Clément-de-Vers,205,11500,0,11500,56.1
70399,Ormoy,205,0,621,621,3
76403,Malleville-les-Grès,205,0,1328,1328,6.5
80132,Braches,205,0,1259,1259,6.1
80388,Grébault-Mesnil,205,0,1363,1363,6.6
85087,Faymoreau,205,0,3213,3213,15.7
86218,Saint-Clair,205,0,1047,1047,5.1
89308,Pont-sur-Vanne,205,2840,397,3237,15.8
2460,Marcy-sous-Marle,204,0,1028,1028,5
2763,Vasseny,204,0,402,402,2
5130,Saint-Apollinaire,204,0,16302,16302,79.9
6116,Saint-Auban,204,0,5208,5208,25.5
10417,Villemoiron-en-Othe,204,0,3559,3559,17.4
12289,Valzergues,204,0,3504,3504,17.2
14380,Loucelles,204,0,2501,2501,12.3
15111,Madic,204,5276,1044,6320,31
17254,Nachamps,204,0,5682,5682,27.9
18041,La Celette,204,0,547,547,2.7
21651,Val-Suzon,204,0,0,0,0
24529,Segonzac,204,150,1549,1699,8.3
25226,Étrappe,204,0,471,471,2.3
26292,Saint-Auban-sur-l'Ouvèze,204,0,10482,10482,51.4
28126,Dancy,204,0,375,375,1.8
30031,La Bastide-d'Engras,204,0,1568,1568,7.7
32395,Sainte-Mère,204,0,116,116,0.6
37064,Chaumussay,204,275,3541,3816,18.7
39420,Pimorin,204,0,5937,5937,29.1
46022,Bélaye,204,0,7417,7417,36.4
46256,Saint-Cirq-Lapopie,204,0,1722,1722,8.4
50299,Le Mesnil,204,1262,6417,7679,37.6
55114,Chonville-Malaumont,204,0,823,823,4
55546,Verneuil-Grand,204,0,7293,7293,35.8
57395,Lesse,204,0,675,675,3.3
57705,Velving,204,0,1229,1229,6
61395,Saint-Germain-des-Grois,204,1270,2391,3661,17.9
62542,Maizières,204,0,1695,1695,8.3
67159,Gœrlingen,204,763,2557,3320,16.3
67232,Keffenach,204,0,5621,5621,27.6
70541,Velorcey,204,0,755,755,3.7
70546,Vereux,204,0,1047,1047,5.1
71208,Frontenard,204,0,25,25,0.1
71549,La Truchère,204,0,4747,4747,23.3
76338,La Hallotière,204,0,3854,3854,18.9
80317,Fleury,204,0,282,282,1.4
86201,Prinçay,204,0,1042,1042,5.1
86205,Ranton,204,0,1042,1042,5.1
87204,Videix,204,0,4461,4461,21.9
2027,Assis-sur-Serre,203,0,1023,1023,5
2802,La Ville-aux-Bois-lès-Dizy,203,0,2237,2237,11
7215,Saint-Barthélemy-le-Meil,203,0,4340,4340,21.4
7318,Tauriers,203,1087,3198,4285,21.1
10386,Trouans,203,0,173,173,0.9
10418,Villemorien,203,0,3544,3544,17.5
10427,Ville-sur-Arce,203,0,3544,3544,17.5
11362,Saint-Paulet,203,5130,1784,6914,34.1
14104,Le Brévedent,203,0,3263,3263,16.1
14165,Colleville-sur-Mer,203,0,1405,1405,6.9
14509,Plumetot,203,0,1367,1367,6.7
15010,Arches,203,12390,3839,16229,79.9
17031,Ballans,203,0,5654,5654,27.9
17054,Boresse-et-Martron,203,0,2397,2397,11.8
17471,La Villedieu,203,0,5654,5654,27.9
18010,Ardenais,203,1045,544,1589,7.8
18084,Dampierre-en-Crot,203,0,3657,3657,18
18193,Rezay,203,0,544,544,2.7
19149,Neuville,203,0,602,602,3
21007,Aisy-sous-Thil,203,0,4311,4311,21.2
21043,Baigneux-les-Juifs,203,0,3387,3387,16.7
21254,L'Étang-Vergy,203,0,973,973,4.8
21345,Léry,203,0,0,0,0
21567,Saint-Prix-lès-Arnay,203,0,6261,6261,30.8
23188,Saint-Dizier-les-Domaines,203,0,546,546,2.7
24456,Saint-Martin-des-Combes,203,1679,9721,11400,56.2
25311,Hyémondans,203,0,468,468,2.3
28313,Réclainville,203,0,1066,1066,5.3
2A026,Azilone-Ampaza,203,0,152,152,0.7
31061,Bellegarde-Sainte-Marie,203,0,1698,1698,8.4
31327,Mauran,203,0,7109,7109,35
32102,Cézan,203,0,115,115,0.6
32109,Couloumé-Mondebat,203,0,3742,3742,18.4
33105,Castelviel,203,0,2016,2016,9.9
36096,Lingé,203,0,1006,1006,5
39227,Foncine-le-Bas,203,1600,2055,3655,18
39293,Leschères,203,529,747,1276,6.3
39366,Mont-sur-Monnet,203,0,2055,2055,10.1
41292,Villexanton,203,0,611,611,3
43053,Champclause,203,0,1126,1126,5.5
46264,Saint-Denis-Catus,203,0,1714,1714,8.4
52162,Dammartin-sur-Meuse,203,0,931,931,4.6
53027,Beaumont-Pied-de-Bœuf,203,0,1220,1220,6
60459,La Neuville-sur-Ressons,203,0,1775,1775,8.7
60476,Omécourt,203,0,996,996,4.9
61034,Beaulieu,203,1780,865,2645,13
61346,Le Renouard,203,970,1467,2437,12
62084,Barly,203,0,1687,1687,8.3
62365,Galametz,203,0,3214,3214,15.8
62414,Haucourt,203,0,253,253,1.2
62635,Offin,203,0,3214,3214,15.8
62880,Le Wast,203,0,586,586,2.9
63173,Grandrif,203,0,1834,1834,9
64204,Eaux-Bonnes,203,0,2577,2577,12.7
64226,Fichous-Riumayou,203,0,3178,3178,15.7
65314,Monfaucon,203,0,4586,4586,22.6
65327,Nestier,203,0,1328,1328,6.5
65376,Recurt,203,0,606,606,3
71035,Bissy-la-Mâconnaise,203,0,4724,4724,23.3
71302,Montagny-lès-Buxy,203,0,3114,3114,15.3
72379,Viré-en-Champagne,203,0,1845,1845,9.1
77204,Germigny-sous-Coulombs,203,0,2981,2981,14.7
79348,Villefollet,203,0,5863,5863,28.9
80547,Millencourt,203,0,227,227,1.1
88449,Savigny,203,0,5105,5105,25.1
89010,Annay-sur-Serein,203,730,980,1710,8.4
95379,Maudétour-en-Vexin,203,0,1283,1283,6.3
2130,Bucilly,202,0,3965,3965,19.6
2262,Deuillet,202,0,3629,3629,18
2414,Lavaqueresse,202,0,1114,1114,5.5
2506,Montgobert,202,0,194,194,1
2657,Rougeries,202,0,3602,3602,17.8
4023,Bayons,202,3050,6022,9072,44.9
5048,L'Épine,202,0,6022,6022,29.8
6135,Sigale,202,0,4552,4552,22.5
7030,Beauvène,202,4575,674,5249,26
8016,Aouste,202,0,5281,5281,26.1
9041,La Bastide-du-Salat,202,0,24478,24478,121.2
10286,Petit-Mesnil,202,0,1202,1202,6
11363,Saint-Pierre-des-Champs,202,0,2737,2737,13.5
12181,Peyrusse-le-Roc,202,0,3470,3470,17.2
14132,Canchy,202,0,1398,1398,6.9
16345,Saint-Quentin-sur-Charente,202,545,4156,4701,23.3
19254,Ségur-le-Château,202,0,6186,6186,30.6
21072,Bézouotte,202,0,880,880,4.4
22235,Plouzélambre,202,0,4013,4013,19.9
27111,Bretagnolles,202,0,2376,2376,11.8
30087,Colognac,202,0,420,420,2.1
32211,Lias-d'Armagnac,202,0,0,0,0
33180,Gans,202,0,67,67,0.3
34317,La Vacquerie-et-Saint-Martin-de-Castries,202,0,2269,2269,11.2
46288,Saint-Perdoux,202,0,5965,5965,29.5
47096,Ferrensac,202,0,5158,5158,25.5
51109,Châlons-sur-Vesle,202,0,3590,3590,17.8
54044,Barbas,202,0,717,717,3.5
57643,Secourt,202,0,7736,7736,38.3
58262,Saint-Péreuse,202,0,2380,2380,11.8
60359,Lhéraule,202,0,1656,1656,8.2
60566,Saint-Arnoult,202,0,991,991,4.9
63435,Tourzel-Ronzières,202,0,1313,1313,6.5
67396,Rexingen,202,0,2532,2532,12.5
70114,Cendrecourt,202,0,612,612,3
71232,Hautefond,202,0,783,783,3.9
80069,Beaumont-Hamel,202,0,226,226,1.1
80520,Maucourt,202,0,3656,3656,18.1
88016,Attigny,202,0,1570,1570,7.8
89214,Lailly,202,898,392,1290,6.4
3198,Neure,201,0,2706,2706,13.5
3263,Saint-Voir,201,0,3472,3472,17.3
9149,Lacourt,201,0,24357,24357,121.2
10120,Cussangy,201,0,3742,3742,18.6
10310,Puits-et-Nuisement,201,0,1196,1196,6
14070,Beuvron-en-Auge,201,0,2553,2553,12.7
14390,Maisoncelles-sur-Ajon,201,0,7453,7453,37.1
15222,Sansac-Veinazès,201,1295,1762,3057,15.2
19253,Segonzac,201,0,3208,3208,16
22350,Tréduder,201,0,3993,3993,19.9
23260,Vidaillat,201,0,6302,6302,31.4
27240,La Ferrière-sur-Risle,201,0,1788,1788,8.9
28368,La Saucelle,201,0,3588,3588,17.9
30252,Saint-Félix-de-Pallières,201,0,418,418,2.1
32437,Sorbets,201,0,134,134,0.7
37036,Braye-sur-Maulne,201,0,1865,1865,9.3
38514,Tréminis,201,1000,5631,6631,33
39255,Gizia,201,1150,3065,4215,21
39426,Plasne,201,1500,4446,5946,29.6
46139,Labathude,201,0,5936,5936,29.5
46281,Saint-Médard-de-Presque,201,0,6558,6558,32.6
46324,Uzech,201,0,6015,6015,29.9
47162,Massoulès,201,0,1158,1158,5.8
51415,Omey,201,0,336,336,1.7
51508,Saint-Ouen-Domprot,201,0,3171,3171,15.8
51638,Villeseneux,201,0,3994,3994,19.9
52107,Chantraines,201,0,3092,3092,15.4
54343,Mandres-aux-Quatre-Tours,201,0,1200,1200,6
54517,Thézey-Saint-Martin,201,0,1189,1189,5.9
55182,Éton,201,0,3674,3674,18.3
57065,Bermering,201,0,665,665,3.3
60092,Boullarre,201,0,787,787,3.9
61267,Ménil-Hermei,201,0,1147,1147,5.7
62017,Aix-en-Ergny,201,0,11894,11894,59.2
65471,Vignec,201,0,9663,9663,48.1
66079,Finestret,201,0,6020,6020,30
70247,Fouvent-Saint-Andoche,201,0,1032,1032,5.1
71472,Saint-Prix,201,0,4497,4497,22.4
76029,Aubermesnil-aux-Érables,201,0,4,4,0
77467,La Tombe,201,1078,2847,3925,19.5
80084,Bermesnil,201,0,278,278,1.4
82109,Merles,201,0,21596,21596,107.4
89027,Bagneaux,201,3525,390,3915,19.5
3162,Marigny,200,0,2692,2692,13.5
4090,Le Fugeret,200,0,7072,7072,35.4
7274,Saint-Maurice-en-Chalencon,200,3800,667,4467,22.3
8461,Vandy,200,0,4839,4839,24.2
9058,Bompas,200,0,772,772,3.9
12082,La Couvertoirade,200,0,8564,8564,42.8
14400,Le Manoir,200,0,7708,7708,38.5
16133,Étriac,200,1500,10694,12194,61
21232,Dompierre-en-Morvan,200,0,4247,4247,21.2
21569,Saint-Romain,200,0,870,870,4.4
21616,Tailly,200,0,870,870,4.4
25107,Cendrey,200,0,9969,9969,49.8
25544,Servin,200,0,5514,5514,27.6
26068,Le Chalon,200,0,4054,4054,20.3
27053,Le Bec-Thomas,200,0,5931,5931,29.7
31545,Sepx,200,0,10749,10749,53.7
36108,Lys-Saint-Georges,200,0,587,587,2.9
39031,Auxange,200,610,4059,4669,23.3
43160,Rauret,200,2620,969,3589,17.9
47011,Anthé,200,0,1152,1152,5.8
47211,Poudenas,200,0,970,970,4.8
47275,Saint-Salvy,200,0,1921,1921,9.6
48019,Barre-des-Cévennes,200,0,4905,4905,24.5
51490,Saint-Jean-sur-Moivre,200,0,334,334,1.7
52406,Pressigny,200,0,3944,3944,19.7
54275,Jaulny,200,0,1194,1194,6
60193,Daméraucourt,200,0,981,981,4.9
60276,Godenvillers,200,0,1108,1108,5.5
60329,Laberlière,200,0,1748,1748,8.7
61068,Bursard,200,0,1255,1255,6.3
61503,Vieux-Pont,200,0,422,422,2.1
62409,Hannescamps,200,0,1662,1662,8.3
62602,Nempont-Saint-Firmin,200,0,2128,2128,10.6
64170,Castagnède,200,0,4181,4181,20.9
64285,Juxue,200,0,5197,5197,26
70205,Échavanne,200,0,339,339,1.7
71159,Culles-les-Roches,200,2000,3068,5068,25.3
81304,Trévien,200,0,4576,4576,22.9
88073,Brantigny,200,0,5029,5029,25.1
88461,Suriauville,200,0,70,70,0.4
97314,Ouanary,200,321350,0,321350,1606.8
2411,Latilly,199,0,4600,4600,23.1
3144,Liernolles,199,0,3437,3437,17.3
5074,Lettret,199,0,282,282,1.4
7214,Saint-Apollinaire-de-Rias,199,0,664,664,3.3
14731,Vauville,199,0,15751,15751,79.2
18073,Corquoy,199,0,3602,3602,18.1
19160,Pérols-sur-Vézère,199,0,2728,2728,13.7
21375,Manlay,199,0,6138,6138,30.8
21546,Saint-Didier,199,0,571,571,2.9
23213,Saint-Marien,199,0,2991,2991,15
27222,Épreville-en-Lieuvin,199,0,3065,3065,15.4
2B007,Albertacce,199,0,748,748,3.8
31054,Beauteville,199,0,971,971,4.9
31164,Drudas,199,0,1665,1665,8.4
31178,Fabas,199,0,4122,4122,20.7
31318,Marignac-Laspeyres,199,0,6969,6969,35
32443,Termes-d'Armagnac,199,6228,1992,8220,41.3
33074,Brouqueyran,199,0,1620,1620,8.1
39074,Brans,199,600,3140,3740,18.8
46194,Milhac,199,0,5955,5955,29.9
47298,Sénestis,199,0,2059,2059,10.3
51311,Jussecourt-Minecourt,199,0,1168,1168,5.9
52247,Illoud,199,0,3062,3062,15.4
52253,Juzennecourt,199,0,21859,21859,109.8
64307,Lalongue,199,0,2077,2077,10.4
65273,Liac,199,0,4495,4495,22.6
67032,Bernardvillé,199,0,6154,6154,30.9
70239,Fondremand,199,855,1667,2522,12.7
70566,Villers-sur-Port,199,0,1182,1182,5.9
71314,Montjay,199,0,372,372,1.9
72002,Aillières-Beauvoir,199,0,3690,3690,18.5
76589,Saint-Honoré,199,0,1606,1606,8.1
80146,Brutelles,199,0,607,607,3.1
80605,Offoy,199,0,3793,3793,19.1
81061,Castanet,199,0,10934,10934,54.9
84151,Vitrolles-en-Lubéron,199,0,893,893,4.5
87007,Balledent,199,0,6040,6040,30.4
88182,Frapelle,199,0,1935,1935,9.7
89092,Châtel-Gérard,199,0,961,961,4.8
2075,Berthenicourt,198,0,0,0,0
2317,Fluquières,198,0,1794,1794,9.1
2705,La Selve,198,0,533,533,2.7
3196,Neuilly-en-Donjon,198,0,3420,3420,17.3
7082,Dornas,198,0,4233,4233,21.4
8338,Pauvres,198,0,4791,4791,24.2
10022,Avirey-Lingey,198,0,3456,3456,17.5
10384,Trannes,198,0,1178,1178,5.9
11003,Ajac,198,0,2606,2606,13.2
12029,Bor-et-Bar,198,0,577,577,2.9
14474,Notre-Dame-d'Estrées-Corbon,198,0,2204,2204,11.1
21053,Beaumont-sur-Vingeanne,198,0,862,862,4.4
21562,Saint-Maurice-sur-Vingeanne,198,0,862,862,4.4
23127,Mautes,198,0,2599,2599,13.1
23241,Saint-Silvain-Bellegarde,198,0,2599,2599,13.1
24141,Coutures,198,2115,1503,3618,18.3
24326,Peyzac-le-Moustier,198,0,2749,2749,13.9
25208,Durnes,198,0,1443,1443,7.3
27615,Sassey,198,0,2329,2329,11.8
28217,Louvilliers-lès-Perche,198,0,3535,3535,17.9
2B039,Bisinchi,198,0,744,744,3.8
30176,Montdardier,198,0,3194,3194,16.1
32070,Cahuzac-sur-Adour,198,0,1982,1982,10
32246,Maupas,198,0,0,0,0
33121,Cessac,198,0,1966,1966,9.9
40216,Ozourt,198,0,3101,3101,15.7
40226,Pimbo,198,0,4575,4575,23.1
41179,Le Poislay,198,0,1006,1006,5.1
51607,Verdon,198,0,6361,6361,32.1
52164,Damrémont,198,0,3905,3905,19.7
52227,Graffigny-Chemin,198,0,3046,3046,15.4
56025,Brignac,198,0,2982,2982,15.1
57551,Postroff,198,0,1289,1289,6.5
61308,Neuvy-au-Houlme,198,0,1130,1130,5.7
63336,Saint-Donat,198,0,620,620,3.1
64053,Arrien,198,0,2067,2067,10.4
64480,Saint-Gladie-Arrive-Munein,198,0,4139,4139,20.9
64491,Saint-Médard,198,0,5331,5331,26.9
65285,Louit,198,0,1257,1257,6.3
65429,Sombrun,198,0,4473,4473,22.6
70075,Bonboillon,198,0,134,134,0.7
70098,Brotte-lès-Luxeuil,198,0,190,190,1
70416,Pomoy,198,0,733,733,3.7
70552,Villafans,198,0,63,63,0.3
76119,Bosc-Bérenger,198,0,4625,4625,23.4
76140,Brametot,198,0,1282,1282,6.5
80494,Louvrechy,198,0,1216,1216,6.1
95682,Villiers-le-Sec,198,0,1145,1145,5.8
2155,Chaillevois,197,0,195,195,1
2562,Nouvron-Vingré,197,0,190,190,1
2667,Saconin-et-Breuil,197,0,190,190,1
3057,La Chapelle-aux-Chasses,197,0,2652,2652,13.5
5121,Rochebrune,197,0,1757,1757,8.9
6156,Venanson,197,0,3879,3879,19.7
9035,Balaguères,197,0,23872,23872,121.2
9137,Gudas,197,0,5295,5295,26.9
10113,Couvignon,197,0,0,0,0
14483,Ouffières,197,0,5956,5956,30.2
14491,Parfouru-sur-Odon,197,0,7305,7305,37.1
14687,Le Theil-en-Auge,197,0,1472,1472,7.5
17005,Allas-Bocage,197,0,2326,2326,11.8
18074,Couargues,197,1340,3549,4889,24.8
21113,Broindon,197,0,945,945,4.8
21358,Lucenay-le-Duc,197,0,3837,3837,19.5
21389,Marmagne,197,0,3837,3837,19.5
25143,Chay,197,0,1436,1436,7.3
25579,Val-de-Roulans,197,0,9820,9820,49.8
26217,La Motte-Fanjas,197,0,12338,12338,62.6
27325,Hecmanville,197,0,849,849,4.3
27401,Le Mesnil-Fuguet,197,0,2317,2317,11.8
27640,Tilleul-Dame-Agnès,197,0,1753,1753,8.9
2B145,Loreto-di-Casinca,197,0,912,912,4.6
2B201,Pancheraccia,197,0,1500,1500,7.6
2B293,Sant'Andréa-di-Cotone,197,0,1414,1414,7.2
30048,Bouquet,197,0,1514,1514,7.7
31139,Chaum,197,0,1886,1886,9.6
38023,Avignonet,197,0,5519,5519,28
39265,Hautecour,197,1050,5733,6783,34.4
39361,Montmirey-le-Château,197,2150,3109,5259,26.7
39388,Nevy-sur-Seille,197,80,5236,5316,27
39550,Verges,197,1065,6208,7273,36.9
45322,Thorailles,197,0,597,597,3
46039,Brengues,197,0,5818,5818,29.5
47193,Moulinet,197,0,5030,5030,25.5
48015,Pied-de-Borne,197,0,3992,3992,20.3
48055,Cultures,197,0,6995,6995,35.5
51068,Blesme,197,0,1156,1156,5.9
52165,Dancevoir,197,0,1080,1080,5.5
53085,Crennes-sur-Fraubée,197,0,1752,1752,8.9
54121,Charmois,197,0,814,814,4.1
57238,Fresnes-en-Saulnois,197,0,652,652,3.3
59552,Sancourt,197,0,2561,2561,13
61012,Auguaise,197,2120,2031,4151,21.1
62378,Gouves,197,0,1637,1637,8.3
63218,Mayres,197,0,1780,1780,9
63394,Saint-Romain,197,0,1780,1780,9
70126,Chancey,197,0,133,133,0.7
72178,Maisoncelles,197,0,3683,3683,18.7
74111,Entrevernes,197,0,1522,1522,7.7
76389,Lintot-les-Bois,197,0,1590,1590,8.1
77080,Champcenest,197,0,710,710,3.6
81068,Combefa,197,0,4507,4507,22.9
82116,Montagudet,197,0,6168,6168,31.3
2373,Hary,196,0,3495,3495,17.8
2537,Nanteuil-la-Fosse,196,0,387,387,2
10042,Bérulle,196,0,3420,3420,17.4
10062,Briel-sur-Barse,196,0,3421,3421,17.5
10422,Villeneuve-au-Chemin,196,0,3649,3649,18.6
15230,Sourniac,196,2200,3707,5907,30.1
17004,Île-d'Aix,196,20850,3228,24078,122.8
17114,Coivert,196,0,5459,5459,27.9
18070,Concressault,196,1110,3531,4641,23.7
18147,Ménétréol-sur-Sauldre,196,0,0,0,0
19045,La Chapelle-Saint-Géraud,196,0,582,582,3
21579,Salives,196,0,135,135,0.7
23005,Arfeuille-Châtain,196,0,2573,2573,13.1
23228,Saint-Pardoux-le-Neuf,196,0,7413,7413,37.8
25273,Glamondans,196,0,9770,9770,49.8
32198,Lartigue,196,0,2490,2490,12.7
33353,Rimons,196,0,1946,1946,9.9
36122,Meunet-sur-Vatan,196,0,3981,3981,20.3
42025,Boyer,196,0,5085,5085,25.9
43178,Saint-Didier-sur-Doulon,196,1060,1785,2845,14.5
45343,Villevoques,196,0,1922,1922,9.8
46241,Rouffilhac,196,0,5866,5866,29.9
46276,Saint-Martin-Labouval,196,0,1102,1102,5.6
50054,Biéville,196,0,2899,2899,14.8
50610,Urville,196,0,6165,6165,31.5
51080,Brandonvillers,196,0,1218,1218,6.2
52095,Chalvraines,196,0,3015,3015,15.4
54178,Épiez-sur-Chiers,196,0,2488,2488,12.7
55278,Laneuville-au-Rupt,196,0,791,791,4
55391,Olizy-sur-Chiers,196,0,7087,7087,36.2
58068,Chaumard,196,0,2310,2310,11.8
61041,Bellou-le-Trichard,196,0,2276,2276,11.6
62404,Halloy,196,0,1629,1629,8.3
62883,Wavrans-sur-Ternoise,196,0,4234,4234,21.6
63017,Augnat,196,0,1274,1274,6.5
64001,Aast,196,0,2046,2046,10.4
65105,Bourg-de-Bigorre,196,0,585,585,3
65383,Sadournin,196,0,6349,6349,32.4
67190,Hengwiller,196,45,13824,13869,70.8
68202,Mertzen,196,0,2791,2791,14.2
69075,Dième,196,0,2317,2317,11.8
70295,La Lanterne-et-les-Armonts,196,0,2254,2254,11.5
70308,La Longine,196,0,2254,2254,11.5
71030,Bergesserin,196,0,1362,1362,6.9
71039,Blanot,196,0,1362,1362,6.9
71446,Saint-Marcelin-de-Cray,196,800,1362,2162,11
71532,Taizé,196,0,1362,1362,6.9
77158,Diant,196,0,139,139,0.7
80616,Pargny,196,0,3736,3736,19.1
80748,Templeux-le-Guérard,196,0,1404,1404,7.2
81275,Salles,196,0,4987,4987,25.4
86228,Saint-Laurent-de-Jourdes,196,2920,7927,10847,55.3
88010,Aouze,196,0,2190,2190,11.2
1331,Saint-Alban,195,0,2794,2794,14.3
2090,Billy-sur-Ourcq,195,0,651,651,3.3
2127,Bruyères-sur-Fère,195,0,4507,4507,23.1
2219,Coucy-la-Ville,195,0,193,193,1
3193,Nassigny,195,0,273,273,1.4
4193,Saint-Paul-sur-Ubaye,195,3400,58236,61636,316.1
8485,Villy,195,0,6904,6904,35.4
9045,Bédeilhac-et-Aynat,195,0,753,753,3.9
14050,La Bazoque,195,0,1350,1350,6.9
16268,Poursac,195,1430,4268,5698,29.2
21434,Montlay-en-Auxois,195,0,4141,4141,21.2
21541,Saint-Aubin,195,0,848,848,4.3
21594,Savoisy,195,0,3253,3253,16.7
23166,Sagnat,195,0,5822,5822,29.9
23221,Saint-Merd-la-Breuille,195,0,2673,2673,13.7
24006,Allas-les-Mines,195,1740,9545,11285,57.9
24386,Saint-Cernin-de-l'Herm,195,0,334,334,1.7
25340,Lombard,195,0,1421,1421,7.3
25392,Mont-de-Vougney,195,0,1358,1358,7
25629,Voillans,195,0,9720,9720,49.8
26195,Montclar-sur-Gervanne,195,1200,2362,3562,18.3
27544,Saint-Germain-de-Fresney,195,0,2293,2293,11.8
2A035,Belvédère-Campomoro,195,0,0,0,0
30161,Massanes,195,0,6095,6095,31.3
31027,Auribail,195,0,1026,1026,5.3
31362,Montberaud,195,0,6829,6829,35
31537,Savarthès,195,0,4039,4039,20.7
32330,Préchac-sur-Adour,195,0,3595,3595,18.4
32377,Saint-Georges,195,0,736,736,3.8
33354,Riocaud,195,0,1472,1472,7.5
33365,Saint-Aignan,195,0,2935,2935,15.1
39092,Chambéria,195,1308,5675,6983,35.8
46243,Rueyres,195,0,5758,5758,29.5
47208,Pompogne,195,0,3291,3291,16.9
47223,Rives,195,0,4979,4979,25.5
50304,Le Mesnil-Aubert,195,0,4719,4719,24.2
50327,La Meurdraquière,195,0,4719,4719,24.2
51219,Drosnay,195,0,1211,1211,6.2
51501,Sainte-Marie-à-Py,195,0,1835,1835,9.4
51583,Trois-Fontaines-l'Abbaye,195,0,1766,1766,9.1
54535,Tronville,195,0,1164,1164,6
55370,Naix-aux-Forges,195,0,2351,2351,12.1
55444,Rouvrois-sur-Meuse,195,0,2874,2874,14.7
57024,Antilly,195,0,396,396,2
58021,Azy-le-Vif,195,0,1304,1304,6.7
60629,Thérines,195,0,957,957,4.9
61263,Ménil-Erreux,195,508,5763,6271,32.2
61485,Ticheville,195,1100,1410,2510,12.9
64121,Beyrie-en-Béarn,195,0,5757,5757,29.5
64325,Lasseubetat,195,0,4199,4199,21.5
64487,Saint-Just-Ibarre,195,0,5067,5067,26
70481,Savoyeux,195,0,1001,1001,5.1
71006,Amanzé,195,0,3785,3785,19.4
71144,Cordesse,195,0,4363,4363,22.4
71216,Germagny,195,0,2991,2991,15.3
76195,Criquetot-le-Mauconduit,195,0,1263,1263,6.5
80278,Erches,195,0,235,235,1.2
82069,Ginals,195,0,2758,2758,14.1
88202,Gircourt-lès-Viéville,195,0,2802,2802,14.4
88495,Vaudéville,195,0,4904,4904,25.1
2120,Brenelle,194,0,383,383,2
2273,Dury,194,0,27727,27727,142.9
2337,Froidestrées,194,0,3459,3459,17.8
2379,Le Hérie-la-Viéville,194,0,3459,3459,17.8
2812,Villers-Hélon,194,0,187,187,1
5025,Buissard,194,0,12907,12907,66.5
9284,Ségura,194,0,5214,5214,26.9
19247,Saint-Victour,194,0,2660,2660,13.7
23054,Charron,194,0,2547,2547,13.1
25534,Sarrageois,194,0,11554,11554,59.6
25536,Sauvagney,194,0,131,131,0.7
27342,Houetteville,194,0,834,834,4.3
28144,Les Étilleux,194,0,76,76,0.4
28327,Saint-Bomer,194,0,76,76,0.4
2B124,Ghisoni,194,0,0,0,0
31305,Loudet,194,0,4018,4018,20.7
35336,Le Tiercent,194,0,5947,5947,30.7
39392,Offlanges,194,1340,3061,4401,22.7
42269,Saint-Paul-d'Uzore,194,0,1738,1738,9
46277,Saint-Martin-le-Redon,194,0,7054,7054,36.4
46292,Saint-Simon,194,0,5729,5729,29.5
48170,Saint-Martin-de-Boubaux,194,0,10566,10566,54.5
50174,Équilly,194,0,4695,4695,24.2
50247,Hocquigny,194,0,4695,4695,24.2
51460,Rieux,194,0,6233,6233,32.1
51641,Villevenard,194,0,281,281,1.4
54032,Autrey,194,0,0,0,0
59490,Rainsars,194,0,1537,1537,7.9
60059,Béhéricourt,194,0,0,0,0
60084,Bonnières,194,0,952,952,4.9
60345,Lamécourt,194,0,1029,1029,5.3
62058,Aumerval,194,0,4191,4191,21.6
62776,Sapignies,194,0,965,965,5
62802,Le Souich,194,0,1612,1612,8.3
62830,Trescault,194,0,965,965,5
64345,Lohitzun-Oyhercq,194,0,5041,5041,26
66202,Targasonne,194,0,0,0,0
71096,La Chapelle-sous-Uchon,194,0,4341,4341,22.4
76365,Houdetot,194,0,1256,1256,6.5
80314,Flers,194,0,1390,1390,7.2
88387,Removille,194,0,2167,2167,11.2
95331,Lassy,194,0,1122,1122,5.8
2519,Montloué,193,0,2126,2126,11
2636,Regny,193,0,0,0,0
3035,Le Bouchaud,193,0,3333,3333,17.3
4241,Villemus,193,0,509,509,2.6
8132,Corny-Machéroménil,193,0,3691,3691,19.1
8295,Mondigny,193,0,4233,4233,21.9
9024,Aston,193,47800,27795,75595,391.7
10050,Bossancourt,193,0,1149,1149,6
11234,Mireval-Lauragais,193,0,1696,1696,8.8
12192,Mounes-Prohencoux,193,0,7552,7552,39.1
12222,Saint-Félix-de-Sorgues,193,0,404,404,2.1
15051,Clavières,193,2539,4269,6808,35.3
18188,Primelles,193,720,538,1258,6.5
19225,Saint-Merd-de-Lapleau,193,0,2476,2476,12.8
21488,Poinçon-lès-Larrey,193,0,3220,3220,16.7
21499,Pothières,193,0,3220,3220,16.7
21633,Thorey-sous-Charny,193,0,4098,4098,21.2
21715,Voudenay,193,0,5953,5953,30.8
23242,Saint-Silvain-Montaigut,193,0,3152,3152,16.3
25455,Placey,193,0,130,130,0.7
31176,Esténos,193,0,1847,1847,9.6
33386,Saint-Cibard,193,0,7498,7498,38.8
33404,Sainte-Gemme,193,0,1917,1917,9.9
34106,Fozières,193,0,2168,2168,11.2
39184,Les Crozets,193,725,5617,6342,32.9
40299,Serreslous-et-Arribans,193,0,4459,4459,23.1
40305,Sorbets,193,0,4459,4459,23.1
43195,Saint-Ilpize,193,100,9458,9558,49.5
43215,Saint-Paul-de-Tartas,193,500,936,1436,7.4
47073,Cours,193,0,1854,1854,9.6
47177,Monheurt,193,0,1854,1854,9.6
50016,Appeville,193,0,1046,1046,5.4
50398,Le Perron,193,0,2855,2855,14.8
52280,Lecey,193,0,886,886,4.6
54409,Omelmont,193,0,0,0,0
55153,Dieppe-sous-Douaumont,193,0,3486,3486,18.1
55178,Érize-Saint-Dizier,193,0,2613,2613,13.5
55445,Rouvrois-sur-Othain,193,0,3527,3527,18.3
58233,Saint-Benin-des-Bois,193,0,967,967,5
60085,Bonvillers,193,0,4352,4352,22.5
60249,Foulangues,193,0,802,802,4.2
61138,Croisilles,193,0,1395,1395,7.2
65097,Bonrepos,193,0,576,576,3
70405,Pennesières,193,0,1617,1617,8.4
72246,Prévelles,193,0,1177,1177,6.1
76207,Cuverville-sur-Yères,193,1765,1221,2986,15.5
76526,Ricarville-du-Val,193,896,1221,2117,11
80061,Beaucamps-le-Jeune,193,0,266,266,1.4
80225,Creuse,193,0,12373,12373,64.1
80465,Languevoisin-Quiquery,193,0,3679,3679,19.1
89415,Thory,193,0,419,419,2.2
2592,Parpeville,192,0,0,0,0
5014,Barret-sur-Méouge,192,0,5724,5724,29.8
8360,Renneville,192,0,4211,4211,21.9
9014,Argein,192,0,23266,23266,121.2
9091,Cazavet,192,0,23266,23266,121.2
9247,Rivèrenert,192,0,23266,23266,121.2
10435,Villy-le-Maréchal,192,0,2742,2742,14.3
12093,Le Fel,192,0,951,951,5
15057,Cros-de-Montvert,192,4978,1684,6662,34.7
18178,La Perche,192,0,515,515,2.7
21382,Marcilly-Ogny,192,0,2918,2918,15.2
23066,Le Compas,192,0,2521,2521,13.1
23209,Saint-Loup,192,0,2886,2886,15
24421,Saint-Geyrac,192,7108,1072,8180,42.6
25313,Hyèvre-Paroisse,192,0,9570,9570,49.8
27248,Folleville,192,0,2957,2957,15.4
27433,Neuville-sur-Authou,192,0,828,828,4.3
31385,Montmaurin,192,0,3977,3977,20.7
32358,Saint-Antoine,192,0,20629,20629,107.4
38237,Mizoën,192,0,10921,10921,56.9
39040,Barretaine,192,50,4247,4297,22.4
45001,Adon,192,0,2235,2235,11.6
45341,Villeneuve-sur-Conie,192,0,271,271,1.4
47273,Saint-Robert,192,0,1471,1471,7.7
48107,Palhers,192,0,4578,4578,23.8
48171,Saint-Martin-de-Lansuscle,192,0,10457,10457,54.5
51259,Francheville,192,0,320,320,1.7
51398,La Neuville-aux-Larris,192,0,278,278,1.4
51445,Pourcy,192,0,3412,3412,17.8
51551,Somsois,192,0,3029,3029,15.8
53272,Villepail,192,0,1708,1708,8.9
54587,Vitrey,192,0,0,0,0
55146,Dannevoux,192,0,6943,6943,36.2
57230,Fouligny,192,0,8910,8910,46.4
57362,Kerprich-aux-Bois,192,0,1250,1250,6.5
57611,Saint-Georges,192,0,1250,1250,6.5
59287,Haucourt-en-Cambrésis,192,0,1319,1319,6.9
64318,Larreule,192,0,3006,3006,15.7
64342,Licq-Athérey,192,0,4989,4989,26
70142,Chaumercenne,192,0,130,130,0.7
71104,Charnay-lès-Chalon,192,0,2216,2216,11.5
71201,Fley,192,0,2945,2945,15.3
76221,Drosay,192,0,1243,1243,6.5
76343,Haucourt,192,0,3627,3627,18.9
79218,Pressigny,192,0,5034,5034,26.2
80429,Hénencourt,192,0,25,25,0.1
80432,Herleville,192,0,3475,3475,18.1
81183,Mont-Roc,192,0,2415,2415,12.6
86269,Ternay,192,0,981,981,5.1
88085,Champdray,192,0,323,323,1.7
88312,Morelmaison,192,0,2145,2145,11.2
90078,Petitefontaine,192,2720,5719,8439,44
2183,Chevregny,191,0,1373,1373,7.2
2432,Limé,191,0,377,377,2
2546,La Neuville-en-Beine,191,0,3432,3432,18
2605,Pleine-Selve,191,0,0,0,0
3116,Fourilles,191,0,3907,3907,20.5
7251,Saint-Joseph-des-Bancs,191,0,3260,3260,17.1
9077,Capoulet-et-Junac,191,0,737,737,3.9
14012,Angerville,191,0,2426,2426,12.7
15213,Saint-Saturnin,191,995,43,1038,5.4
16081,La Chapelle,191,600,2401,3001,15.7
16128,Épenède,191,50,3930,3980,20.8
16190,Longré,191,1198,4181,5379,28.2
17435,Taillant,191,0,5320,5320,27.9
17458,Vanzac,191,810,2255,3065,16
18002,Ainay-le-Vieil,191,0,512,512,2.7
18043,La Celle-Condé,191,0,3457,3457,18.1
19208,Saint-Hilaire-Foissac,191,0,2450,2450,12.8
21308,Grignon,191,0,0,0,0
24244,Lolme,191,2440,694,3134,16.4
24477,Saint-Pardoux-de-Drône,191,170,1450,1620,8.5
2B246,La Porta,191,0,884,884,4.6
31342,Milhas,191,0,10265,10265,53.7
33270,Marimbault,191,0,63,63,0.3
39073,Brainans,191,400,4225,4625,24.2
43167,Saint-Arcons-d'Allier,191,0,1739,1739,9.1
43253,Les Vastres,191,0,1060,1060,5.5
46168,Lentillac-Saint-Blaise,191,0,5640,5640,29.5
48165,Saint-Laurent-de-Muret,191,0,4554,4554,23.8
50572,Sénoville,191,2010,6008,8018,42
51542,Soizy-aux-Bois,191,0,6137,6137,32.1
55412,Rambucourt,191,0,2270,2270,11.9
55470,Saudrupt,191,0,3733,3733,19.5
55523,Vacherauville,191,0,11839,11839,62
58159,Marigny-sur-Yonne,191,0,2970,2970,15.5
58266,Saint-Révérien,191,0,2970,2970,15.5
58277,Sermages,191,0,9852,9852,51.6
60303,Hautbos,191,0,937,937,4.9
61160,Feings,191,0,671,671,3.5
62410,Haplincourt,191,0,950,950,5
65079,Bégole,191,0,1213,1213,6.4
67258,Landersheim,191,1100,13472,14572,76.3
70367,Mont-le-Vernois,191,0,9880,9880,51.7
70371,Montureux-et-Prantigny,191,0,980,980,5.1
71321,Morey,191,0,3069,3069,16.1
71573,Versaugues,191,0,741,741,3.9
72236,Pincé,191,0,4442,4442,23.3
73324,Villaroux,191,0,3416,3416,17.9
77087,La Chapelle-Iger,191,0,971,971,5.1
79015,Asnières-en-Poitou,191,0,5516,5516,28.9
80340,Fourcigny,191,0,264,264,1.4
80348,Fransu,191,0,329,329,1.7
80743,Suzanne,191,0,214,214,1.1
88020,Autreville,191,0,2134,2134,11.2
88352,Pompierre,191,0,2134,2134,11.2
5108,Puy-Saint-Eusèbe,190,0,15183,15183,79.9
7284,Saint-Pierre-Saint-Jean,190,176,4649,4825,25.4
10038,Bercenay-le-Hayer,190,0,0,0,0
10112,Coussegrey,190,0,3537,3537,18.6
12024,Belcastel,190,0,409,409,2.2
14635,Saint-Omer,190,0,5744,5744,30.2
16392,Valence,190,630,2389,3019,15.9
21325,Jouey,190,0,5860,5860,30.8
22309,Saint-Launeuc,190,0,0,0,0
25098,Buffard,190,0,1385,1385,7.3
25391,Mont-de-Laval,190,0,3191,3191,16.8
26277,La Roche-sur-Grane,190,0,2302,2302,12.1
27269,Fresne-Cauverville,190,0,2926,2926,15.4
2B199,Palasca,190,0,2666,2666,14
34175,Mourèze,190,0,216,216,1.1
40140,Lagrange,190,0,2170,2170,11.4
43131,Mazerat-Aurouze,190,1575,1730,3305,17.4
46222,Pomarède,190,0,5374,5374,28.3
46280,Saint-Médard,190,0,1604,1604,8.4
47205,Pindères,190,0,3206,3206,16.9
52240,Heuilley-le-Grand,190,0,3747,3747,19.7
53264,Thorigné-en-Charnie,190,0,1359,1359,7.2
57183,Donnelay,190,0,629,629,3.3
58217,Pousseaux,190,0,3975,3975,20.9
65106,Bourisp,190,0,9134,9134,48.1
68276,Rimbachzell,190,0,4689,4689,24.7
70201,Delain,190,0,975,975,5.1
70559,Villeparois,190,0,9829,9829,51.7
71091,La Chapelle-du-Mont-de-France,190,0,2582,2582,13.6
76006,Amfreville-les-Champs,190,0,419,419,2.2
77496,Vieux-Champagne,190,0,2446,2446,12.9
88381,Relanges,190,0,1477,1477,7.8
2115,Braye-en-Laonnois,189,0,1359,1359,7.2
2441,Louâtre,189,0,182,182,1
5027,Cervières,189,0,13483,13483,71.3
5058,Freissinières,189,0,13037,13037,69
8250,Leffincourt,189,0,4573,4573,24.2
8468,Vaux-Villaine,189,0,4941,4941,26.1
9138,L'Herm,189,0,5080,5080,26.9
10014,Assencières,189,0,703,703,3.7
11002,Airoux,189,0,1661,1661,8.8
14134,Canteloup,189,0,1521,1521,8
21041,Avot,189,0,131,131,0.7
23078,Faux-Mazuras,189,0,5926,5926,31.4
25083,Bournois,189,0,436,436,2.3
25239,Feule,189,0,11964,11964,63.3
25520,Saint-Juan,189,0,9421,9421,49.8
26122,Espenel,189,717,5137,5854,31
28142,Ermenonville-la-Petite,189,0,699,699,3.7
28400,Varize,189,0,993,993,5.3
36111,Malicornay,189,0,554,554,2.9
39225,Le Fied,189,0,4180,4180,22.1
39250,Geruge,189,550,5956,6506,34.4
39499,Saligney,189,1920,2982,4902,25.9
40225,Philondenx,189,0,4367,4367,23.1
48008,Arzenc-de-Randon,189,1400,2226,3626,19.2
48053,Cubières,189,0,3830,3830,20.3
51370,Moiremont,189,0,2806,2806,14.8
52014,Aprey,189,0,2341,2341,12.4
54070,Bey-sur-Seille,189,0,1118,1118,5.9
54247,Hammeville,189,0,0,0,0
54474,Sainte-Geneviève,189,0,2065,2065,10.9
55119,Cléry-le-Petit,189,0,6834,6834,36.2
55292,Liny-devant-Dun,189,0,6834,6834,36.2
57056,Bébing,189,0,1230,1230,6.5
57198,Erstroff,189,0,3227,3227,17.1
57294,Hanviller,189,0,4356,4356,23
57393,Lengelsheim,189,0,4356,4356,23
60438,Moulin-sous-Touvent,189,6850,1280,8130,43
61052,Bonnefoi,189,3300,1948,5248,27.8
62016,Airon-Saint-Vaast,189,0,2011,2011,10.6
63348,Saint-Genès-la-Tourette,189,0,1229,1229,6.5
64197,Cuqueron,189,0,5089,5089,26.9
64403,Montfort,189,0,3951,3951,20.9
67488,Thal-Drulingen,189,624,2369,2993,15.8
76189,Crasville-la-Mallet,189,0,1224,1224,6.5
80067,Beaufort-en-Santerre,189,0,3421,3421,18.1
80516,Marquaix,189,0,1354,1354,7.2
80664,Rancourt,189,0,1354,1354,7.2
80741,Soyécourt,189,0,3421,3421,18.1
82021,Bouloc-en-Quercy,189,0,5917,5917,31.3
86011,Asnières-sur-Blour,189,0,7644,7644,40.4
87080,Jouac,189,200,3217,3417,18.1
88507,Villers,189,0,2716,2716,14.4
89188,Girolles,189,835,410,1245,6.6
89253,Merry-sur-Yonne,189,244,410,654,3.5
2004,Agnicourt-et-Séchelles,188,0,947,947,5
2066,Benay,188,0,0,0,0
2096,Bois-lès-Pargny,188,0,947,947,5
2132,Bucy-lès-Cerny,188,0,7180,7180,38.2
7121,Lachapelle-Graillouse,188,2024,1470,3494,18.6
8160,Évigny,188,0,4123,4123,21.9
11072,La Cassaigne,188,0,557,557,3
12278,Tayrac,188,0,4362,4362,23.2
14036,Banneville-la-Campagne,188,0,1513,1513,8
14082,La Boissière,188,0,2093,2093,11.1
15165,Rouffiac,188,3320,1648,4968,26.4
16191,Lonnes,188,1425,2363,3788,20.1
18195,Sagonne,188,0,3013,3013,16
19190,Saint-Bonnet-près-Bort,188,0,2577,2577,13.7
21415,Minot,188,0,3137,3137,16.7
23074,Le Donzeil,188,0,5895,5895,31.4
24215,Jayac,188,0,719,719,3.8
24572,Vergt-de-Biron,188,0,683,683,3.6
25067,Blussans,188,0,434,434,2.3
27442,Notre-Dame-du-Hamel,188,0,810,810,4.3
31199,Fronsac,188,0,1800,1800,9.6
32274,Monlezun-d'Armagnac,188,0,125,125,0.7
33310,Origne,188,0,1923,1923,10.2
36138,Néret,188,940,4130,5070,27
40160,Lourquen,188,0,2944,2944,15.7
40322,Uza,188,0,1530,1530,8.1
41058,Concriers,188,0,566,566,3
47020,Baleyssagues,188,0,9261,9261,49.3
48168,Saint-Léger-de-Peyre,188,1960,4482,6442,34.3
51268,Germinon,188,0,3736,3736,19.9
51586,Unchair,188,0,3341,3341,17.8
54223,Germiny,188,0,6233,6233,33.2
54582,Villette,188,0,2387,2387,12.7
55329,Mécrin,188,0,759,759,4
57310,Hellering-lès-Fénétrange,188,0,1224,1224,6.5
58127,Giry,188,0,10610,10610,56.4
60544,Rocquencourt,188,0,4240,4240,22.6
62426,Héninel,188,0,5288,5288,28.1
62513,Ligny-sur-Canche,188,0,4061,4061,21.6
62694,Rebreuve-sur-Canche,188,0,1562,1562,8.3
63466,Vodable,188,0,1222,1222,6.5
66215,Trévillach,188,0,5631,5631,30
70484,Secenans,188,0,59,59,0.3
71315,Mont-lès-Seurre,188,0,2169,2169,11.5
76180,Cleuville,188,0,1218,1218,6.5
76379,Lamberville,188,0,1517,1517,8.1
76641,Saint-Pierre-le-Vieux,188,0,1218,1218,6.5
88315,Mortagne,188,0,1828,1828,9.7
88330,Nonville,188,0,1461,1461,7.8
89149,Dyé,188,500,437,937,5
89203,Island,188,1950,408,2358,12.5
91399,Mespuits,188,0,473,473,2.5
2105,Bouresches,187,0,4322,4322,23.1
2240,Croix-Fonsomme,187,0,1694,1694,9.1
2425,Leuze,187,0,3671,3671,19.6
2545,La Neuville-Bosmont,187,0,942,942,5
3231,Saint-Fargeol,187,0,4402,4402,23.5
8092,Cauroy,187,0,4525,4525,24.2
8141,Dommery,187,0,4102,4102,21.9
10011,Arrentières,187,0,0,0,0
10436,Vinets,187,0,159,159,0.9
11142,Festes-et-Saint-André,187,0,2462,2462,13.2
16178,Lagarde-sur-le-Né,187,920,9999,10919,58.4
17268,Nuaillé-sur-Boutonne,187,0,5209,5209,27.9
21163,Chazeuil,187,0,129,129,0.7
22331,Sainte-Tréphine,187,0,17220,17220,92.1
23071,Croze,187,0,7072,7072,37.8
24323,Petit-Bersac,187,3559,1420,4979,26.6
24478,Saint-Pardoux-et-Vielvic,187,0,9154,9154,49
25574,Uzelle,187,0,431,431,2.3
28155,Fontaine-les-Ribouts,187,0,250,250,1.3
2B190,Olmi-Cappella,187,0,2624,2624,14
31096,Cabanac-Séguenville,187,0,1564,1564,8.4
32157,L'Isle-Arné,187,0,2375,2375,12.7
32171,Labastide-Savès,187,0,1167,1167,6.2
33215,Ladaux,187,0,1857,1857,9.9
38020,Auris,187,0,10636,10636,56.9
39027,Augisey,187,3150,2851,6001,32.1
39223,La Ferté,187,309,4136,4445,23.8
39460,La Rixouse,187,0,688,688,3.7
41001,Ambloy,187,0,2313,2313,12.4
42160,Nollieux,187,0,1544,1544,8.3
51094,Brusson,187,0,1097,1097,5.9
53134,Livet,187,0,1338,1338,7.2
54500,Selaincourt,187,0,6200,6200,33.2
58034,Blismes,187,0,2203,2203,11.8
58271,Saizy,187,0,2908,2908,15.6
59167,Cuvillers,187,0,2431,2431,13
60427,Monts,187,0,602,602,3.2
60465,Noirémont,187,7830,4217,12047,64.4
60614,Serans,187,0,4106,4106,22
61424,Saint-Martin-des-Landes,187,0,841,841,4.5
62779,Sarton,187,0,1554,1554,8.3
64096,Barraute-Camu,187,0,3909,3909,20.9
64423,Oraàs,187,0,3909,3909,20.9
65016,Antist,187,0,1404,1404,7.5
67229,Jetterswiller,187,0,10156,10156,54.3
67245,Knœrsheim,187,110,10156,10266,54.9
68328,Storckensohn,187,0,1943,1943,10.4
71519,Serrigny-en-Bresse,187,2662,350,3012,16.1
71527,Sommant,187,0,4184,4184,22.4
77136,Courquetaine,187,0,177,177,0.9
80434,Hervilly,187,0,1340,1340,7.2
80503,Maizicourt,187,0,729,729,3.9
80517,Marquivillers,187,0,226,226,1.2
80529,Mérélessart,187,0,570,570,3
86069,La Chaussée,187,0,955,955,5.1
86151,Maulay,187,0,955,955,5.1
1177,Grand-Corent,186,0,3596,3596,19.3
2754,Ugny-le-Gay,186,0,3342,3342,18
7111,Juvinas,186,0,3175,3175,17.1
9227,Péreille,186,0,1652,1652,8.9
10393,Vallentigny,186,0,3927,3927,21.1
12042,Calmels-et-le-Viala,186,0,390,390,2.1
14476,Olendon,186,0,2914,2914,15.7
15203,Saint-Mary-le-Plain,186,2415,42,2457,13.2
17341,Saint-Germain-de-Vibrac,186,0,2196,2196,11.8
21233,Drambon,186,0,0,0,0
21678,Vic-sous-Thil,186,0,3950,3950,21.2
23178,Saint-Agnant-près-Crocq,186,0,2442,2442,13.1
27068,Bois-Anzeray,186,0,5231,5231,28.1
27081,Boncourt,186,0,2188,2188,11.8
2B236,Poggio-di-Nazza,186,0,0,0,0
31225,Goutevernisse,186,0,320,320,1.7
32046,Bernède,186,0,5823,5823,31.3
32124,Espaon,186,0,1161,1161,6.2
34339,Villespassans,186,0,1052,1052,5.7
39026,Augerans,186,1000,1801,2801,15.1
39514,Serre-les-Moulières,186,100,2935,3035,16.3
39583,Vosbles-Valfin,186,2230,5413,7643,41.1
41116,Lisle,186,0,945,945,5.1
46218,Pescadoires,186,0,6763,6763,36.4
46253,Saint-Chamarand,186,0,5566,5566,29.9
50241,Hémevez,186,0,5851,5851,31.5
55076,Bréhéville,186,0,3399,3399,18.3
55358,Chanteraine,186,0,2242,2242,12.1
55362,Moulins-Saint-Hubert,186,0,6726,6726,36.2
57228,Fossieux,186,0,616,616,3.3
57297,Harprich,186,0,3176,3176,17.1
58268,Saint-Seine,186,0,9594,9594,51.6
61216,La Lande-de-Goult,186,9530,837,10367,55.7
61427,Saint-Martin-l'Aiguillon,186,0,837,837,4.5
64240,Gère-Bélesten,186,0,2361,2361,12.7
65173,Esterre,186,0,7616,7616,40.9
66211,Tordères,186,0,2493,2493,13.4
70190,Cubry-lès-Faverney,186,0,1105,1105,5.9
70290,Jasney,186,0,1182,1182,6.4
70323,Mailleroncourt-Saint-Pancras,186,0,1182,1182,6.4
71317,Montmort,186,0,956,956,5.1
76606,Morienne,186,0,4,4,0
77206,Giremoutiers,186,0,724,724,3.9
77481,Vanvillé,186,0,2395,2395,12.9
81181,Montpinier,186,0,2782,2782,15
81278,Sauveterre,186,13144,1606,14750,79.3
84005,Aurel,186,0,3018,3018,16.2
88490,Valleroy-le-Sec,186,0,65,65,0.3
89161,Étivey,186,4635,898,5533,29.7
89226,Lignorelles,186,1675,25,1700,9.1
1077,Challes-la-Montagne,185,0,2651,2651,14.3
2143,Le Catelet,185,0,1676,1676,9.1
2616,Pont-Saint-Mard,185,0,183,183,1
3017,Barrais-Bussolles,185,0,372,372,2
9109,Durfort,185,0,3290,3290,17.8
14130,Campigny,185,0,7130,7130,38.5
21120,La Bussière-sur-Ouche,185,0,2812,2812,15.2
26137,Francillon-sur-Roubion,185,755,2241,2996,16.2
26329,Saint-Sauveur-Gouvernet,185,0,9506,9506,51.4
2A254,Quenza,185,0,4314,4314,23.3
31194,Francarville,185,3078,902,3980,21.5
32053,Bézues-Bajon,185,0,2183,2183,11.8
32338,Ramouzens,185,0,0,0,0
32385,Saint-Léonard,185,0,698,698,3.8
33459,Saint-Pey-d'Armens,185,0,7187,7187,38.8
39090,Chaînée-des-Coupis,185,650,1096,1746,9.4
40072,Castelnau-Tursan,185,0,4274,4274,23.1
46043,Cahus,185,0,6036,6036,32.6
46242,Rudelle,185,0,5463,5463,29.5
47266,Saint-Pé-Saint-Simon,185,0,897,897,4.8
47272,Saint-Quentin-du-Dropt,185,0,4724,4724,25.5
48150,Saint-Flour-de-Mercoire,185,0,1657,1657,9
50265,Laulne,185,0,3866,3866,20.9
50340,Montcuit,185,540,5353,5893,31.9
52022,Aubepierre-sur-Aube,185,0,1014,1014,5.5
60216,Erquinvillers,185,0,1025,1025,5.5
60297,Le Hamel,185,0,908,908,4.9
60353,Lavacquerie,185,0,908,908,4.9
61026,Barville,185,50,65,115,0.6
61101,Le Château-d'Almenêches,185,0,1161,1161,6.3
62227,Clenleu,185,0,10948,10948,59.2
62419,Haut-Loquin,185,0,400,400,2.2
62616,Nœux-lès-Auxi,185,0,3997,3997,21.6
64032,Araujuzon,185,0,3867,3867,20.9
64077,Auga,185,0,2897,2897,15.7
64316,Larrau,185,0,4807,4807,26
64319,Larribar-Sorhapuru,185,0,4807,4807,26
68052,Bretten,185,0,2634,2634,14.2
70118,Chambornay-lès-Bellevaux,185,0,1550,1550,8.4
70488,Senoncourt,185,0,1099,1099,5.9
71041,Bois-Sainte-Marie,185,0,3591,3591,19.4
71058,Bresse-sur-Grosne,185,0,2241,2241,12.1
72270,Saint-Calez-en-Saosnois,185,0,3431,3431,18.5
76478,Notre-Dame-du-Parc,185,0,1493,1493,8.1
76744,Villers-sous-Foucarmont,185,0,3,3,0
77029,Beauvoir,185,0,175,175,0.9
78234,Flacourt,185,0,1722,1722,9.3
80562,Montigny-sur-l'Hallue,185,0,721,721,3.9
81029,Bernac,185,0,10164,10164,54.9
81205,Péchaudier,185,0,206,206,1.1
88403,Rozerotte,185,0,65,65,0.4
89040,Bessy-sur-Cure,185,800,25,825,4.5
89339,Sainte-Colombe,185,810,893,1703,9.2
2102,Bouconville-Vauclair,184,0,1323,1323,7.2
2376,Hauteville,184,0,1014,1014,5.5
2401,Laigny,184,0,3281,3281,17.8
2529,Mortiers,184,0,927,927,5
2794,Vézilly,184,0,4253,4253,23.1
7262,Saint-Laurent-les-Bains-Laval-d'Aurelle,184,0,1439,1439,7.8
11182,Lacombe,184,0,2377,2377,12.9
11292,La Pomarède,184,0,1617,1617,8.8
14203,Cricqueville-en-Auge,184,0,2337,2337,12.7
14424,Le Mesnil-Robert,184,0,84,84,0.5
16162,Gurat,184,1990,8652,10642,57.8
17294,Puyrolland,184,0,5125,5125,27.9
18276,Vernais,184,0,811,811,4.4
19089,Gros-Chastang,184,0,3491,3491,19
21543,Saint-Broing-les-Moines,184,0,3070,3070,16.7
22169,Peumerit-Quintin,184,0,16944,16944,92.1
24452,Saint-Martial-Viveyrol,184,1710,1397,3107,16.9
25225,Étrabonne,184,0,124,124,0.7
25366,Mancenans-Lizerne,184,0,1282,1282,7
30009,Alzon,184,0,2968,2968,16.1
32136,Galiax,184,0,3392,3392,18.4
32374,Saint-Élix-d'Astarac,184,0,2337,2337,12.7
33188,Giscos,184,0,61,61,0.3
33516,Soussac,184,0,1827,1827,9.9
34277,Saint-Maurice-Navacelles,184,0,2067,2067,11.2
38419,Saint-Martin-de-Clelles,184,0,5155,5155,28
39523,Syam,184,0,1863,1863,10.1
43104,Grèzes,184,0,1676,1676,9.1
46333,Vidaillac,184,0,1034,1034,5.6
51005,Allemant,184,0,2401,2401,13
51097,Bussy-le-Château,184,0,1731,1731,9.4
51267,Germigny,184,0,3270,3270,17.8
51275,Glannes,184,0,2902,2902,15.8
51618,Le Vézier,184,0,5912,5912,32.1
52302,Maizières,184,0,1666,1666,9.1
52425,Rivière-les-Fosses,184,0,2279,2279,12.4
53090,Denazé,184,0,1218,1218,6.6
53131,Lesbois,184,0,2426,2426,13.2
54217,Gélacourt,184,0,813,813,4.4
57580,Riche,184,0,609,609,3.3
58287,Tazilly,184,0,9491,9491,51.6
60336,Lachaussée-du-Bois-d'Écu,184,0,7215,7215,39.2
61333,Pontchardon,184,0,1330,1330,7.2
62710,Rimboval,184,0,10888,10888,59.2
64200,Doazon,184,0,4954,4954,26.9
64327,Lecumberry,184,0,4781,4781,26
64361,Lussagnet-Lusson,184,0,1921,1921,10.4
64457,Poursiugues-Boucoue,184,0,2881,2881,15.7
65201,Geu,184,0,1758,1758,9.6
70276,Granges-la-Ville,184,0,58,58,0.3
70523,Vars,184,0,929,929,5
76012,Angerville-Bailleul,184,0,2179,2179,11.8
76731,Vénestanville,184,0,1485,1485,8.1
77355,Paroy,184,0,2606,2606,14.2
79022,Availles-Thouarsais,184,0,4706,4706,25.6
80467,Laucourt,184,0,222,222,1.2
80729,Sauvillers-Mongival,184,0,1130,1130,6.1
82104,Marsac,184,0,4313,4313,23.4
86239,Sainte-Radégonde,184,0,10963,10963,59.6
88104,Circourt-sur-Mouzon,184,0,2056,2056,11.2
88344,Pargny-sous-Mureau,184,0,2056,2056,11.2
89412,Thizy,184,2122,888,3010,16.4
2138,Buzancy,183,0,611,611,3.3
3134,Laféline,183,0,3743,3743,20.5
8200,Grivy-Loisy,183,0,4428,4428,24.2
10291,Plessis-Barbuise,183,0,1131,1131,6.2
17223,Massac,183,0,5097,5097,27.9
21158,Chaume-et-Courchamp,183,0,797,797,4.4
25635,Vyt-lès-Belvoir,183,1280,5045,6325,34.6
27237,Le Favril,183,0,2818,2818,15.4
2A024,Aullène,183,0,4268,4268,23.3
34171,Montoulieu,183,4950,3920,8870,48.5
34212,Poujols,183,0,2055,2055,11.2
38204,Lalley,183,0,5127,5127,28
39531,Thoiria,183,0,5326,5326,29.1
39557,Vescles,183,1655,5326,6981,38.1
41224,Saint-Marc-du-Cor,183,0,5466,5466,29.9
43052,Champagnac-le-Vieux,183,150,2050,2200,12
43151,Pinols,183,840,1666,2506,13.7
43196,Saint-Jean-d'Aubrigoux,183,1475,7614,9089,49.7
45219,Moulon,183,0,1876,1876,10.3
46183,Marcilhac-sur-Célé,183,0,5404,5404,29.5
46213,Padirac,183,0,5971,5971,32.6
47231,Saint-Avit,183,0,1893,1893,10.3
52130,Cirfontaines-en-Azois,183,0,1003,1003,5.5
54225,Gézoncourt,183,0,1999,1999,10.9
54467,Rozelieures,183,0,756,756,4.1
54569,Ville-au-Val,183,0,1999,1999,10.9
58101,Dompierre-sur-Nièvre,183,0,10328,10328,56.4
64031,Arancou,183,0,4755,4755,26
64338,Lespourcy,183,0,1910,1910,10.4
65332,Oléac-Debat,183,0,1162,1162,6.3
68183,Liebenswiller,183,0,3557,3557,19.4
70185,Cresancey,183,0,924,924,5
71405,Saint-Didier-en-Bresse,183,0,2112,2112,11.5
80165,Camps-en-Amiénois,183,0,253,253,1.4
80673,Riencourt,183,0,253,253,1.4
86087,Craon,183,0,935,935,5.1
87023,Le Buis,183,0,297,297,1.6
88257,Juvaincourt,183,0,2630,2630,14.4
88450,Senaide,183,0,1423,1423,7.8
8416,Seuil,182,0,3481,3481,19.1
12260,Sauclières,182,0,7793,7793,42.8
16373,Souvigné,182,970,3984,4954,27.2
18111,Humbligny,182,1460,1379,2839,15.6
21497,Pont-et-Massène,182,0,3865,3865,21.2
22365,Trémargat,182,0,16760,16760,92.1
25330,Lavans-Quingey,182,0,1326,1326,7.3
25446,Passavant,182,0,9072,9072,49.8
25522,Saint-Julien-lès-Russey,182,0,3056,3056,16.8
28078,Chapelle-Guillaume,182,0,9945,9945,54.6
30283,Saint-Martial,182,0,3898,3898,21.4
32022,Avéron-Bergelle,182,0,1822,1822,10
32333,Projan,182,0,5697,5697,31.3
37042,Candes-Saint-Martin,182,0,9990,9990,54.9
39066,Bornay,182,700,5736,6436,35.4
43100,Frugières-le-Pin,182,0,8919,8919,49
46035,Boussac,182,0,5375,5375,29.5
46223,Pontcirq,182,0,1537,1537,8.4
46319,Théminettes,182,0,5375,5375,29.5
48115,Le Pompidou,182,0,9912,9912,54.5
51279,Granges-sur-Aube,182,0,2375,2375,13
52094,Vals-des-Tilles,182,0,2254,2254,12.4
52321,Mertrud,182,0,674,674,3.7
55578,Warcq,182,0,3288,3288,18.1
58163,Menou,182,0,3808,3808,20.9
61317,Orgères,182,0,1316,1316,7.2
62544,Manin,182,0,1512,1512,8.3
62890,Willeman,182,0,2882,2882,15.8
65028,Arné,182,0,544,544,3
66233,Vivès,182,0,7548,7548,41.5
74072,Chevaline,182,0,1501,1501,8.2
76537,Ronchois,182,0,3,3,0
79306,Saurais,182,376,4772,5148,28.3
80544,Mézerolles,182,0,709,709,3.9
82060,Fauroux,182,0,5698,5698,31.3
87155,Saint-Junien-les-Combes,182,3390,3098,6488,35.6
88325,La Neuveville-sous-Montfort,182,0,64,64,0.4
88517,Viviers-le-Gras,182,0,1415,1415,7.8
89115,Compigny,182,860,34,894,4.9
89182,Fouronnes,182,0,8218,8218,45.2
91240,Fontaine-la-Rivière,182,0,458,458,2.5
2455,Malzy,181,0,998,998,5.5
2832,Wiège-Faty,181,0,3228,3228,17.8
3280,Terjat,181,0,4260,4260,23.5
8392,Saint-Morel,181,0,4379,4379,24.2
10301,Pouy-sur-Vannes,181,0,0,0,0
10383,Trancault,181,0,0,0,0
12007,Ambeyrac,181,0,528,528,2.9
12227,Saint-Igest,181,0,528,528,2.9
14650,Saint-Pierre-du-Fresne,181,0,6712,6712,37.1
19171,Reygade,181,0,537,537,3
21177,Clamerey,181,0,3843,3843,21.2
21648,Turcey,181,0,0,0,0
23016,Banize,181,0,5675,5675,31.4
23123,Les Mars,181,0,2376,2376,13.1
24116,Châtres,181,860,3166,4026,22.2
25087,Branne,181,0,417,417,2.3
25416,Myon,181,0,1319,1319,7.3
2B054,Campile,181,0,838,838,4.6
31245,Juzet-d'Izaut,181,0,9728,9728,53.7
31325,Mascarville,181,0,883,883,4.9
32182,Lahas,181,0,2299,2299,12.7
33396,Saint-Étienne-de-Lisse,181,0,7032,7032,38.9
39037,Bans,181,2100,1753,3853,21.3
40247,Saint-Agnet,181,0,5666,5666,31.3
45264,Rozières-en-Beauce,181,0,746,746,4.1
50457,Sainte-Colombe,181,0,5693,5693,31.5
51349,Margerie-Hancourt,181,0,2855,2855,15.8
52120,Chauffourt,181,0,830,830,4.6
55059,Bonnet,181,0,3538,3538,19.5
55243,Herbeuville,181,0,2343,2343,12.9
55321,Marre,181,0,11219,11219,62
55457,Saint-Hilaire-en-Woëvre,181,0,2343,2343,12.9
55493,Sommeilles,181,0,4017,4017,22.2
57375,Lagarde,181,0,599,599,3.3
61108,Cisai-Saint-Aubin,181,1900,1308,3208,17.7
61330,Planches,181,0,1308,1308,7.2
62121,Beugnâtre,181,0,900,900,5
63074,Chalus,181,0,1177,1177,6.5
65259,Lansac,181,0,1149,1149,6.3
67079,Crœttwiller,181,0,20756,20756,114.7
70066,Betaucourt,181,0,548,548,3
70252,Framont,181,0,929,929,5.1
76399,Lucy,181,0,4228,4228,23.4
80430,Herbécourt,181,0,1297,1297,7.2
81073,Crespinet,181,0,5593,5593,30.9
88228,Haillainville,181,0,4552,4552,25.1
88354,Pont-sur-Madon,181,0,2601,2601,14.4
88425,Saint-Maurice-sur-Mortagne,181,0,903,903,5
1406,Servignat,180,0,3480,3480,19.3
2552,Neuvillette,180,0,0,0,0
3033,Bost,180,0,4931,4931,27.4
3151,Louroux-de-Beaune,180,0,6431,6431,35.7
4055,Chaudon-Norante,180,0,6365,6365,35.4
4057,Clamensane,180,0,5366,5366,29.8
6005,Ascros,180,0,4056,4056,22.5
9168,Lieurac,180,0,1598,1598,8.9
11196,Laurac,180,0,533,533,3
12249,Saint-Sever-du-Moustier,180,0,7043,7043,39.1
15009,Apchon,180,7653,2776,10429,57.9
21124,Censerey,180,0,5552,5552,30.8
21175,Cirey-lès-Pontailler,180,0,0,0,0
21709,Viserny,180,0,3506,3506,19.5
23187,Saint-Dizier-la-Tour,180,0,2363,2363,13.1
25275,Glère,180,0,1254,1254,7
25346,Longeville,180,0,1312,1312,7.3
25608,Le Vernoy,180,210,1176,1386,7.7
26133,Fay-le-Clos,180,0,2963,2963,16.5
27364,Launay,180,0,776,776,4.3
27680,Verneusses,180,0,776,776,4.3
28411,Villars,180,0,945,945,5.2
31274,Larcan,180,0,3728,3728,20.7
32199,Lasserrade,180,0,3318,3318,18.4
45012,Audeville,180,0,224,224,1.2
47227,Ruffiac,180,0,3037,3037,16.9
50175,Éroudeville,180,0,5662,5662,31.5
50310,Le Mesnil-Eury,180,0,2662,2662,14.8
54083,Bonviller,180,0,2699,2699,15
54231,Gondrecourt-Aix,180,0,1671,1671,9.3
54292,Lamath,180,0,795,795,4.4
55414,Rancourt-sur-Ornain,180,0,3995,3995,22.2
61352,Rônai,180,0,380,380,2.1
62282,Éclimeux,180,0,2850,2850,15.8
63260,Olmet,180,0,4173,4173,23.2
63323,Saint-Bonnet-le-Bourg,180,7852,1627,9479,52.7
68131,Heiwiller,180,0,4829,4829,26.8
70092,Bresilley,180,0,122,122,0.7
70554,Villars-le-Pautel,180,0,545,545,3
76257,Fallencourt,180,0,3,3,0
88119,Crainvilliers,180,0,63,63,0.4
88305,Moncel-sur-Vair,180,0,2011,2011,11.2
89284,Pacy-sur-Armançon,180,1660,418,2078,11.5
89314,Prégilbert,180,300,25,325,1.8
2125,Brumetz,179,0,4137,4137,23.1
2707,Septvaux,179,0,177,177,1
3261,Sainte-Thérence,179,0,4213,4213,23.5
4211,Sourribes,179,1080,3942,5022,28.1
5031,Champcella,179,0,12347,12347,69
8387,Saint-Loup-Terrier,179,0,3926,3926,21.9
8437,Tailly,179,0,4331,4331,24.2
9102,Coutens,179,0,3708,3708,20.7
9108,Durban-sur-Arize,179,0,21691,21691,121.2
10155,Fontette,179,0,3125,3125,17.5
10304,Précy-Saint-Martin,179,0,3779,3779,21.1
11056,Cabrespine,179,0,1161,1161,6.5
15026,Brezons,179,2100,3959,6059,33.8
17029,Bagnizeau,179,0,4986,4986,27.9
19193,Saint-Cirgues-la-Loutre,179,0,531,531,3
21305,Grancey-sur-Ource,179,0,2986,2986,16.7
21427,Montceau-et-Écharnant,179,0,2721,2721,15.2
23091,Gioux,179,0,6770,6770,37.8
23120,Malleret-Boussac,179,0,2690,2690,15
24254,Marnac,179,1460,8762,10222,57.1
25096,Brey-et-Maison-du-Bois,179,0,10660,10660,59.6
25435,Orsans,179,0,2114,2114,11.8
27163,Colletot,179,0,4043,4043,22.6
28175,La Gaudaine,179,0,70,70,0.4
2B086,Centuri,179,0,6565,6565,36.7
2B327,Tomino,179,0,6565,6565,36.7
32061,Boulaur,179,0,2274,2274,12.7
38424,Saint-Maurice-en-Trièves,179,0,5015,5015,28
41024,Boursay,179,0,5347,5347,29.9
42002,Ailleux,179,0,1604,1604,9
46068,Cénevières,179,0,1006,1006,5.6
46107,Floressas,179,0,6508,6508,36.4
47042,Brugnac,179,0,1445,1445,8.1
52447,Saint-Ciergues,179,0,821,821,4.6
54418,Parroy,179,0,2684,2684,15
54484,Sainte-Pôle,179,0,635,635,3.5
60132,Catigny,179,0,0,0,0
60362,Libermont,179,0,0,0,0
62467,Humerœuille,179,0,3867,3867,21.6
62561,Martinpuich,179,0,890,890,5
64459,Préchacq-Navarrenx,179,0,3742,3742,20.9
64479,Saint-Girons-en-Béarn,179,0,4820,4820,26.9
66113,Montbolo,179,0,0,0,0
70021,Andornay,179,0,7868,7868,44
70521,Vantoux-et-Longevelle,179,0,809,809,4.5
80365,Fricamps,179,0,247,247,1.4
80513,Maricourt,179,0,200,200,1.1
80525,Meigneux,179,0,247,247,1.4
87115,Pensol,179,320,79,399,2.2
8375,Sachy,178,0,6302,6302,35.4
8458,Tourteron,178,0,3904,3904,21.9
10045,Beurey,178,0,1059,1059,5.9
12204,La Roque-Sainte-Marguerite,178,0,1840,1840,10.3
14232,Ducy-Sainte-Marguerite,178,0,2182,2182,12.3
15011,Arnac,178,5881,1561,7442,41.8
15214,Saint-Saury,178,4040,1561,5601,31.5
16130,Les Essards,178,3600,8370,11970,67.2
22009,Le Bodéo,178,0,2823,2823,15.9
24036,Berbiguières,178,1620,8713,10333,58.1
24213,Jaure,178,1600,970,2570,14.4
24267,Mescoules,178,980,3963,4943,27.8
24281,Monsac,178,2250,647,2897,16.3
24404,Saint-Félix-de-Reillac-et-Mortemart,178,1885,2471,4356,24.5
26171,Manas,178,450,1715,2165,12.2
31112,Castagnède,178,0,9566,9566,53.7
32400,Saint-Orens-Pouy-Petit,178,0,684,684,3.8
32451,Tournan,178,0,1111,1111,6.2
33173,Francs,178,0,6916,6916,38.9
33216,Lados,178,0,59,59,0.3
41113,Lavardin,178,0,2202,2202,12.4
45150,Fréville-du-Gâtinais,178,0,1825,1825,10.3
46069,Cézac,178,0,4375,4375,24.6
48021,La Bastide-Puylaurent,178,0,3607,3607,20.3
51537,Sivry-Ante,178,0,2643,2643,14.8
54594,Xammes,178,0,1063,1063,6
55250,Inor,178,0,6436,6436,36.2
55293,Lion-devant-Dun,178,0,6436,6436,36.2
56209,Sainte-Brigitte,178,0,1239,1239,7
57320,Hertzing,178,0,1159,1159,6.5
58165,Metz-le-Comte,178,0,2768,2768,15.6
60182,Le Crocq,178,0,4014,4014,22.6
60376,Maisoncelle-Saint-Pierre,178,0,6980,6980,39.2
63375,Saint-Martin-des-Plains,178,0,1157,1157,6.5
64027,Anos,178,0,1858,1858,10.4
66062,Dorres,178,0,0,0,0
70272,Gourgeon,178,0,539,539,3
70560,Villers-Bouton,178,0,1491,1491,8.4
70578,Vregille,178,0,120,120,0.7
71524,Sivignon,178,0,1237,1237,6.9
77256,Lizines,178,4900,2521,7421,41.7
80386,Gratibus,178,0,215,215,1.2
80788,Vergies,178,0,246,246,1.4
81016,Arfons,178,0,3619,3619,20.3
81108,Itzac,178,0,9780,9780,54.9
81126,Lacougotte-Cadoul,178,0,581,581,3.3
88070,Bouxurulles,178,0,2558,2558,14.4
89190,Givry,178,0,386,386,2.2
89215,Lain,178,1783,8037,9820,55.2
90030,Croix,178,0,1059,1059,5.9
90105,Villars-le-Sec,178,0,1059,1059,5.9
2072,Berrieux,177,0,1272,1272,7.2
2230,Couvrelles,177,0,349,349,2
2726,Sommette-Eaucourt,177,0,25297,25297,142.9
9147,Labatut,177,0,797,797,4.5
10025,Bagneux-la-Fosse,177,0,3090,3090,17.5
10312,Racines,177,0,3295,3295,18.6
11242,Montclar,177,0,1148,1148,6.5
16054,Le Bouchage,177,5778,3642,9420,53.2
21472,Orville,177,0,122,122,0.7
27182,Courteilles,177,1500,4978,6478,36.6
27673,Vatteville,177,0,930,930,5.3
30163,Mauressargues,177,0,652,652,3.7
30175,Montclus,177,0,2583,2583,14.6
31494,Saint-Laurent,177,0,3666,3666,20.7
43011,Aubazat,177,1140,1612,2752,15.5
43105,Javaugues,177,0,8674,8674,49
45058,Bucy-le-Roi,177,0,250,250,1.4
45159,Grangermont,177,0,1341,1341,7.6
50533,Saint-Patrice-de-Claids,177,0,3698,3698,20.9
51251,Flavigny,177,0,3517,3517,19.9
51424,Passavant-en-Argonne,177,0,2628,2628,14.8
51435,Pocancy,177,0,3517,3517,19.9
53173,La Pallu,177,0,1574,1574,8.9
55454,Saint-Aubin-sur-Aire,177,0,714,714,4
57359,Kemplich,177,0,1134,1134,6.4
60224,Étavigny,177,0,693,693,3.9
61084,Champcerie,177,0,1010,1010,5.7
62187,Buneville,177,0,3824,3824,21.6
71421,Saint-Germain-en-Brionnais,177,0,3435,3435,19.4
71464,Saint-Maurice-lès-Couches,177,0,3960,3960,22.4
72085,Cogners,177,0,2393,2393,13.5
76028,Aubéguimont,177,0,3,3,0
80384,Grandcourt,177,0,198,198,1.1
86192,Plaisance,177,0,7159,7159,40.4
88014,Arrentès-de-Corcieux,177,0,1721,1721,9.7
88146,Domjulien,177,0,62,62,0.4
88303,Midrevaux,177,0,1977,1977,11.2
89362,Saint-Moré,177,2100,384,2484,14
2040,Autreppes,176,0,3138,3138,17.8
2367,Happencourt,176,0,25154,25154,142.9
3146,Limoise,176,0,2369,2369,13.5
4183,Saint-Julien-du-Verdon,176,4800,6223,11023,62.6
5062,Le Glaizil,176,0,11710,11710,66.5
8168,La Ferté-sur-Chiers,176,0,6231,6231,35.4
10218,Maisons-lès-Chaource,176,0,3277,3277,18.6
10296,Polisy,176,0,3072,3072,17.5
11051,Brézilhac,176,0,521,521,3
14160,Cintheaux,176,0,5321,5321,30.2
16173,Juillé,176,1625,2213,3838,21.8
19126,Marcillac-la-Croze,176,0,887,887,5
23191,Saint-Éloi,176,0,2874,2874,16.3
24416,Saint-Germain-de-Belvès,176,960,8615,9575,54.4
26248,Pontaix,176,0,9785,9785,55.6
28306,Pré-Saint-Martin,176,0,324,324,1.8
2B252,Pruno,176,0,815,815,4.6
37253,Sublaines,176,0,3960,3960,22.5
41187,Renay,176,0,894,894,5.1
46111,Fourmagnac,176,0,5197,5197,29.5
47047,Cambes,176,0,3278,3278,18.6
47299,Sérignac-Péboudou,176,0,4494,4494,25.5
50064,La Bonneville,176,0,5536,5536,31.5
51022,Aulnay-l'Aître,176,0,2776,2776,15.8
51591,Vandeuil,176,0,3128,3128,17.8
52056,Blessonville,176,0,965,965,5.5
52170,Dommarien,176,0,2180,2180,12.4
54004,Affléville,176,0,1634,1634,9.3
54082,Boncourt,176,0,1634,1634,9.3
55106,Chattancourt,176,0,10909,10909,62
57054,Baudrecourt,176,0,582,582,3.3
57609,Saint-Epvre,176,0,582,582,3.3
60214,Ernemont-Boutavent,176,0,863,863,4.9
60219,Escles-Saint-Pierre,176,0,863,863,4.9
60243,Fontaine-Saint-Lucien,176,0,6901,6901,39.2
61261,Le Ménil-Broût,176,1342,62,1404,8
64454,Pontiacq-Viellepinte,176,0,3976,3976,22.6
65184,Galez,176,0,526,526,3
67057,Bosselshausen,176,1025,4743,5768,32.8
71045,Bouhans,176,0,329,329,1.9
73234,Saint-François-de-Sales,176,0,2237,2237,12.7
73272,Saint-Pierre-de-Belleville,176,0,6677,6677,37.9
76268,Fongueusemare,176,0,1588,1588,9
79060,Caunay,176,0,0,0,0
80367,Frise,176,0,197,197,1.1
81237,Saint-Amancet,176,0,3578,3578,20.3
1106,Cize,175,0,3383,3383,19.3
2039,Autremencourt,175,0,882,882,5
2194,Cilly,175,0,882,882,5
2568,Oigny-en-Valois,175,0,168,168,1
2601,Pignicourt,175,0,471,471,2.7
3285,Tortezais,175,0,6252,6252,35.7
5060,Furmeyer,175,0,6549,6549,37.4
8312,Murtin-et-Bogny,175,0,2724,2724,15.6
10338,Saint-Étienne-sous-Barbuise,175,0,149,149,0.9
12018,Balaguier-d'Olt,175,0,5168,5168,29.5
18191,Raymond,175,0,1630,1630,9.3
19177,Rosiers-de-Juillac,175,1440,2793,4233,24.2
19231,Saint-Pardoux-la-Croisille,175,0,3321,3321,19
21009,Allerey,175,0,5398,5398,30.8
21101,Braux,175,0,3716,3716,21.2
21374,Maligny,175,0,5398,5398,30.8
23118,Maisonnisses,175,0,5487,5487,31.4
24062,Bouteilles-Saint-Sébastien,175,160,1329,1489,8.5
31063,Benque,175,0,3625,3625,20.7
32405,Sainte-Radegonde,175,0,99,99,0.6
37114,La Guerche,175,900,3038,3938,22.5
39377,Mutigney,175,480,2762,3242,18.5
45141,Faverelles,175,0,2037,2037,11.6
45170,Intville-la-Guétard,175,0,218,218,1.2
45217,Morville-en-Beauce,175,0,218,218,1.2
46314,Terrou,175,0,5168,5168,29.5
47160,Masquières,175,0,1008,1008,5.8
50399,Le Petit-Celland,175,0,4306,4306,24.6
51038,Baslieux-sous-Châtillon,175,0,253,253,1.4
51077,Bouvancourt,175,0,3110,3110,17.8
54063,Bernécourt,175,0,1045,1045,6
54130,Clayeures,175,0,723,723,4.1
54226,Gibeaumeix,175,0,5802,5802,33.2
54416,Pannes,175,0,1045,1045,6
55334,Ménil-la-Horgne,175,0,706,706,4
55438,Romagne-sous-Montfaucon,175,0,1830,1830,10.5
57100,Bourscheid,175,0,351,351,2
58279,Sichamps,175,0,9877,9877,56.4
58307,Vielmanay,175,0,3489,3489,19.9
60099,Braisnes-sur-Aronde,175,0,1530,1530,8.7
60569,Saint-Crépin-aux-Bois,175,6910,1185,8095,46.3
61357,Rouperroux,175,3770,787,4557,26
61361,Saint-André-de-Briouze,175,0,999,999,5.7
64297,Lacarre,175,0,4548,4548,26
64299,Lacommande,175,0,4712,4712,26.9
64560,Viven,175,0,2740,2740,15.7
65290,Luc,175,0,1111,1111,6.3
71108,Chasselas,175,3230,4470,7700,44
71454,Saint-Martin-du-Mont,175,0,720,720,4.1
72170,Louvigny,175,0,3245,3245,18.5
76564,Saint-Aubin-sur-Mer,175,0,1133,1133,6.5
76567,Sainte-Beuve-en-Rivière,175,0,4088,4088,23.4
79160,Lusseray,175,0,5054,5054,28.9
80796,Villeroy,175,0,242,242,1.4
88297,Méménil,175,0,230,230,1.3
89168,Fleys,175,240,24,264,1.5
89252,Merry-Sec,175,0,7902,7902,45.2
1174,Giron,174,0,2095,2095,12
1330,Ruffieu,174,0,0,0,0
4155,Prads-Haute-Bléone,174,3400,7293,10693,61.5
7094,Gilhac-et-Bruzac,174,1200,581,1781,10.2
9049,Bénac,174,0,4677,4677,26.9
15076,Glénat,174,3620,1526,5146,29.6
15113,Mandailles-Saint-Julien,174,1650,5895,7545,43.4
18113,Ignol,174,0,340,340,2
19280,Végennes,174,0,877,877,5
21215,Cuiserey,174,0,758,758,4.4
21548,Saint-Germain-de-Modéon,174,0,499,499,2.9
24524,Savignac-de-Miremont,174,950,2415,3365,19.3
25451,Petite-Chaux,174,0,10363,10363,59.6
27010,Amécourt,174,260,142,402,2.3
27429,Neuilly,174,0,914,914,5.3
2A091,Cognocoli-Monticchi,174,0,130,130,0.7
30222,La Roque-sur-Cèze,174,0,2539,2539,14.6
32085,Castet-Arrouy,174,0,99,99,0.6
36246,Villiers,174,0,863,863,5
39519,Soucia,174,300,5064,5364,30.8
41205,Saint-Cyr-du-Gault,174,0,6669,6669,38.3
46061,Cassagnes,174,0,6327,6327,36.4
46286,Saint-Paul-de-Vern,174,0,5677,5677,32.6
47018,Auriac-sur-Dropt,174,0,8571,8571,49.3
47219,Rayet,174,0,4443,4443,25.5
48175,Saint-Pierre-de-Nogaret,174,0,6179,6179,35.5
50372,Neufmesnil,174,0,3636,3636,20.9
50482,Saint-Germain-sur-Sèves,174,0,3636,3636,20.9
51579,Tréfols,174,0,5590,5590,32.1
55105,Châtillon-sous-les-Côtes,174,0,3143,3143,18.1
55175,Érize-la-Brûlée,174,0,2355,2355,13.5
60171,Courtieux,174,0,1179,1179,6.8
60352,Lattainville,174,0,3821,3821,22
61347,Résenlieu,174,0,1258,1258,7.2
61388,Saint-Fulgent-des-Ormes,174,0,2020,2020,11.6
62562,Matringhem,174,0,10297,10297,59.2
63006,Anzat-le-Luguet,174,0,1131,1131,6.5
63065,Ceilloux,174,950,1572,2522,14.5
64166,Caro,174,0,4522,4522,26
65432,Soublecause,174,0,3930,3930,22.6
67027,Belmont,174,0,12592,12592,72.4
67134,Eschwiller,174,1393,2181,3574,20.5
70125,Champvans,174,0,878,878,5
71152,Cressy-sur-Somme,174,0,894,894,5.1
71579,Villeneuve-en-Montagne,174,0,2669,2669,15.3
73113,Feissons-sur-Salins,174,0,1042,1042,6
76523,Rétonval,174,0,3,3,0
76680,Sorquainville,174,0,1129,1129,6.5
80105,Billancourt,174,0,3316,3316,19.1
80804,Villers-sous-Ailly,174,0,4309,4309,24.8
86143,Mairé,174,0,3960,3960,22.8
88309,Monthureux-le-Sec,174,0,61,61,0.4
88440,Sandaucourt,174,0,61,61,0.4
2274,Ébouleau,173,0,466,466,2.7
8356,Remaucourt,173,0,3794,3794,21.9
8410,Semide,173,0,4186,4186,24.2
11222,Mas-Cabardès,173,0,2235,2235,12.9
16114,Couture,173,0,3787,3787,21.9
19209,Saint-Hilaire-les-Courbes,173,0,3012,3012,17.4
19217,Saint-Julien-Maumont,173,0,872,872,5
21397,Mavilly-Mandelot,173,0,752,752,4.3
24191,Fraisse,173,1900,3851,5751,33.2
25016,Amathay-Vésigneux,173,0,1261,1261,7.3
25203,Domprel,173,0,2044,2044,11.8
28300,Poinville,173,0,909,909,5.3
30264,Saint-Jean-de-Ceyrargues,173,0,5408,5408,31.3
32103,Chélan,173,0,2042,2042,11.8
33196,Guillac,173,0,1207,1207,7
36011,Bagneux,173,0,175,175,1
36051,Chitray,173,0,951,951,5.5
37007,Assay,173,0,4694,4694,27.1
39301,Loulle,173,0,1752,1752,10.1
41254,Le Temple,173,0,5167,5167,29.9
43054,Chanaleilles,173,0,1575,1575,9.1
43070,Chilhac,173,3518,1575,5093,29.4
43086,Domeyrat,173,0,1575,1575,9.1
45120,Dammarie-en-Puisaye,173,0,2014,2014,11.6
45201,Mérinville,173,0,524,524,3
46235,Reilhac,173,0,5109,5109,29.5
50024,Auxais,173,0,3615,3615,20.9
51327,Loisy-en-Brie,173,0,3438,3438,19.9
52357,Noncourt-sur-le-Rongeant,173,0,641,641,3.7
52457,Saint-Vallier-sur-Marne,173,0,3412,3412,19.7
54368,Mignéville,173,0,614,614,3.5
57674,Tincry,173,0,572,572,3.3
57717,Viller,173,0,2954,2954,17.1
58291,Thianges,173,0,446,446,2.6
61105,Chemilli,173,200,2009,2209,12.8
62558,Marquay,173,0,3737,3737,21.6
65181,Fréchou-Fréchet,173,0,1098,1098,6.3
67536,Windstein,173,0,6336,6336,36.6
70179,Coulevon,173,0,8949,8949,51.7
71168,Dampierre-en-Bresse,173,0,21,21,0.1
71199,Flagy,173,0,1202,1202,6.9
71255,Lesme,173,0,889,889,5.1
71544,Toutenant,173,0,1996,1996,11.5
76423,Ménerval,173,0,3268,3268,18.9
76671,Sept-Meules,173,0,1094,1094,6.3
77197,Frétoy,173,0,624,624,3.6
80302,Faverolles,173,0,209,209,1.2
2056,Beaumont-en-Beine,172,0,3090,3090,18
2590,Pargny-la-Dhuys,172,0,3976,3976,23.1
2797,Viel-Arcy,172,0,339,339,2
3050,La Chabanne,172,0,4712,4712,27.4
7003,Aizac,172,0,2936,2936,17.1
8095,Chagny,172,0,3773,3773,21.9
8110,Le Châtelet-sur-Sormonne,172,0,2678,2678,15.6
10397,Vauchonvilliers,172,0,1024,1024,6
12035,Brasc,172,0,9386,9386,54.6
14601,Saint-Julien-sur-Calonne,172,0,2764,2764,16.1
17212,Louzignac,172,0,4791,4791,27.9
17481,Voissay,172,0,4791,4791,27.9
21393,Massingy,172,0,2870,2870,16.7
21570,Sainte-Sabine,172,0,2614,2614,15.2
24383,Saint-Capraise-d'Eymet,172,595,322,917,5.3
27139,Chambord,172,0,4837,4837,28.1
27168,Connelles,172,0,5101,5101,29.7
27586,Saint-Philbert-sur-Boissey,172,0,705,705,4.1
28151,Fessanvilliers-Mattanvilliers,172,0,230,230,1.3
29012,Bolazec,172,0,8942,8942,52
30320,Seynes,172,0,5376,5376,31.3
36166,Préaux,172,0,2159,2159,12.6
38321,Prébois,172,0,4818,4818,28
40064,Canenx-et-Réaut,172,0,1353,1353,7.9
41100,Les Hayes,172,0,2127,2127,12.4
46142,Lacapelle-Cabanac,172,0,6254,6254,36.4
46258,Saint-Cirq-Souillaguet,172,0,5147,5147,29.9
52035,Baissey,172,0,2130,2130,12.4
52360,Occey,172,0,2130,2130,12.4
53114,Hardanges,172,0,6392,6392,37.2
55071,Brandeville,172,0,3144,3144,18.3
55408,Pouilly-sur-Meuse,172,0,6219,6219,36.2
60071,Biermont,172,0,1504,1504,8.7
60519,Quesmy,172,0,0,0,0
62518,Linzeux,172,0,3716,3716,21.6
62823,Torcy,172,0,10178,10178,59.2
63137,Doranges,172,0,1554,1554,9
64475,Sainte-Engrâce,172,0,4470,4470,26
66170,Sainte-Colombe-de-la-Commanderie,172,0,2305,2305,13.4
70444,La Résie-Saint-Martin,172,0,868,868,5
71364,La Racineuse,172,0,21,21,0.1
72302,Saint-Martin-des-Monts,172,0,1049,1049,6.1
80344,Francières,172,0,4259,4259,24.8
80420,Harponville,172,0,192,192,1.1
80586,Nesle-l'Hôpital,172,0,237,237,1.4
80668,Remiencourt,172,0,11027,11027,64.1
81290,Souel,172,0,4376,4376,25.4
88248,Isches,172,0,1337,1337,7.8
88342,Pallegney,172,0,4325,4325,25.1
88343,Parey-sous-Montfort,172,0,61,61,0.4
2101,Bosmont-sur-Serre,171,0,861,861,5
2335,Fressancourt,171,0,3072,3072,18
2762,Vassens,171,0,165,165,1
5028,Chabestan,171,0,6399,6399,37.4
8178,Fraillicourt,171,0,3751,3751,21.9
9118,Esplas-de-Sérou,171,0,20722,20722,121.2
9300,Soula,171,0,4596,4596,26.9
10101,Coclois,171,0,146,146,0.9
10174,Isle-Aubigny,171,0,146,146,0.9
11080,Val de Lambronne,171,0,1879,1879,11
15106,Lieutadès,171,1630,3782,5412,31.6
18128,Limeux,171,318,2320,2638,15.4
25012,Les Alliés,171,0,1873,1873,11
25341,Lomont-sur-Crête,171,0,8524,8524,49.8
27381,Malouy,171,0,2633,2633,15.4
27546,Saint-Germain-des-Angles,171,0,2011,2011,11.8
27614,Sancourt,171,3370,139,3509,20.5
27621,Serez,171,0,2011,2011,11.8
28252,Miermaigne,171,0,67,67,0.4
31009,Antichan-de-Frontignes,171,0,1637,1637,9.6
31373,Montesquieu-Guittaut,171,0,3542,3542,20.7
32031,Bascous,171,0,0,0,0
33291,Montagoudin,171,0,1392,1392,8.1
34193,Pardailhan,171,0,647,647,3.8
36188,Saint-Cyran-du-Jambot,171,0,4270,4270,25
36225,Le Tranger,171,0,4270,4270,25
39240,Le Frasnois,171,0,1731,1731,10.1
43001,Agnat,171,0,8380,8380,49
45124,Desmonts,171,0,1296,1296,7.6
50124,La Chapelle-Urée,171,0,4207,4207,24.6
51048,Belval-sous-Châtillon,171,0,248,248,1.5
54349,Manonviller,171,0,756,756,4.4
57347,Insviller,171,0,566,566,3.3
57625,Salonnes,171,0,566,566,3.3
58245,Saint-Hilaire-Fontaine,171,0,8820,8820,51.6
60640,Tourly,171,0,3755,3755,22
62745,Saint-Denœux,171,0,2707,2707,15.8
63310,Sainte-Agathe,171,1730,3965,5695,33.3
63373,Saint-Maigner,171,0,265,265,1.5
64534,Taron-Sadirac-Viellenave,171,0,2677,2677,15.7
65384,Sailhan,171,0,8221,8221,48.1
70035,Augicourt,171,0,518,518,3
71048,Bourg-le-Comte,171,0,3832,3832,22.4
72279,Saint-Georges-de-la-Couée,171,0,9643,9643,56.4
76604,Saint-Mards,171,0,1380,1380,8.1
79074,La Chapelle-Pouilloux,171,0,4939,4939,28.9
80040,Aumâtre,171,0,236,236,1.4
82084,Lacour,171,0,5354,5354,31.3
82130,Montjoi,171,0,18372,18372,107.4
86035,Bourg-Archambault,171,0,6916,6916,40.4
86230,Saint-Léomer,171,0,6916,6916,40.4
88223,Gugney-aux-Aulx,171,0,2458,2458,14.4
8321,Neuville-Day,170,0,3729,3729,21.9
9290,Sentein,170,0,20600,20600,121.2
10324,Roncenay,170,0,2428,2428,14.3
14146,Cauville,170,0,5139,5139,30.2
14204,Cricqueville-en-Bessin,170,0,1177,1177,6.9
14214,Cussy,170,0,6552,6552,38.5
16111,Courgeac,170,1020,7994,9014,53
17067,Brie-sous-Matha,170,0,4735,4735,27.9
17249,Mortiers,170,0,2007,2007,11.8
21026,Asnières-en-Montagne,170,0,3312,3312,19.5
21032,Aubigny-la-Ronce,170,0,739,739,4.3
21033,Aubigny-lès-Sombernon,170,0,956,956,5.6
23253,Thauron,170,0,5330,5330,31.4
27558,Saint-Léger-du-Gennetey,170,0,696,696,4.1
27663,Le Troncq,170,0,731,731,4.3
31055,Beauville,170,4630,829,5459,32.1
31393,Mourvilles-Hautes,170,0,3456,3456,20.3
32100,Cazeneuve,170,0,654,654,3.8
39360,Montmirey-la-Ville,170,345,2683,3028,17.8
42121,Lérigneux,170,0,1523,1523,9
46209,Nadaillac-de-Rouge,170,0,5546,5546,32.6
50517,Saint-Martin-de-Varreville,170,0,921,921,5.4
51151,Chichey,170,0,2218,2218,13
51601,Vavray-le-Grand,170,0,997,997,5.9
52075,Briaucourt,170,0,18673,18673,109.8
60051,Beaudéduit,170,0,834,834,4.9
60098,Bouvresse,170,0,834,834,4.9
62064,Avesnes-lès-Bapaume,170,0,845,845,5
62608,Neuville-Bourjonval,170,0,845,845,5
64158,Cabidos,170,0,2662,2662,15.7
64293,Labatut-Figuières,170,0,3840,3840,22.6
65357,Peyraube,170,0,1079,1079,6.3
67026,Bellefosse,170,1550,12302,13852,81.5
70361,Montessaux,170,0,1955,1955,11.5
70386,La Neuvelle-lès-Scey,170,0,437,437,2.6
71507,Savigny-sur-Grosne,170,0,2059,2059,12.1
73277,Sainte-Reine,170,0,2161,2161,12.7
76306,Gonnetot,170,0,1372,1372,8.1
79042,Bougon,170,0,945,945,5.6
80244,Dominois,170,0,4210,4210,24.8
84109,Saint-Hippolyte-le-Graveyron,170,0,5551,5551,32.7
88162,Esley,170,0,1322,1322,7.8
2385,Housset,169,0,3014,3014,17.8
2570,Ollezy,169,0,24154,24154,142.9
4077,Entrevennes,169,0,1964,1964,11.6
5082,Mont-Dauphin,169,0,5494,5494,32.5
7253,Saint-Julien-du-Gua,169,280,564,844,5
8150,Écly,169,0,3232,3232,19.1
8340,Poilcourt-Sydney,169,0,3232,3232,19.1
9251,Roumengoux,169,0,3501,3501,20.7
10394,Vallières,169,0,3146,3146,18.6
15240,Trémouille,169,11905,865,12770,75.6
16183,Lésignac-Durand,169,860,3477,4337,25.7
21169,Chevannes,169,0,810,810,4.8
21274,Foissy,169,0,5213,5213,30.8
21281,Fontenelle,169,0,736,736,4.4
21449,Nan-sous-Thil,169,0,3589,3589,21.2
21476,Painblanc,169,0,2569,2569,15.2
22095,Landebaëron,169,0,3026,3026,17.9
25420,Nans-sous-Sainte-Anne,169,0,1232,1232,7.3
27241,Feuguerolles,169,900,727,1627,9.6
27289,La Goulafrière,169,0,729,729,4.3
27455,Piencourt,169,0,2603,2603,15.4
27692,Villettes,169,0,727,727,4.3
28077,La Chapelle-Fortin,169,0,3017,3017,17.9
28139,Épeautrolles,169,0,625,625,3.7
28392,Trancrainville,169,0,888,888,5.3
32241,Mas-d'Auvignon,169,0,96,96,0.6
33398,Saint-Exupéry,169,0,1376,1376,8.1
38066,Chalon,169,0,4320,4320,25.6
38127,Cornillon-en-Trièves,169,0,4734,4734,28
39109,Charézier,169,380,4918,5298,31.3
47122,Labretonie,169,0,1364,1364,8.1
50536,Saint-Pierre-d'Arthéglise,169,712,5316,6028,35.7
52062,Bourg,169,0,775,775,4.6
52146,Coupray,169,0,927,927,5.5
54093,Brainville,169,0,1569,1569,9.3
55245,Heudicourt-sous-les-Côtes,169,0,2008,2008,11.9
57702,Vaxy,169,0,559,559,3.3
58197,Nuars,169,0,2628,2628,15.6
61071,Camembert,169,0,1222,1222,7.2
62222,Chériennes,169,0,2676,2676,15.8
64509,Sauguis-Saint-Étienne,169,4960,4392,9352,55.3
70103,La Bruyère,169,0,1944,1944,11.5
72362,Le Tronchet,169,0,7955,7955,47.1
79019,Aubigny,169,0,4431,4431,26.2
80322,Fonches-Fonchette,169,0,204,204,1.2
80468,Laviéville,169,0,189,189,1.1
80735,Seux,169,0,10835,10835,64.1
82138,Perville,169,0,18158,18158,107.4
85245,Saint-Martin-des-Fontaines,169,2129,1109,3238,19.2
88210,Gorhey,169,0,2429,2429,14.4
88448,Sauville,169,0,59,59,0.3
88480,Ubexy,169,0,4250,4250,25.1
88523,Vouxey,169,0,1888,1888,11.2
2404,Landouzy-la-Cour,168,0,2996,2996,17.8
3216,Ronnet,168,0,3954,3954,23.5
3294,Ussel-d'Allier,168,0,3436,3436,20.5
4199,Saint-Vincent-sur-Jabron,168,0,3700,3700,22
5127,Rousset,168,0,1499,1499,8.9
6024,Briançonnet,168,0,4289,4289,25.5
9189,Mérens-les-Vals,168,0,24195,24195,144
10024,Avreuil,168,0,3128,3128,18.6
10272,Ormes,168,0,143,143,0.9
12175,Ols-et-Rinhodes,168,0,490,490,2.9
17157,Fenioux,168,2050,4680,6730,40.1
17464,Vergné,168,0,4680,4680,27.9
18154,Mornay-Berry,168,0,329,329,2
19122,Madranges,168,0,2925,2925,17.4
21450,Nantoux,168,0,731,731,4.4
21659,Vaux-Saules,168,0,0,0,0
21689,Villars-et-Villenotte,168,0,3567,3567,21.2
22320,Saint-Nicodème,168,0,3008,3008,17.9
24367,Saint-André-de-Double,168,1000,1276,2276,13.5
25234,Ferrières-le-Lac,168,0,1170,1170,7
25376,Mérey-Vieilley,168,1008,2960,3968,23.6
26098,Cobonne,168,0,2035,2035,12.1
2B337,Valle-di-Rostino,168,0,632,632,3.8
30050,Bragassargues,168,0,349,349,2.1
32465,Villefranche-d'Astarac,168,0,2134,2134,12.7
34015,Assignan,168,0,950,950,5.7
34062,Caussiniojouls,168,0,329,329,2
36121,Meunet-Planches,168,0,3412,3412,20.3
39326,Mesnois,168,1780,4889,6669,39.7
40130,Labastide-Chalosse,168,0,3881,3881,23.1
40198,Morganx,168,0,3881,3881,23.1
41174,Périgny,168,0,2078,2078,12.4
46041,Cadrieu,168,0,4961,4961,29.5
50253,Huisnes-sur-Mer,168,0,4134,4134,24.6
51179,Coupéville,168,0,280,280,1.7
57010,Alaincourt-la-Côte,168,0,556,556,3.3
57559,Puzieux,168,0,556,556,3.3
57661,Sturzelbronn,168,0,3872,3872,23
58008,Anthien,168,0,2613,2613,15.6
60416,Montgérain,168,0,931,931,5.5
62815,Tigny-Noyelle,168,0,1787,1787,10.6
64075,Audaux,168,0,3512,3512,20.9
64332,Lème,168,0,2630,2630,15.7
65009,Anères,168,0,1099,1099,6.5
65177,Fontrailles,168,0,5442,5442,32.4
66006,Ansignan,168,0,4108,4108,24.5
70112,Cemboing,168,0,509,509,3
71007,Ameugny,168,0,1168,1168,7
71116,Châtenay,168,1520,3261,4781,28.5
71301,Mont,168,0,864,864,5.1
76079,Bénouville,168,0,1515,1515,9
76109,Bois-Héroult,168,0,115,115,0.7
80294,Éterpigny,168,0,1204,1204,7.2
82015,Belbèze-en-Lomagne,168,0,3938,3938,23.4
88299,Ménil-en-Xaintois,168,0,1877,1877,11.2
89250,Méré,168,1750,23,1773,10.6
1302,Pollieu,167,0,1861,1861,11.1
3147,Loddes,167,0,2884,2884,17.3
4132,Montsalier,167,0,440,440,2.6
6101,Rigaud,167,0,3763,3763,22.5
9231,Le Port,167,0,20237,20237,121.2
10119,Cunfin,167,0,2915,2915,17.5
14053,Beaumais,167,0,2616,2616,15.7
14680,Sully,167,0,6436,6436,38.5
18227,Sainte-Montaine,167,500,0,500,3
19156,Palazinges,167,0,842,842,5
19158,Pandrignes,167,0,3169,3169,19
21214,Crugey,167,0,2538,2538,15.2
21296,Gevrolles,167,0,2786,2786,16.7
21644,Trochères,167,0,727,727,4.4
23017,Basville,167,0,2192,2192,13.1
25218,Épenouse,167,0,1973,1973,11.8
25280,Goumois,167,0,1163,1163,7
25360,Malbrans,167,0,1217,1217,7.3
31209,Garac,167,0,1397,1397,8.4
32062,Bourrouillan,167,0,111,111,0.7
32177,Lagarde-Hachan,167,0,370,370,2.2
33155,Escaudes,167,0,56,56,0.3
38301,Le Percy,167,0,4678,4678,28
38522,Valjouffrey,167,0,1749,1749,10.5
40146,Latrille,167,0,5228,5228,31.3
43134,Mézères,167,230,6949,7179,43
43220,Saint-Préjet-d'Allier,167,0,6949,6949,41.6
47007,Allons,167,0,2818,2818,16.9
47176,Montgaillard-en-Albret,167,0,810,810,4.9
50261,Lamberville,167,0,2470,2470,14.8
51361,Le Meix-Tiercelin,167,0,2634,2634,15.8
54026,Athienville,167,0,2504,2504,15
54094,Bralleville,167,0,0,0,0
54098,Brémoncourt,167,0,690,690,4.1
54387,Morville-sur-Seille,167,0,1825,1825,10.9
57290,Hampont,167,0,553,553,3.3
57451,Marthille,167,0,553,553,3.3
58289,Ternant,167,0,8614,8614,51.6
59062,Beaurieux,167,0,1323,1323,7.9
61056,Le Bouillon,167,690,1048,1738,10.4
61103,Chaumont,167,0,1207,1207,7.2
61390,Saint-Georges-d'Annebecq,167,0,353,353,2.1
62114,Bermicourt,167,0,3608,3608,21.6
63067,La Cellette,167,0,259,259,1.6
64013,Ainhice-Mongelos,167,0,4340,4340,26
64336,Lescun,167,0,3596,3596,21.5
65237,Juncalas,167,0,1595,1595,9.6
70555,La Villedieu-en-Fontenette,167,0,618,618,3.7
76187,Contremoulins,167,0,1084,1084,6.5
76269,Fontaine-en-Bray,167,0,3901,3901,23.4
76511,Preuseville,167,0,1233,1233,7.4
77250,Leudon-en-Brie,167,0,2750,2750,16.5
79294,Saint-Romans-des-Champs,167,0,2251,2251,13.5
80037,Aubvillers,167,0,1026,1026,6.1
80472,Lesbœufs,167,0,1196,1196,7.2
80790,Verpillières,167,0,202,202,1.2
81118,Laboulbène,167,0,2498,2498,15
86172,Mouterre-sur-Blourde,167,0,6754,6754,40.4
1298,Plagne,166,0,1999,1999,12
2010,Allemant,166,0,327,327,2
2078,Besmé,166,0,164,164,1
2731,Le Sourd,166,0,2960,2960,17.8
4174,Saint-Benoît,166,0,5870,5870,35.4
7202,Sablières,166,0,11575,11575,69.7
7213,Saint-André-Lachamp,166,2000,11575,13575,81.8
9080,Carla-de-Roquefort,166,0,1474,1474,8.9
16091,Châtignac,166,1425,7806,9231,55.6
17398,Saint-Seurin-de-Palenne,166,0,1960,1960,11.8
18217,Saint-Jeanvrin,166,0,445,445,2.7
19051,Chaumeil,166,0,2130,2130,12.8
21006,Aisey-sur-Seine,166,0,2770,2770,16.7
21420,Molinot,166,0,722,722,4.3
23222,Saint-Michel-de-Veisse,166,0,5205,5205,31.4
23266,La Villetelle,166,0,6278,6278,37.8
24411,Saint-Front-sur-Nizonne,166,1450,1112,2562,15.4
25422,Neuchâtel-Urtière,166,0,10508,10508,63.3
27475,La Poterie-Mathieu,166,0,2556,2556,15.4
27541,Le Mesnil-Saint-Jean,166,0,2556,2556,15.4
29084,Île-Molène,166,0,299,299,1.8
30296,Saint-Roman-de-Codières,166,0,3556,3556,21.4
31379,Montgazin,166,0,285,285,1.7
31419,Le Pin-Murelet,166,0,5813,5813,35
31509,Saint-Pé-d'Ardet,166,0,1589,1589,9.6
32071,Caillavet,166,0,1207,1207,7.3
34188,Olmet-et-Villecun,166,0,1864,1864,11.2
39545,Le Vaudioux,166,1350,1681,3031,18.3
43222,Saint-Privat-du-Dragon,166,0,1512,1512,9.1
47118,Hautesvignes,166,0,1340,1340,8.1
48185,Les Salelles,166,0,5895,5895,35.5
50379,Notre-Dame-de-Livoye,166,0,4084,4084,24.6
51224,Écriennes,166,0,1031,1031,6.2
53102,Gastines,166,0,1099,1099,6.6
53236,Saint-Mars-du-Désert,166,0,1476,1476,8.9
54071,Bezange-la-Grande,166,0,2489,2489,15
58041,Brinon-sur-Beuvron,166,15790,2581,18371,110.7
58285,Tamnay-en-Bazois,166,0,8563,8563,51.6
60624,Sully,166,900,814,1714,10.3
61067,Bures,166,3180,59,3239,19.5
63129,Cros,166,0,520,520,3.1
65165,Esparros,166,0,496,496,3
66158,Rasiguères,166,0,4059,4059,24.5
70016,Amont-et-Effreney,166,0,1909,1909,11.5
70547,Verlans,166,0,1084,1084,6.5
71087,Chapaize,166,0,2011,2011,12.1
76185,Compainville,166,0,3136,3136,18.9
80192,Chipilly,166,0,22,22,0.1
80352,Frémontiers,166,0,229,229,1.4
81270,Saint-Sernin-lès-Lavaur,166,0,185,185,1.1
89267,Montréal,166,600,801,1401,8.4
2736,Tartiers,165,0,159,159,1
3206,La Petite-Marche,165,0,3884,3884,23.5
5157,Saint-Véran,165,0,5364,5364,32.5
8243,Lalobbe,165,0,3619,3619,21.9
9044,Baulou,165,0,4435,4435,26.9
9052,Besset,165,0,3418,3418,20.7
9313,Tourtouse,165,0,19995,19995,121.2
12010,Arques,165,0,2974,2974,18
12038,Brousse-le-Château,165,0,2964,2964,18
12078,Les Costes-Gozon,165,0,2964,2964,18
14645,Saint-Pierre-Azif,165,0,13060,13060,79.2
16161,Guizengeard,165,0,8823,8823,53.5
23207,Saint-Léger-Bridereix,165,0,3123,3123,18.9
23230,Saint-Pierre-Chérignat,165,0,5174,5174,31.4
24128,Comberanche-et-Épeluche,165,4310,1253,5563,33.7
24163,Étouars,165,1500,1106,2606,15.8
25009,Aïssey,165,0,8225,8225,49.8
27371,Livet-sur-Authou,165,0,711,711,4.3
39208,Entre-deux-Monts,165,570,1671,2241,13.6
39329,Mièges,165,1650,1671,3321,20.1
41014,Beauchêne,165,0,4928,4928,29.9
43204,Saint-Julien-Molhesabate,165,0,1321,1321,8
46047,Calès,165,0,5383,5383,32.6
46115,Frayssinhes,165,0,5383,5383,32.6
47158,Marmont-Pachas,165,0,3777,3777,22.9
50207,Golleville,165,290,5190,5480,33.2
51001,Ablancourt,165,0,2603,2603,15.8
58023,Bazoches,165,0,1944,1944,11.8
62116,Bernieulles,165,0,1755,1755,10.6
62877,Warlincourt-lès-Pas,165,0,1371,1371,8.3
63408,Sauret-Besserve,165,0,256,256,1.6
64449,Poey-d'Oloron,165,0,3553,3553,21.5
64528,Suhescun,165,0,4288,4288,26
68229,Murbach,165,1860,4072,5932,36
70500,Thieffrans,165,0,528,528,3.2
72354,Thoigné,165,0,3060,3060,18.5
78302,La Hauteville,165,0,1654,1654,10
79018,Aubigné,165,0,4765,4765,28.9
80106,Blangy-sous-Poix,165,0,228,228,1.4
80329,Forceville,165,0,184,184,1.1
80577,Moyencourt-lès-Poix,165,0,228,228,1.4
81027,Belleserre,165,0,3354,3354,20.3
88017,Aulnois,165,0,58,58,0.4
88514,Viocourt,165,0,1843,1843,11.2
1110,Colomieu,164,0,1828,1828,11.1
1234,Marignieu,164,0,1828,1828,11.1
1329,Rossillon,164,0,1828,1828,11.1
2327,Foreste,164,0,1486,1486,9.1
8226,Hierges,164,0,1053,1053,6.4
8240,Justine-Herbigny,164,0,3597,3597,21.9
9219,Orgibet,164,0,19873,19873,121.2
11026,Baraigne,164,0,1441,1441,8.8
14141,Castillon-en-Auge,164,0,1826,1826,11.1
14426,Le Mesnil-sur-Blangy,164,0,2636,2636,16.1
15237,Tiviers,164,1270,3627,4897,29.9
16275,Ranville-Breuillaud,164,2652,2062,4714,28.7
17092,Chartuzac,164,0,1936,1936,11.8
17417,Salignac-de-Mirambeau,164,0,1936,1936,11.8
21288,Frôlois,164,0,0,0,0
23226,Saint-Pardoux-d'Arnet,164,0,2153,2153,13.1
23262,Vigeville,164,0,2465,2465,15
25192,Dampjoux,164,0,10382,10382,63.3
26240,Plan-de-Baix,164,0,1987,1987,12.1
28299,Les Pinthières,164,0,952,952,5.8
31158,Cuguron,164,0,3397,3397,20.7
31347,Molas,164,0,3397,3397,20.7
32343,Riguepeu,164,0,1193,1193,7.3
36212,Saulnay,164,0,813,813,5
38208,Lavars,164,0,4594,4594,28
39321,Menétru-le-Vignoble,164,750,4359,5109,31.2
39353,Montfleur,164,600,4773,5373,32.8
40033,Bélis,164,0,1290,1290,7.9
43055,Chaniat,164,0,8037,8037,49
43175,Saint-Cirgues,164,5390,1493,6883,42
46289,Saint-Pierre-Toirac,164,0,4843,4843,29.5
48123,Recoules-d'Aubrac,164,0,6061,6061,37
50190,Fontenay-sur-Mer,164,0,5159,5159,31.5
51589,Vanault-le-Châtel,164,0,962,962,5.9
55075,Brauvilliers,164,0,3206,3206,19.5
55197,Fresnes-au-Mont,164,0,2220,2220,13.5
55263,Kœur-la-Grande,164,0,2417,2417,14.7
58069,Chaumot,164,0,2550,2550,15.5
62449,Hesmond,164,0,2597,2597,15.8
64548,Uzan,164,0,2568,2568,15.7
65063,Barbazan-Dessus,164,0,1041,1041,6.3
70176,Corravillers,164,0,1886,1886,11.5
70314,Magnivray,164,0,158,158,1
71174,Dezize-lès-Maranges,164,0,713,713,4.3
71278,Marigny,164,1811,2635,4446,27.1
76144,Bretteville-Saint-Laurent,164,0,362,362,2.2
79089,Le Chillou,164,0,4194,4194,25.6
80064,Beaucourt-en-Santerre,164,0,1007,1007,6.1
80281,Ergnies,164,0,4061,4061,24.8
82061,Féneyrols,164,0,2319,2319,14.1
87206,Villefavard,164,2878,2791,5669,34.6
89315,Préhy,164,310,22,332,2
1214,Leyssard,163,0,6166,6166,37.8
3064,Château-sur-Allier,163,0,2194,2194,13.5
8046,Banogne-Recouvrance,163,0,3117,3117,19.1
8101,La Chapelle,163,0,3744,3744,23
10102,Colombé-la-Fosse,163,0,970,970,6
10213,Magnant,163,0,2845,2845,17.5
11435,Villerouge-Termenès,163,0,2208,2208,13.5
14179,Cordebugle,163,0,1814,1814,11.1
15107,Lorcières,163,2402,3605,6007,36.9
15129,Montboudif,163,2575,2514,5089,31.2
16059,Brettes,163,1570,3568,5138,31.5
16381,Theil-Rabier,163,1725,3568,5293,32.5
17012,Annezay,163,0,4540,4540,27.9
21153,Châtellenot,163,0,2477,2477,15.2
21523,Reulle-Vergy,163,0,782,782,4.8
23011,Aulon,163,0,903,903,5.5
23182,Saint-Avit-de-Tardes,163,0,6165,6165,37.8
24184,Florimont-Gaumier,163,0,279,279,1.7
24247,Lusignac,163,1494,1238,2732,16.8
25210,Échenans,163,650,10319,10969,67.3
25276,Gondenans-Montby,163,0,376,376,2.3
25297,Le Gratteris,163,0,0,0,0
25343,Longemaison,163,0,1925,1925,11.8
26308,Saint-Julien-en-Quint,163,3928,9063,12991,79.7
27671,Vannecrocq,163,0,2510,2510,15.4
28189,Guilleville,163,0,856,856,5.3
2B333,Vallecalle,163,0,985,985,6
32063,Bouzon-Gellenave,163,0,1632,1632,10
38406,Saint-Julien-de-l'Herms,163,0,4167,4167,25.6
41098,Gombergean,163,0,2016,2016,12.4
46315,Teyssieu,163,0,5318,5318,32.6
47089,Esclottes,163,0,8029,8029,49.3
48136,Saint-André-de-Lancize,163,0,8878,8878,54.5
51212,Dommartin-Lettrée,163,0,8285,8285,50.8
54200,Flirey,163,0,973,973,6
55304,Louppy-le-Château,163,0,2206,2206,13.5
55569,Villotte-devant-Louppy,163,0,2206,2206,13.5
57241,Fribourg,163,0,1061,1061,6.5
58263,Saint-Pierre-du-Mont,163,0,3410,3410,20.9
60496,Plainville,163,0,3676,3676,22.6
60659,Vaudancourt,163,1500,3579,5079,31.2
61219,La Lande-Saint-Siméon,163,0,4366,4366,26.8
62209,Canlers,163,0,9646,9646,59.2
65291,Lugagnan,163,0,1557,1557,9.6
70576,Vougécourt,163,0,493,493,3
80055,Barly,163,0,635,635,3.9
80191,Chilly,163,0,2950,2950,18.1
86093,Dercé,163,0,833,833,5.1
86270,Thollet,163,0,6593,6593,40.4
87052,La Croix-sur-Gartempe,163,0,2774,2774,17
1219,Lompnas,162,0,2765,2765,17.1
2375,Hautevesnes,162,0,3745,3745,23.1
7176,Planzolles,162,1475,11296,12771,78.8
8117,Chesnois-Auboncourt,162,0,3553,3553,21.9
8323,La Neuville-lès-Wasigny,162,0,3553,3553,21.9
9095,Cescau,162,0,19631,19631,121.2
9309,Teilhet,162,0,3356,3356,20.7
10040,Bernon,162,0,3016,3016,18.6
11036,Belvis,162,0,1780,1780,11
17402,Saint-Sigismond-de-Clermont,162,0,1913,1913,11.8
19114,Lignareix,162,0,2221,2221,13.7
21208,Courtivron,162,0,2306,2306,14.2
23190,Saint-Domet,162,0,2127,2127,13.1
25324,Lanans,162,0,4466,4466,27.6
26055,Boulc,162,2433,9007,11440,70.6
27420,Mouflaines,162,0,132,132,0.8
28418,Villiers-Saint-Orien,162,0,298,298,1.8
2A282,Soccia,162,0,746,746,4.6
2B257,Rapale,162,0,979,979,6
32126,Estampes,162,0,359,359,2.2
32272,Monlaur-Bernet,162,0,1912,1912,11.8
32273,Monlezun,162,0,2986,2986,18.4
32435,Sirac,162,0,611,611,3.8
32455,Troncens,162,0,2986,2986,18.4
39584,Vriange,162,1050,3288,4338,26.8
40007,Argelos,162,0,440,440,2.7
50208,Gonfreville,162,0,3385,3385,20.9
51620,Vienne-la-Ville,162,0,2405,2405,14.8
52355,Noidant-le-Rocheux,162,0,743,743,4.6
53256,Saint-Thomas-de-Courceriers,162,0,1159,1159,7.2
54477,Saint-Julien-lès-Gorze,162,0,967,967,6
58199,Onlay,162,0,1909,1909,11.8
59066,Bérelles,162,0,1283,1283,7.9
60144,Chavençon,162,0,521,521,3.2
60457,La Neuville-Saint-Pierre,162,0,3653,3653,22.5
60699,Wambez,162,0,795,795,4.9
61069,Cahan,162,600,4339,4939,30.5
61187,Les Genettes,162,490,1670,2160,13.3
61350,La Roche-Mabile,162,670,4788,5458,33.7
63431,Thiolières,162,0,1464,1464,9
64379,Mendive,162,0,4210,4210,26
64455,Portet,162,0,2537,2537,15.7
64555,Viellenave-de-Navarrenx,162,0,3386,3386,20.9
65149,Clarac,162,0,1029,1029,6.4
65269,Lescurry,162,0,3659,3659,22.6
70057,Bay,162,0,109,109,0.7
71254,Lays-sur-le-Doubs,162,0,20,20,0.1
76077,Bénesville,162,0,357,357,2.2
76172,La Chapelle-sur-Dun,162,0,1049,1049,6.5
80300,Falvy,162,0,3088,3088,19.1
80347,Fransart,162,0,2932,2932,18.1
80439,Heuzecourt,162,0,631,631,3.9
80737,Sorel,162,0,1161,1161,7.2
82081,Labourgade,162,0,2081,2081,12.8
87084,Lavignac,162,401,2196,2597,16
88055,Bettegney-Saint-Brice,162,0,2328,2328,14.4
89458,Villenavotte,162,550,30,580,3.6
2642,Résigny,161,0,1774,1774,11
8005,Alincourt,161,0,3079,3079,19.1
10048,Bligny,161,0,0,0,0
15015,Auzers,161,9130,3045,12175,75.6
15050,Le Claux,161,2900,2483,5383,33.4
16405,Vignolles,161,0,8609,8609,53.5
17281,Polignac,161,0,1901,1901,11.8
23138,Moutier-d'Ahun,161,0,5048,5048,31.4
25251,Fourbanne,161,0,8025,8025,49.8
27019,Armentières-sur-Avre,161,1100,4528,5628,35
27462,Le Planquay,161,0,2479,2479,15.4
30119,Fressac,161,0,335,335,2.1
31137,Cessales,161,0,785,785,4.9
32196,Larroque-Saint-Sernin,161,0,619,619,3.8
32215,Loubersan,161,0,356,356,2.2
38207,Lavaldens,161,0,1686,1686,10.5
39244,Frontenay,161,2552,4279,6831,42.4
41026,Brévainville,161,0,818,818,5.1
41057,Conan,161,0,485,485,3
52208,Fresnes-sur-Apance,161,0,3175,3175,19.7
52520,Vicq,161,0,3175,3175,19.7
53184,Préaux,161,0,967,967,6
54195,Flainval,161,0,2414,2414,15
55027,Bannoncourt,161,0,2373,2373,14.7
55083,Brouennes,161,0,5822,5822,36.2
58025,Béard,161,0,415,415,2.6
58080,La Collancelle,161,0,2504,2504,15.6
58129,Gouloux,161,0,1897,1897,11.8
58292,Tintury,161,0,8305,8305,51.6
59045,Baives,161,0,2641,2641,16.4
62436,Herlin-le-Sec,161,0,3478,3478,21.6
62790,Senlis,161,0,9527,9527,59.2
70146,Chaux-lès-Port,161,0,956,956,5.9
70470,Sainte-Marie-en-Chaux,161,0,596,596,3.7
71262,Longepierre,161,1185,1858,3043,18.9
77207,Gironville,161,0,170,170,1.1
81136,Larroque,161,0,8846,8846,54.9
81141,Lédas-et-Penthiès,161,0,4975,4975,30.9
87130,Roziers-Saint-Georges,161,0,75,75,0.5
2333,Fresnes-sous-Coucy,160,0,158,158,1
2488,Molain,160,0,882,882,5.5
2814,Villers-lès-Guise,160,0,882,882,5.5
8135,La Croix-aux-Bois,160,0,3871,3871,24.2
9220,Orlu,160,0,23043,23043,144
9307,Taurignan-Castet,160,0,19389,19389,121.2
10175,Jasseines,160,0,3378,3378,21.1
10177,Javernant,160,0,2285,2285,14.3
10197,Lignol-le-Château,160,0,0,0,0
10221,Maizières-lès-Brienne,160,0,3378,3378,21.1
10284,Périgny-la-Rose,160,0,989,989,6.2
10326,Rosnay-l'Hôpital,160,0,3378,3378,21.1
11297,Pradelles-Cabardès,160,0,2067,2067,12.9
11364,Saint-Polycarpe,160,0,2106,2106,13.2
14122,La Caine,160,0,283,283,1.8
14375,Les Loges-Saulces,160,0,2506,2506,15.7
14385,Magny-en-Bessin,160,0,6167,6167,38.5
15022,Bonnac,160,2045,36,2081,13
17259,Neulles,160,0,1889,1889,11.8
21180,Cléry,160,0,0,0,0
21510,Prusly-sur-Ource,160,0,2669,2669,16.7
21620,Tarsul,160,0,2277,2277,14.2
23200,Saint-Goussaud,160,0,886,886,5.5
24476,Saint-Pantaly-d'Excideuil,160,160,2012,2172,13.6
25470,La Prétière,160,0,369,369,2.3
28255,Moinville-la-Jeulin,160,0,4662,4662,29.1
2B030,Barrettali,160,0,5868,5868,36.7
30242,Saint-Christol-de-Rodières,160,0,2335,2335,14.6
33443,Saint-Martin-de-Lerm,160,0,1589,1589,9.9
37190,Pussigny,160,0,4341,4341,27.1
39094,Chamole,160,4184,3539,7723,48.3
41041,La Chapelle-Vicomtesse,160,0,813,813,5.1
46090,Durbans,160,0,4725,4725,29.5
48112,Pierrefiche,160,720,1884,2604,16.3
51465,Romery,160,0,232,232,1.4
52110,Charmes-la-Grande,160,0,593,593,3.7
54541,Valhey,160,0,2399,2399,15
55024,Azannes-et-Soumazannes,160,0,2924,2924,18.3
57118,Budling,160,0,1025,1025,6.4
58001,Achun,160,0,8253,8253,51.6
60121,Campagne,160,0,0,0,0
61087,Champeaux-sur-Sarthe,160,1165,562,1727,10.8
61446,Saint-Pierre-des-Loges,160,940,1157,2097,13.1
70203,La Demie,160,0,512,512,3.2
70503,Traitiéfontaine,160,0,1340,1340,8.4
71374,Rosey,160,0,2454,2454,15.3
72250,Rahay,160,0,2163,2163,13.5
72342,Souvigné-sur-Même,160,0,976,976,6.1
76265,Flamets-Frétils,160,0,3738,3738,23.4
78237,Flins-Neuve-Église,160,0,1604,1604,10
82122,Montbarla,160,0,5009,5009,31.3
88030,Bainville-aux-Saules,160,0,2299,2299,14.4
89262,Molosmes,160,740,372,1112,7
1191,Izenave,159,0,6015,6015,37.8
2175,Chavigny,159,0,1330,1330,8.4
2221,Coupru,159,0,87,87,0.5
2255,Cys-la-Commune,159,0,314,314,2
2270,Douchy,159,0,1441,1441,9.1
6055,Duranus,159,0,3130,3130,19.7
7032,Berzème,159,0,4932,4932,31
7123,Lachapelle-sous-Chanéac,159,0,3400,3400,21.4
14661,Saint-Vaast-sur-Seulles,159,0,1949,1949,12.3
16413,Villiers-le-Roux,159,740,3480,4220,26.5
17468,Vibrac,159,0,1877,1877,11.8
23040,La Celle-sous-Gouzon,159,0,2390,2390,15
25238,Fessevillers,159,0,1108,1108,7
28136,Écluzelles,159,0,213,213,1.3
31275,Laréole,159,0,1330,1330,8.4
32025,Ayzieu,159,0,0,0,0
32041,Bellegarde,159,0,1877,1877,11.8
32104,Clermont-Pouyguillès,159,0,352,352,2.2
32235,Margouët-Meymes,159,0,1592,1592,10
32320,Plieux,159,0,90,90,0.6
32336,Puylausic,159,0,992,992,6.2
33446,Saint-Martin-du-Puy,159,0,1579,1579,9.9
37101,Épeigné-sur-Dême,159,0,1765,1765,11.1
39041,Baume-les-Messieurs,159,1000,5011,6011,37.8
39373,Les Moussières,159,1642,585,2227,14
42084,Débats-Rivière-d'Orpra,159,0,1425,1425,9
47087,Engayrac,159,0,3640,3640,22.9
48068,Gabrias,159,0,3791,3791,23.8
51304,Janvilliers,159,0,5108,5108,32.1
51376,Montgenost,159,0,2075,2075,13.1
51584,Trois-Puits,159,0,2826,2826,17.8
54009,Allamont,159,0,1476,1476,9.3
54203,Forcelles-Saint-Gorgon,159,0,0,0,0
54436,Preutin-Higny,159,0,701,701,4.4
54553,Vaudeville,159,0,0,0,0
54573,Villers-en-Haye,159,0,1737,1737,10.9
55312,Maizey,159,0,2343,2343,14.7
57383,Languimberg,159,0,1035,1035,6.5
57749,Vœlfling-lès-Bouzonville,159,0,958,958,6
58173,Montaron,159,0,8201,8201,51.6
60014,Angivillers,159,0,881,881,5.5
60335,Lachapelle-sous-Gerberoy,159,0,780,780,4.9
61295,La Motte-Fouquet,159,0,715,715,4.5
61438,Saint-Ouen-de-Sécherouvre,159,630,558,1188,7.5
62142,Blingel,159,0,2517,2517,15.8
63007,Apchat,159,0,1034,1034,6.5
63024,Avèze,159,6250,498,6748,42.4
64002,Abère,159,0,1660,1660,10.4
64173,Casteide-Doat,159,0,3592,3592,22.6
64474,Saint-Dos,159,0,3324,3324,20.9
65404,Sariac-Magnoac,159,0,5151,5151,32.4
65412,Sauveterre,159,0,3592,3592,22.6
67244,Kleingœft,159,750,11215,11965,75.3
70372,Montureux-lès-Baulay,159,0,944,944,5.9
70580,Vy-le-Ferroux,159,0,408,408,2.6
72188,Marollette,159,0,2948,2948,18.5
78231,Favrieux,159,0,1480,1480,9.3
80231,Curlu,159,0,178,178,1.1
80283,Esclainvillers,159,0,977,977,6.1
80327,Fontaine-sur-Maye,159,0,3937,3937,24.8
80403,Guyencourt-sur-Noye,159,0,977,977,6.1
81056,Campagnac,159,0,8736,8736,54.9
88499,Velotte-et-Tatignécourt,159,0,2285,2285,14.4
89132,Cry,159,2690,369,3059,19.2
89333,Saint-André-en-Terre-Plaine,159,0,768,768,4.8
3075,Chezelle,158,0,3232,3232,20.5
3089,Coutansouze,158,0,3232,3232,20.5
3192,Nades,158,0,3232,3232,20.5
4026,Bellaffaire,158,900,4710,5610,35.5
5129,Saint-André-de-Rosans,158,0,4710,4710,29.8
5163,Le Sauze-du-Lac,158,0,12626,12626,79.9
7006,Albon-d'Ardèche,158,1925,3378,5303,33.6
9340,Vira,158,0,4247,4247,26.9
10318,Rigny-la-Nonneuse,158,0,0,0,0
11125,Embres-et-Castelmaure,158,0,243,243,1.5
14302,Glanville,158,0,2539,2539,16.1
16063,Brie-sous-Chalais,158,2950,7430,10380,65.7
21495,Pont,158,0,0,0,0
21613,Soussey-sur-Brionne,158,0,3355,3355,21.2
24426,Saint-Jean-d'Estissac,158,1125,7566,8691,55
25521,Saint-Julien-lès-Montbéliard,158,1031,10002,11033,69.8
31043,Balesta,158,0,3273,3273,20.7
32439,Tarsac,158,0,1582,1582,10
43063,Chassagnes,158,0,1439,1439,9.1
43193,Saint-Hilaire,158,1540,1770,3310,20.9
46131,Grèzes,158,0,4666,4666,29.5
47063,Cavarc,158,0,4034,4034,25.5
47224,Romestaing,158,0,2666,2666,16.9
50300,Le Mesnil-Adelée,158,0,3887,3887,24.6
51463,Les Rivières-Henruel,158,0,2492,2492,15.8
52126,Choilley-Dardenay,158,0,1957,1957,12.4
54532,Tremblecourt,158,0,330,330,2.1
60267,Le Gallet,158,0,3563,3563,22.6
62256,Crépy,158,0,9350,9350,59.2
64143,Bouillon,158,0,2474,2474,15.7
65197,Ger,158,0,1509,1509,9.6
65373,Puntous,158,0,5118,5118,32.4
65397,Saint-Sever-de-Rustan,158,0,3569,3569,22.6
66111,Montalba-le-Château,158,0,213,213,1.3
70036,Aulx-lès-Cromary,158,0,1323,1323,8.4
70480,Sauvigney-lès-Pesmes,158,0,797,797,5
77212,Gravon,158,7766,2238,10004,63.3
77230,Ichy,158,0,166,166,1.1
80117,Bouchon,158,0,272,272,1.7
80218,Courcelles-sous-Moyencourt,158,0,218,218,1.4
80346,Franqueville,158,0,272,272,1.7
80353,Fresnes-Mazancourt,158,0,2860,2860,18.1
80470,Léalvillers,158,0,177,177,1.1
80805,Villers-Tournelle,158,0,191,191,1.2
88504,Vicherey,158,0,5239,5239,33.2
3249,Saint-Palais,157,0,639,639,4.1
8189,Girondelle,157,0,4104,4104,26.1
9203,Montels,157,0,19025,19025,121.2
9296,Aulos-Sinsat,157,2929,22611,25540,162.7
10029,Balnot-sur-Laignes,157,0,2741,2741,17.5
10144,Étrelles-sur-Aube,157,0,161,161,1
11423,Villefloure,157,0,1018,1018,6.5
12236,Saint-Laurent-de-Lévézou,157,0,1113,1113,7.1
14425,Le Mesnil-Simon,157,0,1748,1748,11.1
15052,Collandres,157,3995,2421,6416,40.9
21280,Fontangy,157,0,3334,3334,21.2
21431,Montigny-sur-Armançon,157,0,3334,3334,21.2
24375,Saint-Aubin-de-Nabirat,157,2130,269,2399,15.3
26310,Saint-Laurent-d'Onay,157,0,3183,3183,20.3
27482,La Pyle,157,0,675,675,4.3
2A133,Guitera-les-Bains,157,0,118,118,0.8
30022,Aujac,157,0,4907,4907,31.3
30105,Dourbies,157,0,7854,7854,50
31577,Vignaux,157,0,1313,1313,8.4
32024,Ayguetinte,157,0,5532,5532,35.2
32244,Maulichères,157,0,1572,1572,10
43129,Le Mas-de-Tence,157,1750,3596,5346,34.1
47080,Dévillac,157,0,4009,4009,25.5
47250,Saint-Léger,157,0,1508,1508,9.6
50521,Saint-Maur-des-Bois,157,0,2653,2653,16.9
52082,Bugnières,157,0,861,861,5.5
54475,Saint-Germain,157,0,649,649,4.1
55088,Burey-en-Vaux,157,0,634,634,4
57229,Foulcrey,157,0,1022,1022,6.5
57519,Obervisse,157,0,946,946,6
60179,Crèvecœur-le-Petit,157,0,870,870,5.5
60258,Fresnières,157,0,1373,1373,8.7
61251,Marchemaisons,157,1680,55,1735,11.1
61265,Ménil-Gondouin,157,0,896,896,5.7
61349,Ri,157,0,332,332,2.1
61479,Tanques,157,2430,332,2762,17.6
62175,Brévillers,157,0,2486,2486,15.8
62472,Inxent,157,0,1670,1670,10.6
64212,Espéchède,157,0,1639,1639,10.4
67148,Frohmuhl,157,2140,4231,6371,40.6
67503,Uttwiller,157,1679,4231,5910,37.6
68370,Wildenstein,157,0,1631,1631,10.4
77102,Châtenoy,157,0,80,80,0.5
79153,Loubigné,157,0,4534,4534,28.9
80045,Authuille,157,0,176,176,1.1
80307,Feuillères,157,0,1125,1125,7.2
80343,Framicourt,157,0,217,217,1.4
80708,Saint-Mard,157,0,190,190,1.2
87189,Les Salles-Lavauguyon,157,1082,3434,4516,28.8
89447,Vézinnes,157,0,365,365,2.3
97358,Saint-Élie,157,0,1289,1289,8.2
2415,Laversine,156,0,150,150,1
2784,Petit-Verly,156,0,860,860,5.5
4062,La Condamine-Châtelard,156,2500,46589,49089,314.7
4204,Senez,156,12766,5516,18282,117.2
7074,Creysseilles,156,0,521,521,3.3
8460,Tremblois-lès-Rocroi,156,0,2429,2429,15.6
9341,Viviès,156,0,3231,3231,20.7
10021,Avant-lès-Ramerupt,156,0,580,580,3.7
10269,Nozay,156,0,133,133,0.9
10293,Poivres,156,0,133,133,0.9
10376,Thieffrain,156,0,2723,2723,17.5
18095,Flavigny,156,0,305,305,2
21042,Bagnot,156,0,1170,1170,7.5
21219,Curtil-Vergy,156,0,748,748,4.8
21246,Épernay-sous-Gevrey,156,0,748,748,4.8
21665,Vernois-lès-Vesvres,156,0,108,108,0.7
25354,Luxiol,156,0,7776,7776,49.8
27006,Aizier,156,0,639,639,4.1
27604,Saint-Sulpice-de-Grimbouville,156,0,1166,1166,7.5
2B138,Lavatoggio,156,0,0,0,0
30094,Corbès,156,0,0,0,0
32108,Corneillan,156,0,4884,4884,31.3
32216,Lourties-Monbrun,156,0,1841,1841,11.8
32329,Préchac,156,0,89,89,0.6
38047,Blandin,156,0,1368,1368,8.8
39424,Les Planches-en-Montagne,156,2350,1579,3929,25.2
45044,Bougy-lez-Neuville,156,0,481,481,3.1
47255,Saint-Martin-de-Beauville,156,0,3571,3571,22.9
47296,Ségalas,156,0,2905,2905,18.6
48029,Le Born,156,2094,6154,8248,52.9
50390,Ozeville,156,0,4907,4907,31.5
51060,Bignicourt-sur-Saulx,156,0,915,915,5.9
51167,Coole,156,0,2461,2461,15.8
51356,Matignicourt-Goncourt,156,0,969,969,6.2
52023,Auberive,156,0,1932,1932,12.4
52187,Épizon,156,0,578,578,3.7
52400,Le Châtelet-sur-Meuse,156,0,3077,3077,19.7
52431,Rochetaillée,156,0,1932,1932,12.4
54141,Coyviller,156,0,1241,1241,8
54455,Remenoville,156,0,645,645,4.1
55047,Béthelainville,156,0,9669,9669,62
55246,Hévilliers,156,0,3049,3049,19.5
55368,Naives-en-Blois,156,0,630,630,4
58099,Dommartin,156,0,1838,1838,11.8
61142,Dame-Marie,156,0,1811,1811,11.6
61162,La Ferrière-au-Doyen,156,922,1608,2530,16.2
62600,Nédon,156,0,3370,3370,21.6
62629,Noyellette,156,0,1296,1296,8.3
62777,Le Sars,156,0,776,776,5
62818,Tilly-Capelle,156,0,3370,3370,21.6
63114,Collanges,156,0,1014,1014,6.5
63145,Égliseneuve-des-Liards,156,0,1014,1014,6.5
64115,Berrogain-Laruns,156,0,4054,4054,26
64144,Boumourt,156,0,4200,4200,26.9
64517,Séméacq-Blachon,156,0,1628,1628,10.4
66100,Llo,156,0,0,0,0
67241,Kirrberg,156,0,1956,1956,12.5
68114,Guevenatten,156,0,2221,2221,14.2
69192,Saint-Cyr-le-Chatoux,156,0,3312,3312,21.2
70505,Le Tremblois,156,0,787,787,5
70522,Varogne,156,0,926,926,5.9
70535,Velleguindry-et-Levrecey,156,0,401,401,2.6
71487,Saint-Vérand,156,780,3985,4765,30.5
76233,Ellecourt,156,0,3,3,0
76323,Graval,156,0,3644,3644,23.4
79352,Villiers-sur-Chizé,156,0,4505,4505,28.9
81252,Saint-Germier,156,0,1457,1457,9.3
88156,Doncières,156,0,778,778,5
89112,Collan,156,750,362,1112,7.1
89224,Lichères-près-Aigremont,156,1100,21,1121,7.2
2509,Monthiers,155,0,3583,3583,23.1
2743,Le Thuel,155,0,1708,1708,11
2792,Veuilly-la-Poterie,155,0,84,84,0.5
8172,Fligny,155,0,4052,4052,26.1
10103,Colombé-le-Sec,155,0,0,0,0
10242,Meurville,155,0,0,0,0
14362,Lessard-et-le-Chêne,155,0,1725,1725,11.1
15078,Jabrun,155,1430,3428,4858,31.3
15080,Joursac,155,722,35,757,4.9
16248,Oradour,155,5400,1949,7349,47.4
17213,Lozay,155,0,4317,4317,27.9
21490,Poiseul-la-Ville-et-Laperrière,155,0,2586,2586,16.7
21576,Saint-Thibault,155,0,3291,3291,21.2
24290,Montferrand-du-Périgord,155,1980,563,2543,16.4
25518,Saint-Hilaire,155,0,7726,7726,49.8
27304,Guerny,155,0,126,126,0.8
32359,Saint-Antonin,155,0,585,585,3.8
32407,Saint-Soulan,155,0,967,967,6.2
36106,Luzeret,155,0,852,852,5.5
39050,Besain,155,100,3428,3528,22.8
41193,Romilly,155,0,787,787,5.1
50628,Vernix,155,0,3814,3814,24.6
52132,Clefmont,155,0,711,711,4.6
52206,Frampas,155,0,1404,1404,9.1
53068,Chérancé,155,0,1026,1026,6.6
54053,Bauzemont,155,0,2324,2324,15
54298,Laneuveville-derrière-Foug,155,0,323,323,2.1
55113,Cheppy,155,0,1621,1621,10.5
57308,Hazembourg,155,0,2118,2118,13.7
57513,Nousseviller-lès-Bitche,155,0,3572,3572,23
58045,La Celle-sur-Nièvre,155,0,8748,8748,56.4
58221,Rémilly,155,0,7995,7995,51.6
62462,Huclier,155,0,3348,3348,21.6
64128,Bilhères,155,0,1967,1967,12.7
64303,Laguinge-Restoue,155,0,4028,4028,26
64506,Sarrance,155,0,3338,3338,21.5
65087,Bertren,155,0,1014,1014,6.5
70022,Angirey,155,0,701,701,4.5
70558,La Villeneuve-Bellenoye-et-la-Maize,155,0,921,921,5.9
70562,Villers-la-Ville,155,0,49,49,0.3
73092,Corbel,155,0,10613,10613,68.5
73233,Saint-Franc,155,0,10613,10613,68.5
76066,Beautot,155,0,1251,1251,8.1
76426,Mésangueville,155,0,2928,2928,18.9
81086,Espérausses,155,0,2742,2742,17.7
81320,Vindrac-Alayrac,155,0,3944,3944,25.4
2076,Bertricourt,154,0,414,414,2.7
2248,Cuirieux,154,0,776,776,5
2400,Laffaux,154,0,304,304,2
2834,Wissignicourt,154,0,152,152,1
5154,Saint-Pierre-d'Argençon,154,0,5763,5763,37.4
6102,Rimplas,154,0,3032,3032,19.7
9338,Villeneuve-du-Latou,154,0,2739,2739,17.8
10139,Épothémont,154,0,917,917,6
11228,Mazerolles-du-Razès,154,0,2027,2027,13.2
11300,Puginier,154,0,1353,1353,8.8
14284,Fourneaux-le-Val,154,0,2412,2412,15.7
14500,Pierrefitte-en-Auge,154,0,2475,2475,16.1
15123,Méallet,154,3350,2913,6263,40.7
15200,Saint-Martin-Cantalès,154,0,2550,2550,16.6
16157,Le Grand-Madieu,154,251,3168,3419,22.2
18046,Chambon,154,0,2788,2788,18.1
18183,Le Pondy,154,694,1434,2128,13.8
21114,Buffon,154,0,3000,3000,19.5
21287,Fresnes,154,0,3000,3000,19.5
21520,Remilly-en-Montagne,154,0,866,866,5.6
22126,Le Leslay,154,0,2442,2442,15.9
23252,Tercillat,154,0,414,414,2.7
24063,Bouzic,154,6910,264,7174,46.6
24221,Rudeau-Ladosse,154,20,2170,2190,14.2
27235,Faverolles-la-Campagne,154,0,1370,1370,8.9
27505,Saint-Agnan-de-Cernières,154,0,664,664,4.3
2B046,Cagnano,154,0,5648,5648,36.7
2B233,Pino,154,0,5648,5648,36.7
32353,Sabaillan,154,0,961,961,6.2
37103,Esves-le-Moutier,154,0,2673,2673,17.4
39038,Barésia-sur-l'Ain,154,0,4482,4482,29.1
39058,Blye,154,350,4482,4832,31.4
39408,Patornay,154,660,4482,5142,33.4
40027,Bassercles,154,0,418,418,2.7
43231,Salettes,154,0,854,854,5.5
45283,Saint-Hilaire-sur-Puiseaux,154,0,1579,1579,10.3
46257,Saint-Cirq-Madelon,154,0,4609,4609,29.9
50233,Hautteville-Bocage,154,0,4844,4844,31.5
52300,Magneux,154,0,1395,1395,9.1
53214,Saint-Erblon,154,164,1019,1183,7.7
54282,Joppécourt,154,0,678,678,4.4
54453,Rembercourt-sur-Mad,154,0,919,919,6
55355,Montzéville,154,0,9545,9545,62
55479,Seigneulles,154,0,2085,2085,13.5
58178,Montigny-sur-Canne,154,0,7944,7944,51.6
63421,Singles,154,0,482,482,3.1
64390,Moncaup,154,0,1608,1608,10.4
65367,Poumarous,154,0,978,978,6.4
66073,Estoher,154,0,4612,4612,29.9
67047,Bissert,154,1198,1931,3129,20.3
70303,Liévans,154,0,570,570,3.7
70448,Roche-et-Raucourt,154,0,790,790,5.1
76024,Ardouval,154,0,3597,3597,23.4
76645,Saint-Riquier-en-Rivière,154,0,3,3,0
77275,Les Marêts,154,0,555,555,3.6
80028,Arquèves,154,0,172,172,1.1
80073,Bécordel-Bécourt,154,0,172,172,1.1
80320,Folies,154,0,2787,2787,18.1
80469,Lawarde-Mauger-l'Hortoy,154,0,946,946,6.1
81199,Padiès,154,0,4758,4758,30.9
89042,Bierry-les-Belles-Fontaines,154,300,743,1043,6.8
89288,Paroy-en-Othe,154,0,995,995,6.5
2679,Saint-Gengoulph,153,0,3536,3536,23.1
3248,Saint-Nicolas-des-Biefs,153,0,4191,4191,27.4
8257,Logny-Bogny,153,0,4000,4000,26.1
14107,Bricqueville,153,0,1059,1059,6.9
14169,Colombiers-sur-Seulles,153,0,1876,1876,12.3
14180,Cordey,153,0,2397,2397,15.7
17199,Jussas,153,0,1807,1807,11.8
18063,Chavannes,153,0,2770,2770,18.1
21323,Jancigny,153,0,666,666,4.4
21456,Nogent-lès-Montbard,153,0,2980,2980,19.5
21598,Seigny,153,0,2980,2980,19.5
21716,Vougeot,153,0,734,734,4.8
24039,Besse,153,3720,262,3982,26
25038,Avilley,153,0,353,353,2.3
25270,Gevresin,153,0,3458,3458,22.6
26131,Eyzahut,153,0,5334,5334,34.9
28003,Allainville,153,0,205,205,1.3
28314,Les Ressuintes,153,0,2731,2731,17.8
2A018,Arbellara,153,0,0,0,0
2B220,Piedigriggio,153,0,575,575,3.8
30064,Campestre-et-Luc,153,0,2468,2468,16.1
34137,Liausson,153,0,174,174,1.1
35325,La Selle-Guerchaise,153,0,2299,2299,15
38040,Besse,153,0,8702,8702,56.9
39116,La Châtelaine,153,0,3384,3384,22.1
43005,Alleyras,153,4462,742,5204,34
43083,Cubelles,153,0,1393,1393,9.1
50006,Amigny,153,0,2263,2263,14.8
50511,Saint-Martin-d'Audouville,153,0,4813,4813,31.5
54108,Burthecourt-aux-Chênes,153,0,1218,1218,8
55134,Couvonges,153,0,3396,3396,22.2
58222,Rix,153,0,3201,3201,20.9
60512,Pouilly,153,0,492,492,3.2
61256,Médavy,153,0,960,960,6.3
62219,Caumont,153,0,2422,2422,15.8
63256,Novacelles,153,1050,1383,2433,15.9
65112,Bun,153,0,6265,6265,40.9
70401,Ovanches,153,0,393,393,2.6
72040,La Bosse,153,0,933,933,6.1
74107,Droisy,153,0,3696,3696,24.2
80049,Ayencourt,153,0,185,185,1.2
80193,Chirmont,153,0,940,940,6.1
80339,Fouquescourt,153,0,2769,2769,18.1
80526,Le Meillard,153,0,596,596,3.9
80676,Roiglise,153,0,185,185,1.2
88053,Belval,153,0,1488,1488,9.7
88432,Saint-Pierremont,153,0,763,763,5
88515,Vioménil,153,0,1189,1189,7.8
91248,La Forêt-Sainte-Croix,153,0,385,385,2.5
2459,Marcy,152,0,21724,21724,142.9
2655,Ronchères,152,0,3513,3513,23.1
3141,Lavoine,152,0,4164,4164,27.4
3209,Poëzat,152,0,3109,3109,20.5
8228,La Horgne,152,0,3334,3334,21.9
8412,Senuc,152,0,3678,3678,24.2
9074,Camon,152,0,3148,3148,20.7
9259,Saint-Félix-de-Tournegat,152,0,3148,3148,20.7
17367,Saint-Martin-de-Juillers,152,0,4234,4234,27.9
18014,Assigny,152,0,2738,2738,18
19018,Bassignac-le-Haut,152,0,451,451,3
19119,Lostanges,152,0,766,766,5
21260,Fain-lès-Moutiers,152,0,2961,2961,19.5
21394,Massingy-lès-Semur,152,0,3228,3228,21.2
23181,Saint-Amand-Jartoudeix,152,0,4766,4766,31.4
23216,Saint-Martin-Château,152,0,4766,4766,31.4
26021,Autichamp,152,700,1841,2541,16.7
26027,Barsac,152,2130,8451,10581,69.6
28231,La Mancelière,152,0,203,203,1.3
28272,Mottereau,152,0,562,562,3.7
2A115,Foce,152,0,0,0,0
2B080,Castifao,152,0,572,572,3.8
2B136,Lama,152,0,2133,2133,14
30108,L'Estréchure,152,0,7604,7604,50
32153,Haulies,152,0,1794,1794,11.8
34196,Pégairolles-de-l'Escalette,152,0,1707,1707,11.2
51406,Norrois,152,0,944,944,6.2
51499,Saint-Mard-lès-Rouffy,152,0,3021,3021,19.9
51555,Soudé,152,0,7726,7726,50.8
52128,Cirey-lès-Mareilles,152,0,2339,2339,15.4
53069,Chevaigné-du-Maine,152,0,1352,1352,8.9
54450,Reherrey,152,0,672,672,4.4
54460,Rogéville,152,0,1661,1661,10.9
55317,Manheulles,152,0,1968,1968,12.9
57105,Boustroff,152,0,2595,2595,17.1
57421,Loutzviller,152,0,3503,3503,23
58038,Breugnon,152,0,3180,3180,20.9
58175,Mont-et-Marré,152,0,7840,7840,51.6
58239,Saint-Firmin,152,0,762,762,5
59494,Raucourt-au-Bois,152,0,429,429,2.8
62372,Givenchy-le-Noble,152,0,1263,1263,8.3
62374,Gomiécourt,152,0,756,756,5
62738,Sains-lès-Fressin,152,0,8995,8995,59.2
64176,Castetbon,152,0,3177,3177,20.9
64337,Lespielle,152,0,1587,1587,10.4
65151,Collongues,152,0,965,965,6.3
65413,Sazos,152,0,6224,6224,40.9
71183,Dracy-lès-Couches,152,0,3401,3401,22.4
80233,Dancourt-Popincourt,152,0,183,183,1.2
80440,Hiermont,152,0,593,593,3.9
82106,Maubec,152,0,3563,3563,23.4
82177,Sauveterre,152,0,4759,4759,31.3
88008,Anglemont,152,0,758,758,5
88193,Gemaingoutte,152,0,1478,1478,9.7
88528,Xamontarupt,152,0,199,199,1.3
89008,Angely,152,1750,734,2484,16.3
89310,La Postolle,152,1840,295,2135,14
7075,Cros-de-Géorand,151,5000,1181,6181,40.9
8075,Boult-aux-Bois,151,0,3654,3654,24.2
8377,Saint-Aignan,151,0,3469,3469,23
8439,Tannay,151,0,3654,3654,24.2
9051,Bénaix,151,0,1341,1341,8.9
9217,Niaux,151,0,583,583,3.9
11045,Bouriège,151,0,1988,1988,13.2
11128,Escueillens-et-Saint-Just-de-Bélengard,151,4150,1988,6138,40.6
14547,Rubercy,151,0,1045,1045,6.9
14586,Saint-Germain-du-Pert,151,0,1045,1045,6.9
16215,Médillac,151,630,7100,7730,51.2
19277,Valiergues,151,0,2070,2070,13.7
21093,Bouix,151,0,2519,2519,16.7
21379,Marcheseuil,151,0,4658,4658,30.8
23063,Clairavaux,151,0,2070,2070,13.7
23150,Peyrabout,151,0,2466,2466,16.3
23215,Saint-Martial-le-Vieux,151,0,2070,2070,13.7
24085,La Cassagne,151,0,2641,2641,17.5
24377,Saint-Avit-de-Vialard,151,3100,2096,5196,34.4
25359,Malans,151,0,1100,1100,7.3
2B356,Zalana,151,0,1150,1150,7.6
31251,Labastide-Paumès,151,0,3128,3128,20.7
34230,Les Rives,151,480,1696,2176,14.4
36036,Chalais,151,0,3045,3045,20.2
36167,Preuilly-la-Ville,151,0,830,830,5.5
36181,Saint-Aubin,151,0,3067,3067,20.3
38285,Ornon,151,5725,8589,14314,94.8
39467,Rotalier,151,920,2302,3222,21.3
41195,Rougeou,151,0,2775,2775,18.4
46236,Reilhaguet,151,0,4926,4926,32.6
48083,Les Laubies,151,1060,1778,2838,18.8
51006,Alliancelles,151,0,886,886,5.9
51577,Tramery,151,0,2684,2684,17.8
52388,Pierremont-sur-Amance,151,0,2978,2978,19.7
52472,Sexfontaines,151,0,16586,16586,109.8
54377,Montigny,151,0,536,536,3.5
54489,Saint-Supplet,151,0,1917,1917,12.7
55252,Iré-le-Sec,151,0,5398,5398,35.7
55464,Saint-Pierrevillers,151,0,2760,2760,18.3
58211,Poil,151,0,7789,7789,51.6
60371,Loueuse,151,0,741,741,4.9
60415,Montépilloy,151,0,0,0,0
60692,Villers-Vicomte,151,0,3405,3405,22.5
61276,Merri,151,0,319,319,2.1
62430,Hénu,151,0,1255,1255,8.3
65346,Oueilloux,151,0,959,959,6.4
70262,Genevreuille,151,0,6638,6638,44
76419,Mauny,151,0,619,619,4.1
77021,Barbey,151,0,107,107,0.7
77134,Courchamp,151,0,544,544,3.6
79349,Villemain,151,0,4361,4361,28.9
80080,Belloy-en-Santerre,151,0,2733,2733,18.1
80090,Berny-en-Santerre,151,0,2733,2733,18.1
80216,Courcelette,151,0,169,169,1.1
80496,Machiel,151,0,3739,3739,24.8
81019,Assac,151,0,4666,4666,30.9
88252,Jésonville,151,0,1174,1174,7.8
88496,Vaudoncourt,151,0,53,53,0.4
95295,Guiry-en-Vexin,151,0,6938,6938,45.9
1293,Peyriat,150,0,5674,5674,37.8
2269,Dorengt,150,0,2675,2675,17.8
3308,Vernusse,150,0,5359,5359,35.7
5019,La Beaume,150,0,5613,5613,37.4
8021,Arnicourt,150,0,2869,2869,19.1
8044,Balham,150,0,2869,2869,19.1
9249,Roquefixade,150,0,1332,1332,8.9
10172,Herbisse,150,0,128,128,0.9
11059,Cailhavel,150,5013,1975,6988,46.6
16252,Orival,150,380,7053,7433,49.6
19040,Champagnac-la-Prune,150,0,2846,2846,19
21102,Brazey-en-Morvan,150,0,4627,4627,30.8
21445,La Motte-Ternant,150,0,430,430,2.9
23158,Poussanges,150,0,2056,2056,13.7
23186,Saint-Christophe,150,0,2450,2450,16.3
23204,Saint-Julien-le-Châtel,150,0,2255,2255,15
23234,Saint-Priest,150,0,1969,1969,13.1
24474,Saint-Pancrace,150,0,2113,2113,14.1
25369,Marvelise,150,0,346,346,2.3
28333,Saint-Denis-des-Puits,150,0,555,555,3.7
29116,Lanneuffret,150,2785,1163,3948,26.3
2B260,Riventosa,150,0,2591,2591,17.3
31213,Garin,150,0,1436,1436,9.6
31564,Valcabrère,150,0,1436,1436,9.6
32043,Belmont,150,0,1091,1091,7.3
33129,Cleyrac,150,0,1490,1490,9.9
34093,Dio-et-Valquières,150,0,0,0,0
52229,Grenant,150,0,2958,2958,19.7
54478,Saint-Marcel,150,0,1393,1393,9.3
55008,Amel-sur-l'Étang,150,0,2741,2741,18.3
55419,Récicourt,150,0,1568,1568,10.5
61452,Saint-Roch-sur-Égrenne,150,0,1861,1861,12.4
62118,Béthonsart,150,0,1246,1246,8.3
62545,Maninghem,150,0,8876,8876,59.2
62806,Tardinghen,150,0,597,597,4
64272,Ilharre,150,0,3898,3898,26
64507,Saubole,150,0,1566,1566,10.4
65254,Laméac,150,0,3388,3388,22.6
65377,Réjaumont,150,0,448,448,3
66117,Mont-Louis,150,0,0,0,0
66123,Nyer,150,0,4493,4493,30
70210,Écromagny,150,0,1725,1725,11.5
71139,Collonge-en-Charollais,150,0,2301,2301,15.3
71411,Saint-Eugène,150,0,3356,3356,22.4
71455,Saint-Martin-du-Tartre,150,0,2301,2301,15.3
71473,Saint-Racho,150,930,2911,3841,25.6
76479,Nullemont,150,0,3,3,0
80145,Brucamps,150,0,3714,3714,24.8
80789,Vermandovillers,150,0,2715,2715,18.1
88335,Offroicourt,150,0,53,53,0.4
89019,Arthonnay,150,1500,348,1848,12.3
1101,Chevillard,149,0,5636,5636,37.8
2640,Renansart,149,0,0,0,0
8313,Nanteuil-sur-Aisne,149,0,2850,2850,19.1
8399,Sapogne-sur-Marche,149,0,5275,5275,35.4
10097,Chervey,149,0,2601,2601,17.5
16372,Souffrignac,149,801,2657,3458,23.2
24500,Saint-Sauveur-Lalande,149,250,1132,1382,9.3
26060,Bouvières,149,0,5194,5194,34.9
28091,Les Châtelliers-Notre-Dame,149,0,551,551,3.7
28157,Fontenay-sur-Conie,149,0,783,783,5.3
2A131,Guagno,149,0,686,686,4.6
2B250,Prunelli-di-Casacconi,149,0,690,690,4.6
31078,Boudrac,149,0,3086,3086,20.7
31441,Prunet,149,0,727,727,4.9
31527,La Salvetat-Lauragais,149,3213,727,3940,26.4
32185,Lalanne-Arqué,149,0,1759,1759,11.8
32315,Peyrusse-Grande,149,0,1083,1083,7.3
32445,Tieste-Uragnoux,149,0,2747,2747,18.4
39007,Alièze,149,100,4336,4436,29.8
41177,Le Plessis-Dorin,149,710,4450,5160,34.6
45079,Le Charme,149,0,1528,1528,10.3
45294,Saint-Michel,149,0,1129,1129,7.6
51176,Corroy,149,0,281,281,1.9
51386,Morsains,149,0,4787,4787,32.1
52108,Charmes,149,0,684,684,4.6
53261,Soucé,149,0,1965,1965,13.2
54258,Hénaménil,149,0,2234,2234,15
54307,Lebeuville,149,0,0,0,0
54308,Leintrey,149,0,529,529,3.6
57127,Chanville,149,0,5706,5706,38.3
58234,Saint-Bonnot,149,0,8409,8409,56.4
60306,Hécourt,149,770,731,1501,10.1
61114,Commeaux,149,0,315,315,2.1
61370,Saint-Brice,149,0,5034,5034,33.8
62862,Vincly,149,0,8817,8817,59.2
63079,Champagnat-le-Jeune,149,0,969,969,6.5
64281,Jasses,149,0,3115,3115,20.9
65211,Guchan,149,0,7163,7163,48.1
65393,Saint-Pastous,149,0,6101,6101,40.9
66075,Eyne,149,0,0,0,0
70019,Andelarre,149,0,7708,7708,51.7
70456,Ruhans,149,0,1248,1248,8.4
71474,Sainte-Radegonde,149,0,766,766,5.1
76011,Ancretteville-sur-Mer,149,0,967,967,6.5
76524,Reuville,149,0,328,328,2.2
80194,Chuignes,149,0,2697,2697,18.1
88363,Punerot,149,0,1665,1665,11.2
1117,Conzieu,148,0,1650,1650,11.1
2670,Saint-Algis,148,0,2639,2639,17.8
2803,La Ville-aux-Bois-lès-Pontavert,148,0,398,398,2.7
7277,Saint-Michel-de-Boulogne,148,720,2526,3246,21.9
8395,Saint-Pierre-sur-Vence,148,0,3246,3246,21.9
10421,La Villeneuve-au-Châtelot,148,0,915,915,6.2
11194,Lastours,148,0,1912,1912,12.9
16087,Chassiecq,148,1282,3045,4327,29.2
21164,Chazilly,148,0,2249,2249,15.2
21203,Courcelles-Frémoy,148,0,3143,3143,21.2
24202,Granges-d'Ans,148,0,2588,2588,17.5
24216,La Jemaye-Ponteyraud,148,0,1124,1124,7.6
24230,Larzac,148,0,7245,7245,49
25173,Cour-Saint-Maurice,148,0,1031,1031,7
25177,Crosey-le-Grand,148,0,4080,4080,27.6
25181,Cubrial,148,0,341,341,2.3
28119,La Croix-du-Perche,148,0,105,105,0.7
28329,Saint-Christophe,148,0,8087,8087,54.6
2A132,Guargualé,148,0,111,111,0.8
31180,Falga,148,0,3009,3009,20.3
32138,Garravet,148,0,923,923,6.2
32362,Saint-Aunix-Lengros,148,0,2728,2728,18.4
32386,Saint-Lizier-du-Planté,148,0,923,923,6.2
39352,Monteplain,148,0,2335,2335,15.8
39400,Our,148,1150,2335,3485,23.5
40136,Lacajunte,148,0,3419,3419,23.1
41268,Veilleins,148,0,1235,1235,8.3
43008,Arlempdes,148,810,717,1527,10.3
43133,Mercœur,148,2160,1348,3508,23.7
46247,Saillac,148,0,832,832,5.6
52151,Cour-l'Évêque,148,0,812,812,5.5
52528,Ville-en-Blaisois,148,0,1340,1340,9.1
54056,Bazailles,148,0,1879,1879,12.7
54492,Sanzey,148,0,309,309,2.1
55338,Milly-sur-Bradon,148,0,5352,5352,36.2
57266,Guéblange-lès-Dieuze,148,0,490,490,3.3
58107,Dun-sur-Grandry,148,0,7634,7634,51.6
58200,Ouagne,148,500,3097,3597,24.3
58209,Perroy,148,0,2951,2951,19.9
60114,Buicourt,148,0,726,726,4.9
61166,Ferrières-la-Verrerie,148,1270,52,1322,8.9
62535,La Madelaine-sous-Montreuil,148,0,1575,1575,10.6
63344,Saint-Gal-sur-Sioule,148,0,976,976,6.6
64427,Orion,148,0,3094,3094,20.9
65239,Labastide,148,0,442,442,3
65380,Sabalos,148,0,940,940,6.4
68024,Bellemagny,148,0,2107,2107,14.2
70008,Ainvelle,148,0,941,941,6.4
71498,Santilly,148,0,2270,2270,15.3
77056,Burcy,148,0,76,76,0.5
80515,Marlers,148,0,204,204,1.4
80535,Le Mesge,148,0,255,255,1.7
82158,Saint-Cirice,148,0,15901,15901,107.4
87069,Gajoubert,148,2300,2519,4819,32.6
88368,Ramecourt,148,0,2127,2127,14.4
88431,Saint-Paul,148,0,1653,1653,11.2
95046,Banthelu,148,0,936,936,6.3
2635,Ramicourt,147,0,1332,1332,9.1
2760,La Vallée-Mulâtre,147,0,810,810,5.5
6145,Tourette-du-Château,147,0,3313,3313,22.5
6146,Tournefort,147,0,2894,2894,19.7
7311,Sceautres,147,2300,4560,6860,46.7
8428,Sorcy-Bauthémont,147,0,3224,3224,21.9
9267,Saint-Lary,147,0,17813,17813,121.2
10106,Courceroy,147,0,908,908,6.2
10374,Spoy,147,0,0,0,0
11117,Davejean,147,0,1992,1992,13.6
11411,Villanière,147,0,1899,1899,12.9
12147,Montagnol,147,0,5752,5752,39.1
14705,Tournières,147,0,1018,1018,6.9
15058,Cros-de-Ronesque,147,3730,657,4387,29.8
16034,Bazac,147,300,6912,7212,49.1
16401,Vervant,147,0,1848,1848,12.6
18164,Neuvy-le-Barrois,147,0,2356,2356,16
21220,Cussey-les-Forges,147,0,102,102,0.7
21307,Grésigny-Sainte-Reine,147,0,0,0,0
23243,Saint-Silvain-sous-Toulx,147,0,2210,2210,15
24339,Preyssac-d'Excideuil,147,0,1848,1848,12.6
25335,Liebvillers,147,0,1024,1024,7
25591,Vaufrey,147,0,1024,1024,7
26241,Le Poët-Célard,147,650,1781,2431,16.5
32080,Castelnau-sur-l'Auvignon,147,0,565,565,3.8
32169,Labarthe,147,0,1735,1735,11.8
32266,Moncorneil-Grazan,147,0,1735,1735,11.8
32326,Pouylebon,147,0,2229,2229,15.2
33149,Daubèze,147,0,1460,1460,9.9
33304,Neuffons,147,0,1460,1460,9.9
33411,Saint-Germain-de-Grave,147,0,1503,1503,10.2
34098,Ferrals-les-Montagnes,147,0,556,556,3.8
43072,La Chomette,147,480,1339,1819,12.4
47113,Grayssas,147,0,15794,15794,107.4
48100,Montbel,147,2070,2979,5049,34.3
50052,Beuzeville-la-Bastille,147,0,797,797,5.4
50295,Maupertuis,147,0,2484,2484,16.9
51111,Chambrecy,147,0,2612,2612,17.8
51120,Champlat-et-Boujacourt,147,0,213,213,1.4
52249,Isômes,147,0,1821,1821,12.4
54142,Crantenoy,147,0,0,0,0
54158,Dolcourt,147,0,4874,4874,33.2
54413,Ozerailles,147,0,1365,1365,9.3
54566,Vilcey-sur-Trey,147,0,878,878,6
55381,Neuville-lès-Vaucouleurs,147,0,593,593,4
60593,Saint-Pierre-lès-Bitry,147,0,996,996,6.8
62348,Foufflin-Ricametz,147,0,3176,3176,21.6
62526,Longueville,147,0,424,424,2.9
63371,Saint-Just,147,0,1328,1328,9
64221,Etcharry,147,0,3820,3820,26
65003,Adervielle-Pouchergues,147,0,7067,7067,48.1
65086,Bernadets-Dessus,147,0,933,933,6.3
70174,Cordonnet,147,0,1231,1231,8.4
70204,Denèvre,147,0,755,755,5.1
71078,Chamilly,147,0,4042,4042,27.5
71181,Donzy-le-Pertuis,147,1025,1022,2047,13.9
71271,Mailly,147,0,4166,4166,28.3
76226,Écretteville-sur-Mer,147,0,954,954,6.5
76521,Rebets,147,0,100,100,0.7
79149,Lhoumois,147,0,3854,3854,26.2
80128,Bouvincourt-en-Vermandois,147,0,1053,1053,7.2
80195,Chuignolles,147,0,164,164,1.1
88503,Vexaincourt,147,0,1429,1429,9.7
89486,Yrouerre,147,430,342,772,5.3
1280,Ordonnaz,146,0,2492,2492,17.1
2108,Bourguignon-sous-Montbavin,146,0,145,145,1
2177,Chérêt,146,0,5576,5576,38.2
3009,Aubigny,146,0,1965,1965,13.5
3255,Saint-Priest-d'Andelot,146,0,2986,2986,20.5
6125,Saint-Martin-d'Entraunes,146,0,3290,3290,22.5
7148,Malbosc,146,710,3573,4283,29.3
9026,Audressein,146,0,17692,17692,121.2
9029,Aulus-les-Bains,146,0,17692,17692,121.2
9131,Garanou,146,7460,21026,28486,195.1
15206,Saint-Pierre,146,1981,747,2728,18.7
16185,Ligné,146,3300,1835,5135,35.2
21428,Monthelie,146,0,635,635,4.3
21595,Savolles,146,0,636,636,4.4
24043,Biron,146,0,530,530,3.6
24441,Saint-Léon-d'Issigeac,146,1720,274,1994,13.7
25164,Corcondray,146,0,99,99,0.7
32170,Labarthète,146,0,1461,1461,10
32467,Saint-Caprais,146,0,1855,1855,12.7
33401,Sainte-Florence,146,0,1019,1019,7
36218,Sougé,146,0,231,231,1.6
39114,Château-Chalon,146,100,3881,3981,27.3
39295,Loisia,146,705,2226,2931,20.1
41286,Villeporcher,146,0,1806,1806,12.4
51276,Gourgançon,146,0,275,275,1.9
51305,Janvry,146,0,2595,2595,17.8
51595,Vatry,146,0,7421,7421,50.8
52203,Fontaines-sur-Marne,146,0,1322,1322,9.1
54087,Bouillonville,146,0,872,872,6
54602,Han-devant-Pierrepont,146,0,1853,1853,12.7
55179,Erneville-aux-Bois,146,0,589,589,4
55336,Merles-sur-Loison,146,0,2668,2668,18.3
55518,Cousances-lès-Triconville,146,0,589,589,4
57472,Moncheux,146,0,5591,5591,38.3
57685,Vahl-lès-Bénestroff,146,0,483,483,3.3
58161,Maux,146,0,7531,7531,51.6
61197,Guêprei,146,1020,308,1328,9.1
61499,Les Ventes-de-Bourse,146,1950,51,2001,13.7
62246,Coupelle-Neuve,146,0,8640,8640,59.2
63360,Saint-Hilaire,146,0,227,227,1.6
63376,Saint-Martin-d'Ollières,146,0,949,949,6.5
64117,Bésingrand,146,0,3931,3931,26.9
64446,Peyrelongue-Abos,146,0,1524,1524,10.4
64552,Vialer,146,0,2286,2286,15.7
65058,Azet,146,0,7019,7019,48.1
70105,Bucey-lès-Traves,146,0,375,375,2.6
70129,La Chapelle-Saint-Quillain,146,0,660,660,4.5
70317,Les Magny,146,0,46,46,0.3
71008,Anglure-sous-Dun,146,0,2834,2834,19.4
71449,Saint-Martin-d'Auxy,146,650,2239,2889,19.8
73078,La Chapelle-Saint-Martin,146,0,926,926,6.3
76047,Auzouville-sur-Saâne,146,0,1178,1178,8.1
77205,Gesvres-le-Chapitre,146,0,1991,1991,13.6
80210,Contre,146,0,202,202,1.4
80478,Lignières,146,0,176,176,1.2
80591,Neuville-au-Bois,146,0,202,202,1.4
80757,Thoix,146,0,202,202,1.4
87163,Saint-Martial-sur-Isop,146,1485,2485,3970,27.2
88365,Racécourt,146,0,2098,2098,14.4
89323,Roffey,146,2000,339,2339,16
2508,Monthenault,145,0,5538,5538,38.2
6053,Daluis,145,0,3268,3268,22.5
11123,Duilhac-sous-Peyrepertuse,145,0,223,223,1.5
21085,Bligny-le-Sec,145,0,0,0,0
21338,Lamargelle,145,0,0,0,0
21650,Urcy,145,0,695,695,4.8
23198,Saint-Georges-Nigremont,145,0,1904,1904,13.1
24434,Saint-Just,145,440,1101,1541,10.6
25444,Palise,145,0,2555,2555,17.6
27321,La Haye-le-Comte,145,0,4300,4300,29.7
30272,Saint-Julien-de-la-Nef,145,0,3106,3106,21.4
31528,Saman,145,0,3003,3003,20.7
32068,Cadeilhan,145,0,82,82,0.6
32191,Lanne-Soubiran,145,0,97,97,0.7
32421,Savignac-Mona,145,0,905,905,6.2
36052,Chouday,145,0,2945,2945,20.3
38497,Sousville,145,1853,1518,3371,23.2
39319,Mathenay,145,292,3207,3499,24.1
39351,Montcusel,145,900,4220,5120,35.3
40060,Callen,145,0,1141,1141,7.9
46017,Bannes,145,0,4731,4731,32.6
46303,Sénaillac-Lauzès,145,0,839,839,5.8
51050,Bergères-sous-Montmirail,145,0,4659,4659,32.1
52220,Giey-sur-Aujon,145,0,795,795,5.5
54052,Battigny,145,0,4808,4808,33.2
55285,Lavoye,145,0,1963,1963,13.5
57410,Lhor,145,0,480,480,3.3
58040,Brinay,145,0,7479,7479,51.6
58143,Limon,145,0,727,727,5
61076,Le Cercueil,145,0,910,910,6.3
63410,Sauvagnat,145,0,4903,4903,33.8
63440,Valbeleix,145,0,1059,1059,7.3
64296,Lacadée,145,0,3904,3904,26.9
68326,Sternenberg,145,0,2065,2065,14.2
70425,La Proiselière-et-Langle,145,0,1668,1668,11.5
71072,Cersot,145,0,2224,2224,15.3
76262,Fesques,145,0,3387,3387,23.4
76359,Héronchelles,145,0,99,99,0.7
80559,Montagne-Fayel,145,0,200,200,1.4
80797,Villers-aux-Érables,145,0,891,891,6.1
81310,Veilhes,145,0,474,474,3.3
82156,Saint-Arroumex,145,0,1862,1862,12.8
87123,Rempnat,145,0,2065,2065,14.2
87165,Saint-Martin-le-Mault,145,2000,2468,4468,30.8
88364,Puzieux,145,0,2084,2084,14.4
91473,Orveau,145,0,213,213,1.5
1107,Cleyzieu,144,0,2458,2458,17.1
2144,Caulaincourt,144,0,1305,1305,9.1
2625,Proix,144,0,794,794,5.5
7118,Laboule,144,1902,10041,11943,82.9
8287,Ménil-Lépinois,144,0,2754,2754,19.1
10143,Étourvy,144,0,2681,2681,18.6
12139,Marnhagues-et-Latour,144,0,6166,6166,42.8
14049,Bazenville,144,0,1765,1765,12.3
15220,Salins,144,0,2724,2724,18.9
17343,Saint-Grégoire-d'Ardennes,144,0,1700,1700,11.8
18080,Croisy,144,0,282,282,2
19069,Darazac,144,0,427,427,3
21530,Rougemont,144,0,2805,2805,19.5
21687,Villargoix,144,0,413,413,2.9
23159,Puy-Malsignat,144,0,1890,1890,13.1
23205,Saint-Junien-la-Bregère,144,0,4515,4515,31.4
24337,Prats-du-Périgord,144,2900,247,3147,21.9
24394,Sainte-Croix-de-Mareuil,144,700,2029,2729,19
25582,Valleroy,144,0,7178,7178,49.8
25624,Villers-Grélot,144,0,7178,7178,49.8
27208,Duranville,144,0,2218,2218,15.4
2B083,Castirla,144,0,541,541,3.8
31510,Saint-Pé-Delbosc,144,0,2983,2983,20.7
32255,Miramont-Latour,144,0,82,82,0.6
33113,Cauvignac,144,0,48,48,0.3
35148,Lanrigan,144,0,1803,1803,12.5
46304,Séniergues,144,0,833,833,5.8
51220,Drouilly,144,0,2271,2271,15.8
55256,Jonville-en-Woëvre,144,0,1711,1711,11.9
57567,Rémelfang,144,0,2073,2073,14.4
58042,Bulcy,144,0,2871,2871,19.9
60244,Fontenay-Torcy,144,0,706,706,4.9
60247,Fouilleuse,144,600,764,1364,9.5
61183,Gâprée,144,0,51,51,0.4
63437,Trémouille-Saint-Loup,144,0,451,451,3.1
64199,Diusse,144,0,2255,2255,15.7
64294,Labets-Biscay,144,0,3742,3742,26
64311,Lannecaube,144,0,1503,1503,10.4
65075,Bazus-Aure,144,0,6923,6923,48.1
65126,Campuzan,144,0,4665,4665,32.4
65256,Lanespède,144,0,914,914,6.3
70023,Anjeux,144,0,915,915,6.4
70166,Comberjon,144,0,7449,7449,51.7
70422,Poyans,144,0,727,727,5
73049,Bonvillaret,144,0,5463,5463,37.9
76280,Fréauville,144,0,1063,1063,7.4
80121,Bouillancourt-la-Bataille,144,0,174,174,1.2
80404,Guyencourt-Saulcourt,144,0,1032,1032,7.2
80658,Quivières,144,0,2745,2745,19.1
82007,Auty,144,0,4258,4258,29.6
83039,Châteauvert,144,0,5395,5395,37.5
86098,Fleix,144,0,5824,5824,40.4
87008,La Bazeuge,144,650,2451,3101,21.5
88035,Barbey-Seroux,144,0,1400,1400,9.7
88069,Bouxières-aux-Bois,144,0,2069,2069,14.4
88260,Langley,144,0,3621,3621,25.1
88360,Provenchères-lès-Darney,144,0,1119,1119,7.8
88407,Ruppes,144,0,1609,1609,11.2
90083,Recouvrance,144,0,856,856,5.9
1155,Évosges,143,0,5409,5409,37.8
2561,Nouvion-le-Vineux,143,0,5461,5461,38.2
8229,Houdilcourt,143,0,2735,2735,19.1
9093,Celles,143,0,3844,3844,26.9
14171,Combray,143,0,4323,4323,30.2
16014,Angeduc,143,530,7646,8176,57.2
19262,Soudaine-Lavinadière,143,0,2490,2490,17.4
21679,Vieilmoulin,143,0,804,804,5.6
21686,Villaines-les-Prévôtes,143,0,2786,2786,19.5
23084,La Forêt-du-Temple,143,0,385,385,2.7
23108,Leyrat,143,0,2149,2149,15
25152,La Chevillotte,143,0,2520,2520,17.6
26043,Beauvoisin,143,0,7348,7348,51.4
26246,Ponet-et-Saint-Auban,143,690,7951,8641,60.4
26334,Salettes,143,0,4985,4985,34.9
26356,Truinas,143,0,4985,4985,34.9
27635,Le Thuit,143,0,751,751,5.3
27645,Tocqueville,143,0,586,586,4.1
32245,Maumusson-Laguian,143,0,1431,1431,10
36115,Menetou-sur-Nahon,143,0,145,145,1
41027,Briou,143,0,431,431,3
42310,Thélis-la-Combe,143,0,2926,2926,20.5
43106,Jax,143,860,1302,2162,15.1
51010,Angluzelles-et-Courcelles,143,0,269,269,1.9
52359,Nully,143,0,530,530,3.7
54577,Villers-lès-Moivrons,143,0,846,846,5.9
55488,Silmont,143,0,1724,1724,12.1
57277,Guinkirchen,143,0,861,861,6
57313,Hémilly,143,0,6636,6636,46.4
57406,Liocourt,143,0,473,473,3.3
58026,Beaulieu,143,0,2224,2224,15.6
59188,Écuélin,143,0,5101,5101,35.7
59573,Solrinnes,143,0,1133,1133,7.9
60075,Blancfossé,143,0,3225,3225,22.6
60111,Broyes,143,0,3225,3225,22.6
60546,Rosières,143,0,560,560,3.9
62395,Guigny,143,0,2264,2264,15.8
62481,Labroye,143,0,2264,2264,15.8
63076,Chambon-sur-Dolore,143,0,1292,1292,9
64082,Auterrive,143,0,2989,2989,20.9
64210,Escurès,143,0,1493,1493,10.4
65099,Bordères-Louron,143,0,6875,6875,48.1
65470,Viger,143,0,1366,1366,9.6
70028,Aroz,143,0,367,367,2.6
71415,Sainte-Foy,143,0,4052,4052,28.3
72352,Terrehault,143,0,2652,2652,18.5
73052,Bourget-en-Huile,143,0,2557,2557,17.9
76171,La Chapelle-Saint-Ouen,143,0,2701,2701,18.9
80083,Bergicourt,143,0,197,197,1.4
80311,Fignières,143,0,173,173,1.2
80675,Rogy,143,0,878,878,6.1
80750,Tertry,143,0,2726,2726,19.1
82129,Montgaillard,143,0,3352,3352,23.4
87137,Saint-Bazile,143,330,63,393,2.7
88348,Pierrepont-sur-l'Arentèle,143,0,188,188,1.3
2563,Noyales,142,0,783,783,5.5
2772,Vaux-en-Vermandois,142,0,1287,1287,9.1
3016,Barberier,142,0,2904,2904,20.5
4021,Barras,142,0,5952,5952,41.9
7037,Borée,142,1500,1110,2610,18.4
10253,Montmorency-Beaufort,142,0,2998,2998,21.1
10278,Pargues,142,0,2644,2644,18.6
11270,Padern,142,0,219,219,1.5
11291,Plavilla,142,0,420,420,3
14681,Surrain,142,0,983,983,6.9
15013,Auriac-l'Église,142,3115,32,3147,22.2
15130,Montchamp,142,2180,3141,5321,37.5
21228,Détain-et-Bruant,142,0,681,681,4.8
21624,Tellecey,142,0,0,0,0
24483,Saint-Perdoux,142,797,266,1063,7.5
25623,Villers-Chief,142,0,1677,1677,11.8
27113,Brétigny,142,0,612,612,4.3
27520,Saint-Benoît-des-Ombres,142,0,2187,2187,15.4
2A119,Frasseto,142,0,106,106,0.7
34319,Vailhan,142,0,278,278,2
38060,Brion,142,0,1549,1549,10.9
39084,Cernans,142,1180,3141,4321,30.4
39107,Charcier,142,180,4133,4313,30.4
43128,Malvières,142,0,5909,5909,41.6
46254,Saint-Chels,142,0,4193,4193,29.5
47297,Sembas,142,0,1364,1364,9.6
48145,Saint-Denis-en-Margeride,142,1600,1672,3272,23
50312,Le Mesnil-Gilbert,142,0,3494,3494,24.6
51414,Olizy,142,0,2524,2524,17.8
52003,Aillianville,142,0,2185,2185,15.4
52396,Poinson-lès-Nogent,142,0,15598,15598,109.8
54544,Vandelainville,142,0,848,848,6
55035,Bazincourt-sur-Saulx,142,0,2776,2776,19.5
57440,Manhoué,142,0,470,470,3.3
58216,Pouques-Lormes,142,0,2208,2208,15.5
58252,Saint-Malo-en-Donziois,142,0,2831,2831,19.9
60527,Réez-Fosse-Martin,142,0,556,556,3.9
61013,Aunay-les-Bois,142,1590,50,1640,11.5
62047,Aubrometz,142,0,3068,3068,21.6
62425,Hendecourt-lès-Ransart,142,0,1180,1180,8.3
64428,Orriule,142,0,2968,2968,20.9
66097,Lesquerde,142,0,3472,3472,24.5
71094,La Chapelle-sous-Brancion,142,0,3305,3305,23.3
71323,Mornay,142,0,551,551,3.9
80104,Biencourt,142,0,3,3,0
80152,Bus-la-Mésière,142,0,171,171,1.2
80321,Folleville,142,0,872,872,6.1
80324,Fontaine-le-Sec,142,0,196,196,1.4
89219,Lasson,142,0,918,918,6.5
2188,Chigny,141,0,777,777,5.5
2350,Goudelancourt-lès-Pierrepont,141,0,379,379,2.7
2586,Parfondeval,141,0,1554,1554,11
2751,Trucy,141,0,1014,1014,7.2
5047,Éourres,141,0,4204,4204,29.8
8462,Vaux-Champagne,141,0,3093,3093,21.9
10176,Jaucourt,141,0,0,0,0
10440,Voigny,141,0,0,0,0
11191,Laroque-de-Fa,141,0,1910,1910,13.5
14374,Les Loges,141,0,5229,5229,37.1
15151,Peyrusse,141,1470,32,1502,10.7
16255,Parzac,141,510,2901,3411,24.2
21634,Thorey-sur-Ouche,141,0,2143,2143,15.2
23003,Alleyrat,141,0,5333,5333,37.8
24406,Sainte-Foy-de-Belvès,141,1100,6902,8002,56.8
25132,Châtillon-Guyotte,141,0,7028,7028,49.8
27521,Saint-Christophe-sur-Avre,141,0,3965,3965,28.1
2A028,Balogna,141,0,650,650,4.6
2A295,Sant'Andréa-d'Orcino,141,0,650,650,4.6
31321,Marsoulas,141,0,7578,7578,53.7
32087,Castex-d'Armagnac,141,0,0,0,0
32248,Mauroux,141,0,532,532,3.8
32380,Saint-Griède,141,0,94,94,0.7
36147,Orville,141,0,143,143,1
39284,Lavangeot,141,490,2862,3352,23.8
40124,Herré,141,0,1610,1610,11.4
41153,Montrouveau,141,0,1744,1744,12.4
42278,Saint-Priest-la-Vêtre,141,0,1263,1263,9
43095,Fix-Saint-Geneys,141,465,5867,6332,44.9
46018,Le Bastit,141,0,4600,4600,32.6
46121,Ginouillac,141,0,816,816,5.8
46259,Saint-Clair,141,0,4220,4220,29.9
47136,Laperche,141,0,2626,2626,18.6
48028,Les Bondons,141,1000,3458,4458,31.6
51148,Cheppes-la-Prairie,141,0,235,235,1.7
51547,Somme-Tourbe,141,0,1327,1327,9.4
51558,Soulières,141,0,2802,2802,19.9
57225,Fonteny,141,0,467,467,3.3
60679,La Villeneuve-sous-Thury,141,0,552,552,3.9
61046,Bizou,141,1030,601,1631,11.6
64175,Castet,141,0,1790,1790,12.7
64351,Lourdios-Ichère,141,0,3036,3036,21.5
64537,Trois-Villes,141,0,3664,3664,26
70062,Belmont,141,0,1622,1622,11.5
70463,Saint-Gand,141,0,638,638,4.5
71501,Sassangy,141,0,2163,2163,15.3
72142,Grandchamp,141,0,6637,6637,47.1
73012,Albiez-le-Jeune,141,0,3786,3786,26.9
76694,Tocqueville-en-Caux,141,0,1138,1138,8.1
80407,Hallivillers,141,0,866,866,6.1
80482,Limeux,141,0,430,430,3
80786,Velennes,141,0,195,195,1.4
88047,Begnécourt,141,0,2026,2026,14.4
88174,Fomerey,141,0,3546,3546,25.1
88457,Sionne,141,0,1575,1575,11.2
89006,Ancy-le-Libre,141,200,328,528,3.7
89355,Saint-Martin-sur-Armançon,141,2300,328,2628,18.6
95212,Épiais-lès-Louvres,141,0,1749,1749,12.4
1013,Arandas,140,0,2389,2389,17.1
1215,Surjoux-Lhopital,140,0,1686,1686,12
2591,Pargny-les-Bois,140,0,705,705,5
3270,Sazeret,140,0,5002,5002,35.7
4042,Castellet-lès-Sausses,140,0,4950,4950,35.4
5013,Barcillonnette,140,0,198,198,1.4
7223,Saint-Cirgues-de-Prades,140,0,575,575,4.1
9094,Cérizols,140,0,16965,16965,121.2
10091,Chaudrey,140,0,119,119,0.8
10354,Saint-Nabord-sur-Aube,140,0,119,119,0.8
11318,Roquecourbe-Minervois,140,0,1897,1897,13.6
11420,Villebazy,140,0,1843,1843,13.2
12149,Montclar,140,0,7640,7640,54.6
14273,La Folletière-Abenon,140,0,1558,1558,11.1
16239,Mouzon,140,200,2880,3080,22
17061,Bran,140,0,1653,1653,11.8
18132,Lugny-Champagne,140,0,483,483,3.4
21202,Courban,140,0,2336,2336,16.7
24105,Chapdeuil,140,1228,1063,2291,16.4
24457,Saint-Martin-l'Astier,140,305,6704,7009,50.1
25151,Chevigney-lès-Vercel,140,450,1654,2104,15
25153,Chevroz,140,0,2467,2467,17.6
26204,Montlaur-en-Diois,140,800,7784,8584,61.3
27046,Bazoques,140,0,2156,2156,15.4
30335,Vabres,140,0,4376,4376,31.3
33246,Ligueux,140,0,1057,1057,7.6
37137,Lublé,140,0,1299,1299,9.3
38108,Choranche,140,0,2262,2262,16.2
39202,Dournon,140,0,3097,3097,22.1
47311,Tourliac,140,0,3575,3575,25.5
47313,Tourtrès,140,0,1130,1130,8.1
49114,Courléon,140,0,1364,1364,9.7
50088,Brouains,140,0,3445,3445,24.6
52371,Oudincourt,140,0,15378,15378,109.8
54564,Viéville-en-Haye,140,0,836,836,6
55265,Labeuville,140,0,1812,1812,12.9
57366,Kirviller,140,0,1913,1913,13.7
57455,Mégange,140,0,843,843,6
57457,Menskirch,140,0,2015,2015,14.4
57671,Thimonville,140,0,5361,5361,38.3
58016,Asnois,140,0,2177,2177,15.6
60444,Mureaumont,140,0,687,687,4.9
60688,Villers-sur-Bonnières,140,0,687,687,4.9
62511,Lignereuil,140,0,1163,1163,8.3
64239,Gerderest,140,0,1461,1461,10.4
64383,Mialos,140,2235,2192,4427,31.6
66043,Casteil,140,0,4193,4193,30
66181,Sainte-Léocadie,140,0,0,0,0
70265,Germigney,140,0,707,707,5
71348,Perrigny-sur-Loire,140,0,720,720,5.1
73088,Cohennoz,140,0,3302,3302,23.6
76292,Fry,140,0,2645,2645,18.9
77009,Arville,140,0,148,148,1.1
80358,Fresnoy-en-Chaussée,140,0,860,860,6.1
80409,Hallu,140,0,2534,2534,18.1
80755,Thieulloy-la-Ville,140,0,193,193,1.4
87134,Sainte-Anne-Saint-Priest,140,2965,1994,4959,35.4
89120,Coulours,140,2800,271,3071,21.9
95493,Le Plessis-Luzarches,140,0,809,809,5.8
2100,Bony,139,0,1259,1259,9.1
2393,Jouaignes,139,0,274,274,2
2427,Lhuys,139,0,274,274,2
2440,Lor,139,0,374,374,2.7
2531,Moussy-Verneuil,139,0,999,999,7.2
2595,Passy-sur-Marne,139,0,3213,3213,23.1
3070,Chavenon,139,0,4966,4966,35.7
4101,Lardiers,139,0,2823,2823,20.3
5021,Le Bersac,139,0,4144,4144,29.8
5032,Champoléon,139,0,9248,9248,66.5
11152,Fontjoncouse,139,0,214,214,1.5
15034,Chaliers,139,4629,3075,7704,55.4
15178,Saint-Cirgues-de-Jordanne,139,1590,4710,6300,45.3
16122,Ébréon,139,1050,1747,2797,20.1
21217,Curley,139,0,667,667,4.8
21436,Montmain,139,0,1042,1042,7.5
21566,Saint-Pierre-en-Vaux,139,0,4287,4287,30.8
23173,Soubrebost,139,0,4358,4358,31.4
24347,Rampieux,139,1100,505,1605,11.5
25113,Chamesey,139,0,3832,3832,27.6
25471,Provenchère,139,0,3832,3832,27.6
28273,Moulhard,139,0,7595,7595,54.6
2B192,Olmo,139,0,2592,2592,18.6
2B304,San-Lorenzo,139,0,523,523,3.8
31552,Terrebasse,139,0,2879,2879,20.7
38264,La Morte,139,10125,1455,11580,83.3
39330,Miéry,139,420,3074,3494,25.1
40079,Cazalis,139,0,3211,3211,23.1
47189,Montignac-Toupinerie,139,0,2589,2589,18.6
48001,Albaret-le-Comtal,139,1250,5137,6387,45.9
50225,Le Guislain,139,0,2349,2349,16.9
51061,Billy-le-Grand,139,0,2470,2470,17.8
51285,Haussimont,139,0,7065,7065,50.8
55156,Dombras,139,0,2540,2540,18.3
55202,Futeau,139,0,1453,1453,10.5
55460,Saint-Julien-sous-les-Côtes,139,0,1652,1652,11.9
55544,Velosnes,139,0,4969,4969,35.7
55567,Ville-sur-Cousances,139,0,885,885,6.4
57349,Jallaucourt,139,0,460,460,3.3
58156,Marcy,139,0,2908,2908,20.9
58226,Saint-Agnan,139,0,1638,1638,11.8
58236,Sainte-Colombe-des-Bois,139,0,2771,2771,19.9
58259,Saint-Parize-en-Viry,139,0,1871,1871,13.5
61227,Lignou,139,0,793,793,5.7
61371,Saint-Brice-sous-Rânes,139,1860,294,2154,15.5
63458,Villeneuve,139,0,904,904,6.5
64447,Piets-Plasence-Moustrou,139,0,2176,2176,15.7
70380,Neurey-en-Vaux,139,0,826,826,5.9
70583,Vy-lès-Filain,139,0,445,445,3.2
71019,Barizey,139,0,3822,3822,27.5
71164,Curtil-sous-Burnand,139,0,1684,1684,12.1
71400,Saint-Clément-sur-Guye,139,0,966,966,6.9
76181,Cléville,139,0,1059,1059,7.6
77271,Maisoncelles-en-Gâtinais,139,0,146,146,1.1
77319,Mortery,139,0,501,501,3.6
81162,Maurens-Scopont,139,0,155,155,1.1
88027,Badménil-aux-Bois,139,0,3495,3495,25.1
88373,Raon-sur-Plaine,139,0,1351,1351,9.7
89379,Savigny-en-Terre-Plaine,139,450,671,1121,8.1
90060,Lagrange,139,750,4849,5599,40.3
1208,Lavours,138,0,1538,1538,11.1
2513,Montigny-le-Franc,138,0,695,695,5
8088,Bulson,138,0,4886,4886,35.4
10204,Longeville-sur-Mogne,138,1272,1971,3243,23.5
14147,Cernay,138,0,1536,1536,11.1
15018,Barriac-les-Bosquets,138,4016,2285,6301,45.7
16357,Saint-Vallier,138,0,7379,7379,53.5
23060,Chavanat,138,0,4327,4327,31.4
24445,Saint-Marcel-du-Périgord,138,460,501,961,7
25551,Soulce-Cernay,138,0,961,961,7
30015,Arphy,138,0,2226,2226,16.1
30137,Lamelouze,138,0,4314,4314,31.3
31444,Puysségur,138,0,1154,1154,8.4
32142,Gavarret-sur-Aulouste,138,0,78,78,0.6
32288,Montiron,138,0,1753,1753,12.7
32313,Pessoulens,138,0,521,521,3.8
33403,Sainte-Foy-la-Longue,138,770,1124,1894,13.7
36187,Saint-Civran,138,0,759,759,5.5
36223,Tilly,138,0,2783,2783,20.2
46027,Berganty,138,0,776,776,5.6
51396,Nesle-le-Repons,138,0,200,200,1.4
51397,La Neuville-aux-Bois,138,0,2049,2049,14.8
51574,Togny-aux-Bœufs,138,0,230,230,1.7
54239,Griscourt,138,0,1508,1508,10.9
55225,Halles-sous-les-Côtes,138,0,4990,4990,36.2
55361,Moulainville,138,0,2493,2493,18.1
55365,Murvaux,138,0,4990,4990,36.2
55410,Quincy-Landzécourt,138,0,4934,4934,35.8
57216,Fleisheim,138,0,898,898,6.5
57354,Juville,138,0,457,457,3.3
58201,Oudan,138,0,2887,2887,20.9
59483,Quiévelon,138,0,4923,4923,35.7
62171,Boyaval,138,0,2981,2981,21.6
62533,Lugy,138,0,8166,8166,59.2
62891,Willencourt,138,0,2981,2981,21.6
63292,Puy-Saint-Gulmier,138,0,4667,4667,33.8
64022,Andrein,138,0,2885,2885,20.9
64287,Laàs,138,0,2885,2885,20.9
70181,Courcuire,138,0,93,93,0.7
71377,Royer,138,0,3212,3212,23.3
72086,Commerveil,138,0,2559,2559,18.5
73230,Saint-Colomban-des-Villards,138,21830,19771,41601,301.5
76032,Auberville-la-Manuel,138,0,894,894,6.5
80453,Laboissière-en-Santerre,138,0,167,167,1.2
80800,Villers-Campsart,138,0,191,191,1.4
81318,Villeneuve-lès-Lavaur,138,0,451,451,3.3
88268,Lesseux,138,0,1342,1342,9.7
2079,Besmont,137,0,2689,2689,19.6
2510,Monthurel,137,0,3167,3167,23.1
2712,Sergy,137,0,3167,3167,23.1
3014,Avrilly,137,0,2366,2366,17.3
3194,Naves,137,0,2802,2802,20.5
4184,Saint-Jurs,137,0,5742,5742,41.9
6072,Ilonse,137,0,2697,2697,19.7
7179,Pourchères,137,250,457,707,5.2
8422,Singly,137,0,3005,3005,21.9
9239,Quérigut,137,0,19730,19730,144
10013,Assenay,137,0,1956,1956,14.3
11346,Saint-Jean-de-Paracol,137,0,1505,1505,11
11380,Sonnac-sur-l'Hers,137,0,1505,1505,11
14190,Courcy,137,0,2146,2146,15.7
14329,Heuland,137,0,1740,1740,12.7
14430,Meuvaines,137,0,1680,1680,12.3
15146,Pailherols,137,400,612,1012,7.4
16027,Barbezières,137,2820,1722,4542,33.2
16098,La Chèvrerie,137,0,2999,2999,21.9
17377,Saint-Ouen-la-Thène,137,0,3816,3816,27.9
18275,Vereaux,137,0,2195,2195,16
19184,Saint-Bazile-de-Meyssac,137,0,691,691,5
21149,Charrey-sur-Seine,137,0,2286,2286,16.7
21528,La Roche-Vanneau,137,0,0,0,0
24174,Fanlac,137,1770,1902,3672,26.8
24284,Montagnac-d'Auberoche,137,0,2396,2396,17.5
25464,Les Pontets,137,0,8159,8159,59.6
26101,Comps,137,0,4776,4776,34.9
28114,Courbehaye,137,0,720,720,5.3
28221,Lumeau,137,0,720,720,5.3
31177,Eup,137,0,1311,1311,9.6
31268,Lalouret-Laffiteau,137,0,2838,2838,20.7
31453,Rieumajou,137,0,668,668,4.9
32042,Belloc-Saint-Clamens,137,0,303,303,2.2
32295,Nizas,137,0,855,855,6.2
32360,Saint-Arailles,137,0,996,996,7.3
33020,Auriolles,137,0,1034,1034,7.5
33247,Listrac-de-Durèze,137,0,1034,1034,7.5
33276,Masseilles,137,0,46,46,0.3
39292,Lent,137,550,1387,1937,14.1
40301,Siest,137,0,1173,1173,8.6
42050,La Chapelle-en-Lafaye,137,0,1227,1227,9
42125,Luré,137,60,1131,1191,8.7
49237,La Pellerine,137,0,479,479,3.5
51091,Broussy-le-Petit,137,0,1788,1788,13.1
51103,La Celle-sous-Chantemerle,137,0,1788,1788,13.1
51164,Connantray-Vaurefroy,137,0,258,258,1.9
54033,Avillers,137,0,604,604,4.4
54294,Landremont,137,0,1497,1497,10.9
55352,Montplonne,137,0,2678,2678,19.5
60388,Martincourt,137,0,672,672,4.9
62576,Moncheaux-lès-Frévent,137,0,2960,2960,21.6
64179,Castetner,137,0,3689,3689,26.9
65081,Benqué-Molère,137,0,409,409,3
65128,Castelbajac,137,0,409,409,3
65222,Hitte,137,0,1028,1028,7.5
66081,Fontrabiouse,137,0,0,0,0
70235,Flagy,137,0,814,814,5.9
71537,Thil-sur-Arroux,137,0,3065,3065,22.4
72374,Villaines-la-Carelle,137,0,2540,2540,18.5
76549,Saâne-Saint-Just,137,0,1106,1106,8.1
80153,Bus-lès-Artois,137,0,153,153,1.1
81089,Faussergues,137,0,4233,4233,30.9
81229,Roquevidal,137,0,447,447,3.3
88113,Combrimont,137,0,1332,1332,9.7
1111,Conand,136,0,2321,2321,17.1
1400,Seillonnaz,136,0,2321,2321,17.1
2786,Verneuil-sous-Coucy,136,0,135,135,1
8069,Blanchefosse-et-Bay,136,0,3555,3555,26.1
8234,Inaumont,136,0,2601,2601,19.1
8293,Moiry,136,0,4815,4815,35.4
11159,Gaja-la-Selve,136,0,403,403,3
11200,Lespinassière,136,0,882,882,6.5
11238,Molleville,136,0,1195,1195,8.8
14401,Manvieux,136,0,5242,5242,38.5
14590,Sainte-Honorine-de-Ducy,136,0,941,941,6.9
16037,Bellon,136,1690,6395,8085,59.4
17117,Contré,136,0,3788,3788,27.9
18215,Saint-Hilaire-de-Gondilly,136,0,43,43,0.3
19077,Estivals,136,0,2171,2171,16
19095,Lacelle,136,0,2368,2368,17.4
19132,Ménoire,136,0,686,686,5
21034,Autricourt,136,0,2269,2269,16.7
21225,Dampierre-et-Flée,136,0,592,592,4.4
21503,Pouilly-sur-Vingeanne,136,0,592,592,4.4
21511,Puits,136,0,2269,2269,16.7
23107,Lépinas,136,0,4264,4264,31.4
25449,Péseux,136,0,3749,3749,27.6
25476,Rahon,136,0,3749,3749,27.6
27392,Martagny,136,5030,111,5141,37.8
28264,Montireau,136,0,97,97,0.7
31301,Lilhac,136,0,2817,2817,20.7
32118,Durban,136,0,1605,1605,11.8
32131,Flamarens,136,0,77,77,0.6
32393,Saint-Maur,136,0,2062,2062,15.2
36041,La Chapelle-Saint-Laurian,136,0,2762,2762,20.3
39151,Choux,136,1590,501,2091,15.4
39261,Graye-et-Charnay,136,550,2074,2624,19.3
41022,Bouffry,136,944,691,1635,12
45262,Rouvray-Sainte-Croix,136,0,192,192,1.4
46155,Larnagol,136,0,4016,4016,29.5
50039,Beaucoudray,136,0,2011,2011,14.8
50451,Saint-Brice,136,0,3346,3346,24.6
51098,Bussy-le-Repos,136,0,798,798,5.9
51214,Dommartin-Varimont,136,0,2019,2019,14.8
51247,Fèrebrianges,136,0,197,197,1.4
52313,Mareilles,136,0,2092,2092,15.4
53038,Boulay-les-Ifs,136,0,1210,1210,8.9
55046,Beney-en-Woëvre,136,0,1616,1616,11.9
57151,Conthil,136,0,450,450,3.3
58071,Chevannes-Changy,136,0,2115,2115,15.6
59127,Capelle,136,0,34,34,0.2
61060,Brethel,136,3565,1402,4967,36.5
62434,La Herlière,136,0,1130,1130,8.3
62860,Villers-Sir-Simon,136,0,1130,1130,8.3
63159,Fernoël,136,0,4599,4599,33.8
63202,Madriat,136,0,884,884,6.5
63312,Saint-Alyre-d'Arlanc,136,0,1229,1229,9
64056,Arrosès,136,0,1420,1420,10.4
64355,Louvigny,136,0,2129,2129,15.7
65148,Cizos,136,0,4406,4406,32.4
65274,Libaros,136,0,406,406,3
65321,Montignac,136,0,1299,1299,9.6
65426,Sinzos,136,0,864,864,6.4
65437,Tajan,136,0,406,406,3
65481,Barèges,136,0,5569,5569,40.9
68243,Oberlarg,136,0,3648,3648,26.8
70048,Bard-lès-Pesmes,136,0,92,92,0.7
70087,Bourguignon-lès-Conflans,136,0,808,808,5.9
70242,Fontenois-la-Ville,136,0,864,864,6.4
70327,Malans,136,0,92,92,0.7
70368,Montot,136,0,698,698,5.1
80667,Remaugies,136,0,164,164,1.2
80822,Warsy,136,0,164,164,1.2
86227,Saint-Laon,136,0,695,695,5.1
87009,Beaumont-du-Lac,136,0,1937,1937,14.2
88004,Ainvelle,136,0,1057,1057,7.8
88019,Autigny-la-Tour,136,0,1519,1519,11.2
89175,Fontenay-près-Chablis,136,500,19,519,3.8
89176,Fontenay-près-Vézelay,136,0,295,295,2.2
1233,Marchamp,135,0,2304,2304,17.1
1404,Serrières-sur-Ain,135,0,1934,1934,14.3
2323,Fontaine-Uterte,135,0,1223,1223,9.1
2471,Martigny-Courpierre,135,0,5156,5156,38.2
2725,Sommeron,135,0,2407,2407,17.8
5146,Saint-Julien-en-Beauchêne,135,0,5052,5052,37.4
8459,Tremblois-lès-Carignan,135,0,4780,4780,35.4
10092,Chauffour-lès-Bailly,135,0,2357,2357,17.5
12144,Meljac,135,0,4132,4132,30.6
14607,Saint-Louet-sur-Seulles,135,0,5006,5006,37.1
15100,Laveissenet,135,2200,30,2230,16.5
19097,Lafage-sur-Sombre,135,0,1732,1732,12.8
21010,Aloxe-Corton,135,0,587,587,4.3
21070,Bévy,135,0,647,647,4.8
21116,Bure-les-Templiers,135,0,2252,2252,16.7
21238,Échannay,135,0,759,759,5.6
24282,Monsaguel,135,0,253,253,1.9
24306,Nastringues,135,1210,470,1680,12.4
24569,Vendoire,135,565,1025,1590,11.8
40220,Pécorade,135,0,3119,3119,23.1
42055,Châtelus,135,0,6766,6766,50.1
46031,Blars,135,0,781,781,5.8
46050,Cambayrac,135,0,4908,4908,36.4
51236,Les Essarts-le-Vicomte,135,0,1762,1762,13.1
51315,Landricourt,135,0,1223,1223,9.1
52362,Orbigny-au-Mont,135,0,619,619,4.6
55180,Esnes-en-Argonne,135,0,1411,1411,10.5
58305,Vauclaix,135,0,2099,2099,15.5
60442,Muidorge,135,0,5294,5294,39.2
61037,Bellavilliers,135,0,474,474,3.5
63384,Saint-Pierre-la-Bourlhonne,135,0,1220,1220,9
65036,Artalens-Souin,135,0,5528,5528,40.9
70064,Belverne,135,0,882,882,6.5
70336,Mélecey,135,0,43,43,0.3
70483,Scye,135,1350,802,2152,15.9
71276,Marcilly-la-Gueurce,135,0,523,523,3.9
72091,Contilly,135,0,2503,2503,18.5
76651,Saint-Sylvain,135,0,874,874,6.5
77036,Boisdon,135,0,487,487,3.6
80687,Rubescourt,135,0,163,163,1.2
80747,Templeux-la-Fosse,135,0,967,967,7.2
80777,Vauchelles-lès-Authie,135,0,151,151,1.1
80810,Vitz-sur-Authie,135,0,2916,2916,21.6
81151,Magrin,135,0,2019,2019,15
86206,Raslay,135,0,690,690,5.1
90048,Fontenelle,135,0,4710,4710,34.9
91148,Chauffour-lès-Étréchy,135,0,914,914,6.8
2783,Grand-Verly,134,0,739,739,5.5
4032,Braux,134,0,4738,4738,35.4
7062,Chazeaux,134,0,2111,2111,15.8
7187,Prunet,134,800,2111,2911,21.7
8010,Ambly-Fleury,134,0,2563,2563,19.1
8063,La Besace,134,0,4744,4744,35.4
8208,Hannappes,134,0,3503,3503,26.1
15133,Montmurat,134,2130,1175,3305,24.7
16118,Deviat,134,1990,6301,8291,61.9
16227,Montignac-le-Coq,134,2100,6301,8401,62.7
18093,Faverdines,134,0,359,359,2.7
21362,Maconge,134,0,2037,2037,15.2
21581,Samerey,134,0,1005,1005,7.5
25545,Silley-Amancey,134,0,976,976,7.3
26127,Eygaliers,134,0,6886,6886,51.4
26361,Valdrôme,134,3250,7450,10700,79.9
26370,Vercoiran,134,0,6886,6886,51.4
33112,Caumont,134,0,1331,1331,9.9
33212,Labescau,134,0,45,45,0.3
33292,Montignac,134,0,1331,1331,9.9
38299,Pellafol,134,0,1403,1403,10.5
38489,Siévoz,134,0,1403,1403,10.5
39409,Peintre,134,400,2720,3120,23.3
42101,Graix,134,0,2742,2742,20.5
46179,Lugagnac,134,0,753,753,5.6
46294,Saint-Sulpice,134,0,3957,3957,29.5
48174,Saint-Paul-le-Froid,134,2870,1578,4448,33.2
50033,Baubigny,134,3129,4215,7344,54.8
51104,Cernay-en-Dormois,134,0,1990,1990,14.9
51480,Sainte-Gemme,134,0,194,194,1.4
52465,Saulxures,134,0,615,615,4.6
54251,Harbouey,134,0,475,475,3.5
54401,Nonhigny,134,0,475,475,3.5
55261,Juvigny-en-Perthois,134,0,2619,2619,19.5
57007,Adaincourt,134,0,6218,6218,46.4
60536,Rhuis,134,0,196,196,1.5
61229,Loisail,134,3160,470,3630,27.1
62189,Bus,134,0,666,666,5
63025,Ayat-sur-Sioule,134,0,208,208,1.6
64028,Anoye,134,0,1399,1399,10.4
64033,Araux,134,0,2801,2801,20.9
64048,Arnos,134,0,3608,3608,26.9
64084,Aydie,134,0,2098,2098,15.7
64150,Bunus,134,0,3482,3482,26
64395,Monségur,134,0,3027,3027,22.6
70510,Vadans,134,0,676,676,5
70545,Venisey,134,0,796,796,5.9
71051,Bouzeron,134,0,3684,3684,27.5
71496,Sampigny-lès-Maranges,134,0,3684,3684,27.5
80032,Assainvillers,134,0,162,162,1.2
80306,Fescamps,134,0,162,162,1.2
88236,La Haye,134,0,3370,3370,25.1
89022,Athie,134,400,291,691,5.2
89095,Chemilly-sur-Serein,134,860,18,878,6.6
89376,Sarry,134,590,647,1237,9.2
1242,Mérignat,133,0,1906,1906,14.3
2062,Belleau,133,0,3074,3074,23.1
2116,Braye-en-Thiérache,133,0,2372,2372,17.8
2233,Cramaille,133,0,444,444,3.3
2447,Maast-et-Violaine,133,0,444,444,3.3
2627,Proviseux-et-Plesnoy,133,0,358,358,2.7
6009,Bairols,133,0,2618,2618,19.7
8121,Chilly,133,0,3477,3477,26.1
8149,L'Échelle,133,0,3477,3477,26.1
10207,Longueville-sur-Aube,133,0,137,137,1
11137,Félines-Termenès,133,0,1802,1802,13.5
11173,Hounoux,133,0,394,394,3
15208,Saint-Projet-de-Salers,133,0,2202,2202,16.6
17002,Agudelle,133,0,1570,1570,11.8
18236,Saint-Symphorien,133,0,2408,2408,18.1
19142,Monestier-Port-Dieu,133,0,1823,1823,13.7
24238,Lempzours,133,7650,439,8089,60.8
25242,Flagey-Rigney,133,0,6630,6630,49.8
25548,Solemont,133,0,8419,8419,63.3
26102,Condillac,133,1150,1281,2431,18.3
28312,Puiseux,133,0,178,178,1.3
2A200,Palneca,133,0,100,100,0.8
30040,Blandas,133,0,2145,2145,16.1
32040,Bédéchan,133,0,1689,1689,12.7
34269,Saint-Jean-de-Minervois,133,0,503,503,3.8
34305,Le Soulié,133,0,2353,2353,17.7
39334,Moiron,133,200,4191,4391,33
40039,Betbezer-d'Armagnac,133,0,1519,1519,11.4
40173,Marpaps,133,0,361,361,2.7
45216,Mormant-sur-Vernisson,133,0,1792,1792,13.5
46310,Soulomès,133,0,769,769,5.8
48058,La Fage-Montivernoux,133,3103,4915,8018,60.3
52034,Bailly-aux-Forges,133,0,1205,1205,9.1
55195,Fouchères-aux-Bois,133,0,2600,2600,19.5
57670,Thicourt,133,0,6172,6172,46.4
58116,Flez-Cuzy,133,0,2068,2068,15.5
60615,Sérévillers,133,0,2999,2999,22.5
61198,Guerquesalles,133,0,961,961,7.2
61252,Mardilly,133,0,961,961,7.2
61351,Roiville,133,0,961,961,7.2
61413,Saint-Lambert-sur-Dive,133,0,281,281,2.1
62090,Béalencourt,133,0,2106,2106,15.8
62101,Beauvois,133,0,2873,2873,21.6
62619,Noreuil,133,0,661,661,5
62876,Warlencourt-Eaucourt,133,0,661,661,5
64341,Lichos,133,0,3456,3456,26
65067,Barry,133,0,1271,1271,9.6
70113,Cenans,133,0,426,426,3.2
73205,Le Pontet,133,0,2378,2378,17.9
79085,Chérigné,133,0,3841,3841,28.9
88063,Bocquegney,133,0,1911,1911,14.4
88416,Saint-Genest,133,0,664,664,5
88452,Senonges,133,0,1034,1034,7.8
88525,Vroville,133,0,1911,1911,14.4
88527,Xaffévillers,133,0,664,664,5
89217,Lalande,133,0,6005,6005,45.2
89270,Mouffy,133,940,6005,6945,52.2
89424,Trucy-sur-Yonne,133,400,18,418,3.1
2271,Dravegny,132,0,3051,3051,23.1
3067,Châtelperron,132,0,2280,2280,17.3
5158,Le Saix,132,0,4940,4940,37.4
6052,Cuébris,132,0,2975,2975,22.5
8344,Prez,132,0,3451,3451,26.1
9114,Erp,132,0,15996,15996,121.2
9192,Miglos,132,0,510,510,3.9
10206,Longsols,132,0,491,491,3.7
11141,Ferran,132,0,391,391,3
11394,Tourreilles,132,0,1738,1738,13.2
12211,Saint-André-de-Vézines,132,0,1364,1364,10.3
15116,Marchastel,132,1195,2036,3231,24.5
19245,Saint-Sylvain,132,0,392,392,3
21077,Bissey-la-Côte,132,0,2202,2202,16.7
21604,Senailly,132,0,2571,2571,19.5
23255,Trois-Fonds,132,0,1984,1984,15
24061,Bourrou,132,4458,737,5195,39.4
24424,Saint-Jean-d'Ataux,132,50,720,770,5.8
25241,Flagey,132,0,962,962,7.3
25414,Le Moutherot,132,0,89,89,0.7
28038,Béthonvilliers,132,0,51,51,0.4
2B296,Sant'Antonino,132,0,0,0,0
30338,Vallérargues,132,0,1014,1014,7.7
31319,Marliac,132,0,694,694,5.3
32017,Aurensan,132,0,4132,4132,31.3
32052,Bezolles,132,0,960,960,7.3
32125,Espas,132,0,88,88,0.7
32184,Lalanne,132,0,75,75,0.6
32220,Luppé-Violles,132,0,88,88,0.7
32383,Saint-Justin,132,0,2433,2433,18.4
38221,Marnans,132,0,1440,1440,10.9
39214,Esserval-Tartre,132,2350,1336,3686,27.9
39468,Rothonay,132,925,3842,4767,36.1
43076,Connangles,132,1400,5492,6892,52.2
46157,Larroque-Toirac,132,0,3898,3898,29.5
52103,Champigny-sous-Varennes,132,0,2603,2603,19.7
52336,Montreuil-sur-Blaise,132,0,1195,1195,9.1
52341,Morancourt,132,0,1195,1195,9.1
53248,Saint-Pierre-sur-Erve,132,0,944,944,7.2
55367,Muzeray,132,0,2412,2412,18.3
55407,Pont-sur-Meuse,132,0,533,533,4
58296,Tresnay,132,0,882,882,6.7
60301,Haucourt,132,0,648,648,4.9
61158,Faverolles,132,1285,753,2038,15.4
61176,Francheville,132,2750,828,3578,27.1
61302,Neauphe-sur-Dive,132,0,279,279,2.1
61393,Saint-Germain-de-Clairefeuille,132,0,954,954,7.2
63216,Mauzun,132,0,1266,1266,9.6
65195,Génos,132,0,6346,6346,48.1
70175,Cornot,132,0,400,400,3
72348,Tassillé,132,0,1199,1199,9.1
80812,Vraignes-en-Vermandois,132,0,946,946,7.2
82004,Asques,132,0,3094,3094,23.4
82074,Gramont,132,0,3094,3094,23.4
86012,Asnois,132,0,2973,2973,22.5
88046,Beauménil,132,0,173,173,1.3
88189,Fréville,132,0,1475,1475,11.2
88219,Greux,132,0,1475,1475,11.2
90024,Chavanatte,132,0,785,785,5.9
1428,Valeins,131,0,27,27,0.2
2137,Bussiares,131,0,3028,3028,23.1
2342,Gergny,131,0,2336,2336,17.8
4087,Fontienne,131,0,2661,2661,20.3
8424,Sommauthe,131,0,3170,3170,24.2
8444,Tétaigne,131,0,4638,4638,35.4
9005,Aleu,131,0,15874,15874,121.2
10138,Épagne,131,0,2766,2766,21.1
14298,Géfosse-Fontenay,131,0,907,907,6.9
15257,Vezels-Roussy,131,2340,4438,6778,51.7
15269,Besse,131,2770,2169,4939,37.7
16325,Saint-Gourson,131,200,2867,3067,23.4
16403,Le Vieux-Cérier,131,370,2695,3065,23.4
18104,Groises,131,0,452,452,3.5
21199,Corsaint,131,0,2782,2782,21.2
25049,Belfays,131,0,913,913,7
26256,Propiac,131,0,6731,6731,51.4
27200,Dardez,131,0,1541,1541,11.8
28193,Havelu,131,0,1313,1313,10
28316,Rohaire,131,0,2339,2339,17.9
31168,Eoux,131,0,2713,2713,20.7
31449,Régades,131,0,2713,2713,20.7
32004,Arblade-le-Bas,131,0,4101,4101,31.3
32116,Duffort,131,0,290,290,2.2
33031,Bassanne,131,0,1067,1067,8.1
34104,Fos,131,0,256,256,2
38255,Montfalcon,131,0,1429,1429,10.9
39262,Gredisans,131,1445,2659,4104,31.3
39278,Largillay-Marsonnay,131,1250,3812,5062,38.6
48088,La Malène,131,0,3213,3213,24.5
50192,Fourneaux,131,0,1938,1938,14.8
51218,Val-de-Vière,131,0,769,769,5.9
51419,Outines,131,0,814,814,6.2
52059,Bonnecourt,131,0,601,601,4.6
52322,Meures,131,0,14389,14389,109.8
54268,Housséville,131,0,0,0,0
54317,Lironville,131,0,782,782,6
55349,Montigny-devant-Sassey,131,0,4737,4737,36.2
57403,Liéhon,131,0,5017,5017,38.3
57436,Malaucourt-sur-Seille,131,0,434,434,3.3
61366,Saint-Aubin-de-Bonneval,131,0,947,947,7.2
62085,Basseux,131,0,3685,3685,28.1
63298,La Renaudie,131,0,3037,3037,23.2
64089,Baleix,131,0,1367,1367,10.4
64263,L'Hôpital-d'Orion,131,0,2738,2738,20.9
65011,Les Angles,131,0,1252,1252,9.6
66029,Caixas,131,0,1756,1756,13.4
70232,Ferrières-lès-Scey,131,0,337,337,2.6
70319,Magny-Jobert,131,0,5758,5758,44
70548,Vernois-sur-Mance,131,0,397,397,3
72383,Vouvray-sur-Huisne,131,0,799,799,6.1
80466,Lanches-Saint-Hilaire,131,0,225,225,1.7
81245,Saint-Christophe,131,0,2997,2997,22.9
82036,Le Causé,131,0,3071,3071,23.4
88168,Fauconcourt,131,0,654,654,5
88406,Rugney,131,0,3294,3294,25.1
89089,Chastellux-sur-Cure,131,850,284,1134,8.7
89128,Coutarnoux,131,0,632,632,4.8
1100,Cheignieu-la-Balme,130,0,1449,1449,11.1
2052,Bassoles-Aulers,130,0,129,129,1
2118,Braye,130,0,256,256,2
2377,Haution,130,0,2318,2318,17.8
2494,Monceau-sur-Oise,130,0,717,717,5.5
2675,Sainte-Croix,130,0,935,935,7.2
6056,Entraunes,130,0,2930,2930,22.5
7208,Saint-Andéol-de-Berg,130,739,4032,4771,36.7
8014,Annelles,130,0,2486,2486,19.1
8071,Blombay,130,0,2024,2024,15.6
8087,Brognon,130,0,3399,3399,26.1
8369,La Romagne,130,0,2851,2851,21.9
8384,Saint-Lambert-et-Mont-de-Jeux,130,0,2851,2851,21.9
10184,Juzanvigny,130,0,774,774,6
11384,Soulatgé,130,0,200,200,1.5
12152,Montfranc,130,0,5087,5087,39.1
14741,Le Vey,130,0,3930,3930,30.2
15017,Badailhac,130,1350,581,1931,14.9
16326,Saint-Groux,130,420,1634,2054,15.8
18051,La Chapelotte,130,0,985,985,7.6
21422,Molphey,130,0,373,373,2.9
21600,Semarey,130,0,1976,1976,15.2
21646,Trouhaut,130,0,0,0,0
25138,Les Terres-de-Chaux,130,828,906,1734,13.3
26270,Rochechinard,130,1404,8142,9546,73.4
2A089,Ciamannacce,130,0,97,97,0.7
2B195,Ortiporio,130,0,602,602,4.6
31095,Cabanac-Cazaux,130,0,6987,6987,53.7
31387,Montoussin,130,0,4553,4553,35
32135,Fustérouau,130,0,1301,1301,10
32187,Lamazère,130,0,1971,1971,15.2
37071,Chezelles,130,0,3527,3527,27.1
42281,Saint-Rirand,130,0,3836,3836,29.5
43050,Chambezon,130,1200,1456,2656,20.4
50050,Beuvrigny,130,0,1923,1923,14.8
50126,Chavoy,130,0,3199,3199,24.6
52029,Autigny-le-Grand,130,0,481,481,3.7
54041,Bagneux,130,0,4310,4310,33.2
54224,Germonville,130,0,0,0,0
54301,Lanfroicourt,130,0,769,769,5.9
55066,Bovée-sur-Barboure,130,0,525,525,4
55425,Remoiville,130,0,4648,4648,35.8
55428,Réville-aux-Bois,130,0,2376,2376,18.3
55557,Ville-en-Woëvre,130,0,1683,1683,12.9
55584,Woimbey,130,0,1760,1760,13.5
58181,Moraches,130,0,2022,2022,15.6
60296,Hannaches,130,0,638,638,4.9
60621,Solente,130,0,1137,1137,8.7
61010,Aubry-le-Panthou,130,887,940,1827,14.1
61367,Saint-Aubin-de-Courteraie,130,1350,456,1806,13.9
62809,Ternas,130,0,2808,2808,21.6
62840,Vélu,130,0,646,646,5
64354,Louvie-Soubiron,130,0,1650,1650,12.7
66007,Arboussols,130,0,3894,3894,30
66039,Caramany,130,0,3179,3179,24.5
70342,Mercey-sur-Saône,130,0,667,667,5.1
71217,Germolles-sur-Grosne,130,0,1767,1767,13.6
76501,Pierrefiques,130,0,1173,1173,9
76724,Vatierville,130,0,3037,3037,23.4
79165,Maisontiers,130,0,3325,3325,25.6
80514,Marieux,130,0,145,145,1.1
80665,Regnière-Écluse,130,0,3219,3219,24.8
88213,La Grande-Fosse,130,0,1264,1264,9.7
88239,Hergugney,130,0,3269,3269,25.1
89181,Fournaudin,130,600,252,852,6.6
2406,Landricourt,129,0,128,128,1
2417,Lempire,129,0,1169,1169,9.1
2777,Vendières,129,0,70,70,0.5
3243,Saint-Marcel-en-Murat,129,0,4609,4609,35.7
4202,Sausses,129,0,4561,4561,35.4
8109,Chatel-Chéhéry,129,0,3121,3121,24.2
8247,Landrichamps,129,0,828,828,6.4
10414,Villeloup,129,0,1842,1842,14.3
12293,Veyreau,129,0,1333,1333,10.3
14457,Les Moutiers-en-Auge,129,0,2021,2021,15.7
16177,Ladiville,129,2130,6898,9028,70
21176,Civry-en-Montagne,129,0,1961,1961,15.2
25129,Chassagne-Saint-Denis,129,0,940,940,7.3
2B187,Olmeta-di-Capocorso,129,0,4731,4731,36.7
2B287,Sorio,129,0,780,780,6
39375,Moutonne,129,1025,3754,4779,37
40171,Mano,129,0,1015,1015,7.9
41261,Tourailles,129,0,1596,1596,12.4
43031,Blassac,129,1690,1175,2865,22.2
45237,Orville,129,0,978,978,7.6
46026,Belmont-Sainte-Foi,129,0,725,725,5.6
46302,Sénaillac-Latronquière,129,0,3809,3809,29.5
51517,Saint-Souplet-sur-Py,129,0,2293,2293,17.8
52420,Reynel,129,0,1985,1985,15.4
52426,Rizaucourt-Buchey,129,0,14170,14170,109.8
52450,Saint-Loup-sur-Aujon,129,0,1598,1598,12.4
55384,Nicey-sur-Aire,129,0,1746,1746,13.5
57220,Flocourt,129,0,4940,4940,38.3
57573,Réning,129,0,427,427,3.3
61039,La Bellière,129,710,809,1519,11.8
62231,Colline-Beaumont,129,0,1372,1372,10.6
62762,Saint-Michel-sous-Bois,129,0,7634,7634,59.2
65191,Gazost,129,0,1232,1232,9.6
70106,Buffignécourt,129,0,766,766,5.9
70194,Cuve,129,0,820,820,6.4
70233,Les Fessey,129,0,1484,1484,11.5
70567,Villers-sur-Saulnot,129,0,842,842,6.5
71386,Saint-André-en-Bresse,129,0,531,531,4.1
72037,Blèves,129,0,2392,2392,18.5
76504,Pleine-Sève,129,0,835,835,6.5
78608,Le Tertre-Saint-Denis,129,0,1201,1201,9.3
80428,Hem-Monacu,129,0,924,924,7.2
81243,Saint-Beauzile,129,0,7088,7088,54.9
88441,Sans-Vallois,129,0,1003,1003,7.8
89184,Fulvy,129,445,300,745,5.8
91112,Brouy,129,0,325,325,2.5
2048,Barenton-sur-Serre,128,0,645,645,5
2182,Chevennes,128,0,2283,2283,17.8
3077,Chirat-l'Église,128,0,2618,2618,20.5
3170,Meillers,128,0,1966,1966,15.4
3244,Saint-Marcel-en-Marcillat,128,0,3013,3013,23.5
4140,Les Omergues,128,0,2819,2819,22
8062,Bertoncourt,128,0,2448,2448,19.1
8283,Mazerny,128,0,2807,2807,21.9
8374,La Sabotterie,128,0,2807,2807,21.9
9180,Manses,128,0,2651,2651,20.7
10073,Chalette-sur-Voire,128,0,2702,2702,21.1
10192,Lentilles,128,0,2702,2702,21.1
10283,Pel-et-Der,128,0,2702,2702,21.1
10365,Salon,128,0,132,132,1
11161,Gardie,128,0,1685,1685,13.2
11167,Gramazie,128,648,1685,2333,18.2
14110,Brucourt,128,0,1626,1626,12.7
14619,Sainte-Marie-Outre-l'Eau,128,0,58,58,0.5
16048,Boisbreteau,128,0,6844,6844,53.5
21253,Étalante,128,0,2136,2136,16.7
21275,Foncegrive,128,0,88,88,0.7
21580,Salmaise,128,0,0,0,0
24209,Hautefaye,128,580,858,1438,11.2
27094,Bosquentin,128,0,842,842,6.6
27659,La Trinité,128,0,1505,1505,11.8
2A360,Zigliara,128,0,96,96,0.8
31021,Aspret-Sarrat,128,0,2651,2651,20.7
31370,Montégut-Bourjac,128,0,4482,4482,35
32057,Blaziert,128,0,492,492,3.8
39254,Gillois,128,750,1296,2046,16
40169,Maillas,128,0,1462,1462,11.4
43066,Chaudeyrolles,128,3400,710,4110,32.1
43073,Cistrières,128,1520,5326,6846,53.5
45218,Le Moulinet-sur-Solin,128,0,1657,1657,12.9
47050,Cassignas,128,0,981,981,7.7
48117,Pourcharesses,128,6481,2594,9075,70.9
48131,Le Rozier,128,0,1323,1323,10.3
49236,Passavant-sur-Layon,128,0,5319,5319,41.6
51173,Cormoyeux,128,0,185,185,1.4
52106,Chanoy,128,0,587,587,4.6
57524,Ommeray,128,0,424,424,3.3
58061,Chasnay,128,0,7224,7224,56.4
59661,Willies,128,0,2100,2100,16.4
61137,Craménil,128,0,730,730,5.7
61323,Le Pas-Saint-l'Homer,128,1995,545,2540,19.8
62381,Gouy-en-Ternois,128,0,2765,2765,21.6
64012,Ainharp,128,0,3326,3326,26
65094,Bizous,128,0,838,838,6.5
65319,Montégut,128,0,838,838,6.5
65423,Sère-Rustaing,128,0,4146,4146,32.4
70218,Esmoulins,128,0,646,646,5
70238,Fleurey-lès-Saint-Loup,128,0,813,813,6.4
71057,Bray,128,2400,890,3290,25.7
73254,Sainte-Marie-d'Alvey,128,0,190,190,1.5
76241,Ermenouville,128,0,829,829,6.5
76572,Saint-Denis-d'Aclon,128,0,1033,1033,8.1
80041,Aumont,128,0,177,177,1.4
80223,Crémery,128,0,155,155,1.2
80292,Étalon,128,0,155,155,1.2
81017,Arifat,128,0,2670,2670,20.9
82064,Gariès,128,0,3000,3000,23.4
87195,Tersannes,128,600,2179,2779,21.7
88226,Hagécourt,128,0,1840,1840,14.4
88419,Saint-Jean-d'Ormont,128,0,1244,1244,9.7
88485,La Vacheresse-et-la-Rouillie,128,0,45,45,0.4
90027,Courcelles,128,0,761,761,5.9
95157,Chérence,128,0,809,809,6.3
1076,Chaley,127,0,2167,2167,17.1
2466,Marizy-Sainte-Geneviève,127,0,122,122,1
2579,Oulchy-la-Ville,127,0,424,424,3.3
2641,Renneval,127,0,1399,1399,11
4118,Melve,127,0,3786,3786,29.8
4214,Tartonne,127,0,4491,4491,35.4
6082,Massoins,127,0,2862,2862,22.5
9281,Sautel,127,0,1128,1128,8.9
9318,Unac,127,6300,18290,24590,193.6
10400,Vaupoisson,127,0,108,108,0.9
10408,Viâpres-le-Petit,127,0,131,131,1
11075,Castans,127,0,824,824,6.5
11381,Sougraigne,127,1550,1672,3222,25.4
12269,La Serre,127,0,4969,4969,39.1
19165,Peyrissac,127,0,2211,2211,17.4
19174,La Roche-Canillac,127,0,2410,2410,19
21293,Gergueil,127,0,714,714,5.6
24287,Montaut,127,1000,238,1238,9.7
28271,Morvilliers,127,0,2267,2267,17.9
29289,Trégarvan,127,0,2002,2002,15.8
31058,Belbèze-de-Lauragais,127,0,2071,2071,16.3
31394,Moustajon,127,0,1216,1216,9.6
31493,Saint-Lary-Boujean,127,0,2631,2631,20.7
31524,Salles-et-Pratviel,127,0,1216,1216,9.6
31546,Seyre,127,0,619,619,4.9
32354,Sabazan,127,0,1271,1271,10
33526,Tayac,127,0,4934,4934,38.9
37275,Villedômain,127,1701,2205,3906,30.8
43090,Esplantas-Vazeilles,127,0,1156,1156,9.1
50609,Turqueville,127,0,688,688,5.4
51201,Cuisles,127,0,2257,2257,17.8
52453,Saint-Maurice,127,0,583,583,4.6
55026,Badonvilliers-Gérauvilliers,127,0,2482,2482,19.5
55037,Beaufort-en-Argonne,127,0,4592,4592,36.2
55196,Frémeréville-sous-les-Côtes,127,0,1509,1509,11.9
55560,Villers-aux-Vents,127,0,2819,2819,22.2
55562,Villers-le-Sec,127,0,2482,2482,19.5
59240,Floursies,127,0,1006,1006,7.9
61290,Montreuil-au-Houlme,127,0,725,725,5.7
62453,Hézecques,127,0,7515,7515,59.2
62725,Royon,127,0,7515,7515,59.2
62857,Villers-Châtel,127,0,1055,1055,8.3
63367,Saint-Jean-Saint-Gervais,127,0,826,826,6.5
64229,Gamarthe,127,0,3300,3300,26
66068,Escaro,127,0,3804,3804,30
70490,Servigney,127,0,470,470,3.7
70536,Velle-le-Châtel,127,0,326,326,2.6
79341,Vautebis,127,0,3330,3330,26.2
80349,Fransures,127,0,780,780,6.1
80401,Guillemont,127,0,910,910,7.2
80753,Thiepval,127,4000,142,4142,32.6
84059,Lafare,127,0,4147,4147,32.7
87101,Mortemart,127,400,2161,2561,20.2
2254,Cutry,126,0,121,121,1
2316,Fleury,126,0,121,121,1
2395,Jumencourt,126,0,125,125,1
2557,Noroy-sur-Ourcq,126,0,121,121,1
4092,La Garde,126,0,4455,4455,35.4
9140,Ignaux,126,0,18146,18146,144
14080,Le Bô,126,0,3809,3809,30.2
16103,Combiers,126,530,5925,6455,51.2
18098,Gardefort,126,0,2270,2270,18
19009,Les Angles-sur-Corrèze,126,48,2391,2439,19.4
23212,Saint-Marc-à-Loubaud,126,0,4765,4765,37.8
24422,Saint-Hilaire-d'Estissac,126,1000,6033,7033,55.8
24528,Sceau-Saint-Angel,126,0,844,844,6.7
2B107,Ersa,126,0,4621,4621,36.7
31300,Lieoux,126,0,2610,2610,20.7
32014,Augnax,126,0,4440,4440,35.2
32356,Saint-André,126,0,786,786,6.2
32361,Saint-Arroman,126,0,1487,1487,11.8
32391,Saint-Martin-de-Goyne,126,0,72,72,0.6
32450,Tourdun,126,0,2323,2323,18.4
36038,Champillet,126,0,2768,2768,22
39142,Chevreaux,126,0,1921,1921,15.2
39432,Pointre,126,250,2557,2807,22.3
41163,Nourray,126,0,1558,1558,12.4
46190,Mechmont,126,0,1064,1064,8.4
48160,Saint-Jean-la-Fouillouse,126,850,1484,2334,18.5
51106,Cernon,126,0,210,210,1.7
52069,Braux-le-Châtel,126,0,691,691,5.5
52221,Gillancourt,126,0,13840,13840,109.8
54589,Vittonville,126,0,1377,1377,10.9
55143,Damloup,126,0,2276,2276,18.1
55149,Delut,126,0,2303,2303,18.3
58170,Monceaux-le-Comte,126,0,1959,1959,15.5
61331,Le Plantis,126,3850,44,3894,30.9
62283,Écoivres,126,0,2722,2722,21.6
62347,Fosseux,126,0,1047,1047,8.3
63117,Compains,126,0,920,920,7.3
63339,Saint-Étienne-des-Champs,126,0,4261,4261,33.8
64326,Lay-Lamidou,126,0,2634,2634,20.9
64508,Saucède,126,0,2713,2713,21.5
65182,Gaillagos,126,0,5160,5160,41
70005,Aillevans,126,0,40,40,0.3
70520,Vanne,126,0,647,647,5.1
70557,Villefrancon,126,0,0,0,0
76016,Anglesqueville-la-Bras-Long,126,0,816,816,6.5
76458,Muchedent,126,0,1017,1017,8.1
77395,Rumont,126,0,64,64,0.5
79331,Tourtenay,126,0,1960,1960,15.6
80097,Béthencourt-sur-Somme,126,0,2402,2402,19.1
80224,Cressy-Omencourt,126,0,152,152,1.2
80272,Épénancourt,126,0,2402,2402,19.1
80280,Ercourt,126,0,838,838,6.7
80648,Pys,126,0,141,141,1.1
80833,Yvrencheux,126,0,3120,3120,24.8
82078,Labastide-de-Penne,126,0,3725,3725,29.6
82091,Lamothe-Cumont,126,0,2954,2954,23.4
82164,Sainte-Juliette,126,0,3945,3945,31.3
88194,Gemmelaincourt,126,0,44,44,0.3
88280,Madegney,126,0,1811,1811,14.4
88291,Martinvelle,126,0,979,979,7.8
88347,Pierrefitte,126,0,1811,1811,14.4
2170,Châtillon-sur-Oise,125,0,0,0,0
2256,Dagny-Lambercy,125,0,1377,1377,11
2297,Étrépilly,125,0,2889,2889,23.1
2594,Passy-en-Valois,125,0,120,120,1
3172,Mesples,125,0,509,509,4.1
3245,Saint-Martin-des-Lais,125,0,1683,1683,13.5
4005,Allons,125,0,4420,4420,35.4
4201,Saumane,125,0,329,329,2.6
7106,Issarlès,125,0,977,977,7.8
7257,Saint-Julien-le-Roux,125,2634,417,3051,24.4
8277,Marlemont,125,0,3268,3268,26.1
9059,Bonac-Irazein,125,0,15147,15147,121.2
10117,Crespy-le-Neuf,125,0,744,744,6
10126,Dolancourt,125,0,744,744,6
10327,La Rothière,125,0,744,744,6
12261,Saujac,125,0,365,365,2.9
13090,Saint-Antonin-sur-Bayon,125,0,3513,3513,28.1
16095,Chenon,125,0,1571,1571,12.6
17473,Villemorin,125,0,3482,3482,27.9
21079,Blagny-sur-Vingeanne,125,0,544,544,4.4
21081,Blaisy-Haut,125,0,703,703,5.6
21098,Boux-sous-Salmaise,125,0,0,0,0
21211,Crécey-sur-Tille,125,0,1779,1779,14.2
21467,Oisilly,125,0,544,544,4.4
23042,Ceyroux,125,0,692,692,5.5
25266,Geney,125,0,288,288,2.3
25516,Saint-Georges-Armont,125,0,288,288,2.3
25584,Valoreille,125,0,871,871,7
27330,Herqueville,125,0,3707,3707,29.7
31469,Saint-Araille,125,0,4377,4377,35
32037,Beaumont,125,0,481,481,3.8
32114,Cuélas,125,0,1475,1475,11.8
32357,Sainte-Anne,125,0,472,472,3.8
37268,Verneuil-le-Château,125,0,3392,3392,27.1
39527,Taxenne,125,360,1973,2333,18.7
41274,Villavard,125,0,1546,1546,12.4
48036,Cassagnas,125,0,3066,3066,24.5
50022,Aumeville-Lestre,125,500,3932,4432,35.5
52013,Anrosey,125,0,2465,2465,19.7
54337,Malavillers,125,0,551,551,4.4
55226,Han-lès-Juvigny,125,0,4469,4469,35.8
55510,Thonne-les-Près,125,0,4469,4469,35.8
57268,Guébling,125,0,414,414,3.3
61048,Boëcé,125,2535,439,2974,23.8
61439,Saint-Ouen-le-Brisoult,125,773,562,1335,10.7
61461,Le Sap-André,125,0,904,904,7.2
64418,Noguères,125,0,3366,3366,26.9
70082,Bouhans-lès-Montbozon,125,0,400,400,3.2
76381,Landes-Vieilles-et-Neuves,125,0,2,2,0
76730,Veauville-lès-Quelles,125,0,810,810,6.5
80738,Soues,125,0,215,215,1.7
88180,Frain,125,0,972,972,7.8
88333,Nossoncourt,125,0,624,624,5
89296,Perrigny-sur-Armançon,125,1900,290,2190,17.5
89470,Villiers-les-Hauts,125,700,290,990,7.9
4020,Barles,124,0,5197,5197,41.9
4237,Le Vernet,124,0,5197,5197,41.9
7154,Mazan-l'Abbaye,124,6300,970,7270,58.6
8223,Herbeuval,124,0,4390,4390,35.4
8364,Rilly-sur-Aisne,124,0,2720,2720,21.9
8396,Saint-Quentin-le-Petit,124,0,2371,2371,19.1
9127,Gabre,124,0,2205,2205,17.8
9142,Ilhat,124,0,1101,1101,8.9
9234,Pradières,124,0,3333,3333,26.9
11205,Limousis,124,0,804,804,6.5
11334,Sainte-Camelle,124,0,1090,1090,8.8
15125,Mentières,124,950,2743,3693,29.8
15182,Saint-Étienne-Cantalès,124,6754,1087,7841,63.2
15183,Saint-Étienne-de-Carlat,124,2310,554,2864,23.1
16335,Saint-Martin-du-Clocher,124,981,2714,3695,29.8
19104,Lamongerie,124,0,0,0,0
21701,Villers-Rotin,124,0,0,0,0
22334,Saint-Igeaux,124,0,11419,11419,92.1
23259,Verneiges,124,0,1864,1864,15
25252,Fourcatier-et-Maison-Neuve,124,0,7385,7385,59.6
25604,Verne,124,0,6181,6181,49.8
2B095,Corscia,124,0,466,466,3.8
2B175,Nessa,124,0,1740,1740,14
30236,Saint-Bonnet-de-Salendrinque,124,0,3876,3876,31.3
32030,Bars,124,0,1880,1880,15.2
32263,Moncassin,124,0,274,274,2.2
33420,Saint-Hippolyte,124,0,4818,4818,38.9
36049,Chazelet,124,0,682,682,5.5
39342,Monay,124,390,2743,3133,25.3
43006,Ally,124,11330,1129,12459,100.5
46147,Lagardelle,124,0,4509,4509,36.4
51156,Cloyes-sur-Marne,124,0,770,770,6.2
51442,Possesse,124,0,728,728,5.9
51528,Scrupt,124,0,770,770,6.2
52070,Brennes,124,0,1536,1536,12.4
52213,Genevrières,124,0,2446,2446,19.7
52260,Lamancine,124,0,13621,13621,109.8
52415,Rançonnières,124,0,569,569,4.6
54543,Vallois,124,0,548,548,4.4
54562,Verdenal,124,0,440,440,3.5
55138,Culey,124,0,1495,1495,12.1
57579,Rhodes,124,0,807,807,6.5
58174,Montenoison,124,0,6998,6998,56.4
58294,Toury-sur-Jour,124,0,829,829,6.7
63329,Sainte-Christine,124,0,192,192,1.5
71284,Martailly-lès-Brancion,124,0,2886,2886,23.3
71503,Saules,124,0,1902,1902,15.3
79350,Villiers-en-Bois,124,0,3581,3581,28.9
80038,Auchonvillers,124,0,139,139,1.1
80602,Occoches,124,0,483,483,3.9
85136,Marillet,124,590,2709,3299,26.6
86249,Saires,124,0,633,633,5.1
86266,Surin,124,0,2792,2792,22.5
87004,Augne,124,0,1766,1766,14.2
88051,Belmont-sur-Vair,124,0,44,44,0.4
88139,Dombasle-en-Xaintois,124,0,1782,1782,14.4
88491,Les Vallois,124,0,964,964,7.8
2136,Burelles,123,0,2193,2193,17.8
2227,Courmont,123,0,2843,2843,23.1
2490,Monampteuil,123,0,243,243,2
4190,Saint-Martin-les-Eaux,123,6500,324,6824,55.5
8219,Hauteville,123,0,2352,2352,19.1
8440,Tarzy,123,0,3216,3216,26.1
9017,Arrien-en-Bethmale,123,0,14905,14905,121.2
10054,Bourdenay,123,0,0,0,0
14087,Bonnœil,123,0,1927,1927,15.7
15224,La Ségalassière,123,2500,1078,3578,29.1
16203,Mainzac,123,330,2193,2523,20.5
23128,Mazeirat,123,0,2009,2009,16.3
24052,Bouillac,123,1100,447,1547,12.6
24123,Clermont-de-Beauregard,123,4222,5890,10112,82.2
25231,Eysson,123,0,1453,1453,11.8
25385,Montagney-Servigney,123,0,284,284,2.3
25554,Surmont,123,0,3391,3391,27.6
26135,Ferrassières,123,0,1996,1996,16.2
27173,Corneville-la-Fouquetière,123,0,530,530,4.3
32176,Lagarde,123,0,70,70,0.6
32278,Montaut,123,0,272,272,2.2
32325,Pouydraguin,123,0,1231,1231,10
32408,Salles-d'Armagnac,123,0,82,82,0.7
33152,Donzac,123,0,3772,3772,30.7
34283,Saint-Pierre-de-la-Fage,123,0,1381,1381,11.2
39122,Châtillon,123,0,3580,3580,29.1
40041,Beyries,123,0,334,334,2.7
43143,Montusclat,123,0,682,682,5.5
51113,Champaubert,123,0,178,178,1.4
51229,Épense,123,0,1826,1826,14.8
51350,Margny,123,0,3952,3952,32.1
52290,Les Loges,123,0,2426,2426,19.7
55206,Gercourt-et-Drillancourt,123,0,1286,1286,10.5
55437,Romagne-sous-les-Côtes,123,0,2248,2248,18.3
55503,Taillancourt,123,0,496,496,4
57027,Arraincourt,123,0,5708,5708,46.4
57120,Burlioncourt,123,0,407,407,3.3
58009,Arbourse,123,0,6942,6942,56.4
62370,Gennes-Ivergny,123,0,2657,2657,21.6
70298,Lavigney,123,0,372,372,3
70366,Villers-Chemin-et-Mont-lès-Étrelles,123,0,556,556,4.5
70509,Tromarey,123,0,83,83,0.7
70534,Vellefrie,123,0,730,730,5.9
71466,Saint-Nizier-sur-Arroux,123,0,2752,2752,22.4
77200,Garentreville,123,0,63,63,0.5
80181,Cayeux-en-Santerre,123,0,756,756,6.1
81012,Andillac,123,0,6758,6758,54.9
88466,They-sous-Montfort,123,0,43,43,0.3
89210,Jully,123,150,286,436,3.5
89423,Tronchoy,123,1480,286,1766,14.4
2451,Magny-la-Fosse,122,0,1105,1105,9.1
2774,Vendelles,122,0,1105,1105,9.1
3125,La Guillermie,122,0,3342,3342,27.4
4024,Beaujeu,122,0,5114,5114,41.9
5044,Crévoux,122,0,9749,9749,79.9
9004,Albiès,122,5530,17570,23100,189.3
15007,Anterrieux,122,2640,2698,5338,43.8
15238,Tournemire,122,2600,2020,4620,37.9
21289,Fussey,122,0,585,585,4.8
24161,Église-Neuve-d'Issac,122,3500,5842,9342,76.6
25286,Grand'Combe-des-Bois,122,0,2049,2049,16.8
25306,L'Hôpital-Saint-Lieffroy,122,0,281,281,2.3
27149,La Chapelle-Hareng,122,0,1879,1879,15.4
27418,Morsan,122,0,526,526,4.3
27545,Saint-Germain-de-Pasquier,122,0,3618,3618,29.7
2B231,Pigna,122,0,1712,1712,14
31092,Burgalays,122,0,1168,1168,9.6
32039,Beccas,122,0,270,270,2.2
32129,Estramiac,122,0,460,460,3.8
32461,Verlus,122,0,1221,1221,10
33135,Courpiac,122,0,1212,1212,9.9
36024,Bretagne,122,0,20,20,0.2
36136,Murs,122,0,3047,3047,25
39120,Châtelneuf,122,2146,1235,3381,27.7
45183,Lion-en-Beauce,122,185,172,357,2.9
45231,Oison,122,0,444,444,3.6
46036,Le Bouyssou,122,0,3603,3603,29.5
46249,Saint-Bressou,122,0,3603,3603,29.5
48037,Chadenet,122,2213,2472,4685,38.4
50548,Saint-Sauveur-de-Pierrepont,122,0,2549,2549,20.9
51283,Hans,122,0,1812,1812,14.9
51292,Herpont,122,0,1812,1812,14.9
52273,Larivière-Arnoncourt,122,0,2406,2406,19.7
52517,Vesaignes-sous-Lafauche,122,0,1877,1877,15.4
54522,Thorey-Lyautey,122,0,0,0,0
55193,Forges-sur-Meuse,122,0,1276,1276,10.5
57727,Viviers,122,0,404,404,3.3
58093,Cuncy-lès-Varzy,122,0,2553,2553,20.9
58139,Lanty,122,0,6293,6293,51.6
60078,Blincourt,122,1200,114,1314,10.8
61500,La Ventrouze,122,3339,520,3859,31.6
64414,Narp,122,0,2550,2550,20.9
66080,Fontpédrouse,122,0,3654,3654,30
69016,Azolette,122,0,0,0,0
70466,Saint-Loup-Nantouard,122,0,616,616,5
70524,Vauchoux,122,0,725,725,5.9
71067,Burnand,122,0,1871,1871,15.3
71406,Saint-Didier-en-Brionnais,122,0,3457,3457,28.3
79158,Luché-sur-Brioux,122,0,3523,3523,28.9
80206,Contalmaison,122,0,136,136,1.1
80823,Warvillers,122,0,2208,2208,18.1
81103,Gijounet,122,0,2158,2158,17.7
82034,Castéra-Bouzet,122,0,2860,2860,23.4
87200,Verneuil-Moustiers,122,3480,2076,5556,45.5
88300,Ménil-de-Senones,122,0,1186,1186,9.7
88377,Regnévelle,122,0,948,948,7.8
89165,Flacy,122,0,237,237,1.9
2178,Chermizy-Ailles,121,0,870,870,7.2
2311,Filain,121,0,0,0,0
2378,La Hérie,121,0,2375,2375,19.6
4028,Beynes,121,0,5072,5072,41.9
6098,Puget-Rostang,121,0,2727,2727,22.5
7108,Jaunac,121,1359,2587,3946,32.6
8099,Champigneul-sur-Vence,121,0,2654,2654,21.9
8503,Yvernaumont,121,0,2654,2654,21.9
9115,Esclagne,121,0,2506,2506,20.7
11113,Cucugnan,121,0,186,186,1.5
12122,Lapanouse-de-Cernon,121,0,5181,5181,42.8
14041,Barneville-la-Bertran,121,0,904,904,7.5
14494,Périers-en-Auge,121,0,1537,1537,12.7
15209,Saint-Rémy-de-Chaudes-Aigues,121,1870,2676,4546,37.6
16108,Coulonges,121,850,1521,2371,19.6
16334,Saint-Martial,121,1627,5690,7317,60.5
16396,Ventouse,121,0,1521,1521,12.6
18238,Saint-Vitte,121,0,324,324,2.7
21181,Clomot,121,0,3732,3732,30.8
21187,Commarin,121,0,1839,1839,15.2
21647,Trugny,121,0,907,907,7.5
22108,Lanleff,121,0,2167,2167,17.9
23172,La Serre-Bussière-Vieille,121,0,1589,1589,13.1
25141,Chaux-lès-Passavant,121,0,1429,1429,11.8
25178,Crosey-le-Petit,121,0,3336,3336,27.6
26069,Chamaloc,121,500,6727,7227,59.7
27184,Crasville,121,0,3588,3588,29.7
28197,Intréville,121,0,636,636,5.3
2A326,Tolla,121,0,1652,1652,13.7
2B069,Casabianca,121,0,560,560,4.6
31326,Massabrac,121,0,208,208,1.7
31405,Ore,121,0,1158,1158,9.6
36083,Giroux,121,0,2458,2458,20.3
39095,Champagne-sur-Loue,121,768,1172,1940,16
39196,Les Deux-Fays,121,550,3216,3766,31.1
41108,Lancôme,121,0,4637,4637,38.3
46206,Montlauzun,121,0,2974,2974,24.6
51628,Villeneuve-Saint-Vistre-et-Villevotte,121,0,1579,1579,13
54101,Brouville,121,0,535,535,4.4
54133,Coincourt,121,0,1815,1815,15
54216,Froville,121,0,500,500,4.1
55023,Avocourt,121,0,1265,1265,10.5
55142,Dainville-Bertheléville,121,0,2365,2365,19.5
55254,Les Trois-Domaines,121,0,1638,1638,13.5
57081,Bidestroff,121,0,400,400,3.3
60525,Raray,121,0,0,0,0
60691,Villers-Vermont,121,0,594,594,4.9
61257,Méhoudin,121,520,544,1064,8.8
61425,Saint-Martin-des-Pézerits,121,1000,425,1425,11.8
61492,Trémont,121,560,43,603,5
62103,Béhagnies,121,0,602,602,5
62541,Maisoncelle,121,0,1916,1916,15.8
63111,Clémensat,121,0,787,787,6.5
64468,Roquiague,121,0,3144,3144,26
65103,Bouilh-Péreuilh,121,0,768,768,6.3
65228,Ilhet,121,0,5817,5817,48.1
65387,Saint-Lanne,121,0,2733,2733,22.6
70052,Bassigney,121,0,769,769,6.4
70138,Chassey-lès-Scey,121,0,311,311,2.6
70362,Montigny-lès-Cherlieu,121,0,366,366,3
70364,Montjustin-et-Velotte,121,0,448,448,3.7
70445,Rignovelle,121,0,448,448,3.7
76084,Bertreville,121,0,784,784,6.5
76309,Gonzeville,121,0,267,267,2.2
80042,Autheux,121,0,472,472,3.9
80402,Guizancourt,121,0,167,167,1.4
80414,Hangard,121,0,743,743,6.1
80778,Vauchelles-lès-Domart,121,0,208,208,1.7
82100,Loze,121,0,1711,1711,14.1
88494,Vaubexy,121,0,1739,1739,14.4
89386,Sennevoy-le-Haut,121,250,281,531,4.4
2276,Englancourt,120,0,2140,2140,17.8
2429,Lierval,120,0,4583,4583,38.2
2664,Rozoy-Bellevalle,120,0,2774,2774,23.1
2742,Thiernu,120,0,605,605,5
4171,Rougon,120,0,4243,4243,35.4
7263,Saint-Laurent-sous-Coiron,120,0,3722,3722,31
8017,Apremont,120,0,2904,2904,24.2
8049,Bar-lès-Buzancy,120,0,2904,2904,24.2
9153,Lapenne,120,0,2486,2486,20.7
10147,Fays-la-Chapelle,120,0,1714,1714,14.3
10226,Marolles-lès-Bailly,120,0,2095,2095,17.5
10439,Viviers-sur-Artaut,120,0,2095,2095,17.5
11290,Plaigne,120,0,355,355,3
12022,La Bastide-Pradines,120,0,5138,5138,42.8
14622,Saint-Martin-de-Blagny,120,0,831,831,6.9
15059,Cussac,120,1025,2654,3679,30.7
15251,Védrines-Saint-Loup,120,3000,2654,5654,47.1
15254,Veyrières,120,7614,614,8228,68.6
17156,Expiremont,120,0,1417,1417,11.8
21068,Beurey-Bauguay,120,0,1824,1824,15.2
21083,Blanot,120,0,3701,3701,30.8
21222,Cussy-le-Châtel,120,0,3701,3701,30.8
21537,Saffres,120,0,2548,2548,21.2
23194,Sainte-Feyre-la-Montagne,120,0,4538,4538,37.8
25194,Dannemarie,120,0,7596,7596,63.3
26263,Reilhanette,120,0,6166,6166,51.4
2A141,Letia,120,0,553,553,4.6
30323,Soustelle,120,0,3751,3751,31.3
31198,Le Fréchet,120,0,6449,6449,53.7
31485,Saint-Germier,120,0,585,585,4.9
39469,Rouffange,120,0,1894,1894,15.8
39486,Saint-Lamain,120,100,3189,3289,27.4
40073,Castelner,120,0,2772,2772,23.1
51146,Cheniers,120,0,6099,6099,50.8
55022,Avioth,120,0,4290,4290,35.8
55108,Chaumont-sur-Aire,120,0,1624,1624,13.5
55301,Longchamps-sur-Aire,120,0,1624,1624,13.5
58123,Germenay,120,0,1866,1866,15.6
61268,Ménil-Hubert-en-Exmes,120,1070,867,1937,16.1
63369,Saint-Julien-la-Geneste,120,0,186,186,1.6
64113,Bergouey-Viellenave,120,0,3118,3118,26
64206,Escot,120,0,2584,2584,21.5
65041,Asque,120,0,358,358,3
66034,Campôme,120,0,3594,3594,30
67513,Waldersbach,120,1550,8684,10234,85.3
70182,Courmont,120,0,784,784,6.5
70214,Équevilley,120,0,713,713,5.9
70244,Fouchécourt,120,0,363,363,3
71457,Saint-Martin-en-Gâtinois,120,0,1385,1385,11.5
77342,Obsonville,120,0,126,126,1
80450,Inval-Boiron,120,0,166,166,1.4
80451,Irles,120,0,134,134,1.1
80543,Métigny,120,0,166,166,1.4
80550,Mirvaux,120,0,468,468,3.9
81246,Sainte-Cécile-du-Cayrou,120,0,6593,6593,54.9
82193,Vigueron,120,0,2813,2813,23.4
84120,Saint-Trinit,120,0,1947,1947,16.2
88388,Renauvoid,120,0,3018,3018,25.2
88505,Vienville,120,0,1167,1167,9.7
90016,Bourg-sous-Châtelet,120,0,3574,3574,29.8
1277,Nivollet-Montgriffon,119,0,2031,2031,17.1
2007,Aizelles,119,0,855,855,7.2
2550,Neuville-sur-Ailette,119,0,855,855,7.2
7203,Sagnes-et-Goudoulet,119,0,930,930,7.8
7242,Saint-Gineys-en-Coiron,119,728,3691,4419,37.1
8324,Neuvizy,119,0,2610,2610,21.9
9169,Limbrassac,119,0,2465,2465,20.7
9319,Unzent,119,0,536,536,4.5
14404,Martainville,119,0,3598,3598,30.2
15110,Lugarde,119,0,1835,1835,15.4
15128,La Monselie,119,2673,609,3282,27.6
16041,Bessac,119,1400,5596,6996,58.8
16284,Rouffiac,119,150,5596,5746,48.3
17177,Le Gicq,119,0,3315,3315,27.9
18107,La Groutte,119,1500,524,2024,17
21065,Bessey-en-Chaume,119,0,1809,1809,15.2
21146,Charmes,119,0,518,518,4.4
21167,Cheuge,119,0,518,518,4.4
23233,Saint-Pierre-le-Bost,119,0,1789,1789,15
23251,Tardes,119,0,1789,1789,15
25094,Bretigney-Notre-Dame,119,0,5932,5932,49.8
25386,Montancy,119,0,829,829,7
25499,Romain,119,0,274,274,2.3
26268,Rochebaudin,119,0,4149,4149,34.9
27291,Gournay-le-Guérin,119,0,3347,3347,28.1
2B059,Canavaggia,119,0,447,447,3.8
32055,Bivès,119,0,449,449,3.8
32141,Gaujan,119,0,1512,1512,12.7
32332,Préneron,119,0,865,865,7.3
33513,Sillas,119,0,40,40,0.3
36090,Jeu-Maloches,119,0,1494,1494,12.6
38355,Saint-Andéol,119,0,3334,3334,28
39466,Rosay,119,470,1815,2285,19.2
41077,Épiais,119,0,358,358,3
41277,Villebout,119,0,604,604,5.1
48130,Rousses,119,1400,2919,4319,36.3
48163,Saint-Julien-des-Points,119,0,6481,6481,54.5
49028,Béhuard,119,0,1926,1926,16.2
49171,La Lande-Chasles,119,0,1159,1159,9.7
50040,Beauficel,119,0,2928,2928,24.6
50097,Canville-la-Rocque,119,0,3743,3743,31.5
50633,Le Vicel,119,550,3743,4293,36.1
51132,Les Charmontois,119,0,1767,1767,14.8
51322,Lignon,119,0,1877,1877,15.8
51626,La Villeneuve-lès-Charleville,119,0,3823,3823,32.1
52145,Coublanc,119,0,1474,1474,12.4
52419,Rennepont,119,0,13071,13071,109.8
53019,Bannes,119,0,715,715,6
55099,Champneuville,119,0,7376,7376,62
58015,Asnan,119,0,1851,1851,15.6
58027,Beaumont-la-Ferrière,119,0,6716,6716,56.4
61212,Juvigny-sur-Orne,119,0,251,251,2.1
62026,Ambricourt,119,0,7042,7042,59.2
62741,Saint-Amand,119,0,989,989,8.3
63174,Grandval,119,0,1075,1075,9
64196,Crouseilles,119,0,1242,1242,10.4
70199,Dampvalley-lès-Colombe,119,0,440,440,3.7
70288,Hyet,119,0,997,997,8.4
70307,Longevelle,119,0,38,38,0.3
70474,Saint-Sulpice,119,0,38,38,0.3
72355,Thoiré-sous-Contensor,119,0,5601,5601,47.1
76623,Saint-Michel-d'Halescourt,119,0,2248,2248,18.9
80060,Béalcourt,119,0,464,464,3.9
80372,Frucourt,119,0,363,363,3.1
82083,Lachapelle,119,0,2789,2789,23.4
88510,Villotte,119,0,925,925,7.8
89141,Dissangis,119,0,574,574,4.8
89234,Lucy-sur-Yonne,119,650,2490,3140,26.4
91022,Arrancourt,119,0,300,300,2.5
2235,Craonnelle,118,0,848,848,7.2
2444,Lugny,118,0,2104,2104,17.8
2446,Ly-Fontaine,118,0,0,0,0
2612,Pont-Arcy,118,0,233,233,2
4115,Méailles,118,0,4172,4172,35.4
5152,Saint-Maurice-en-Valgodemard,118,0,7851,7851,66.5
8080,Bouvellemont,118,0,2588,2588,21.9
9097,Clermont,118,0,14299,14299,121.2
12060,Castelmary,118,0,3612,3612,30.6
12184,Pomayrols,118,0,11176,11176,94.7
14116,Le Bû-sur-Rouvres,118,0,3567,3567,30.2
16053,Bors (Canton de Charente-Sud),118,0,6310,6310,53.5
21538,Saint-Andeux,118,0,339,339,2.9
23050,La Chapelle-Baloue,118,1150,3523,4673,39.6
24327,Pezuls,118,150,429,579,4.9
25279,Gouhelans,118,0,272,272,2.3
25398,Montflovin,118,0,0,0,0
25445,Paroy,118,0,860,860,7.3
2B334,Valle-d'Alesani,118,0,847,847,7.2
31543,Sénarens,118,0,4132,4132,35
32376,Sainte-Gemme,118,0,445,445,3.8
40083,Clèdes,118,0,2726,2726,23.1
43004,Alleyrac,118,0,655,655,5.6
47161,Massels,118,0,680,680,5.8
51004,Allemanche-Launay-et-Soyer,118,0,1540,1540,13.1
51510,Saint-Quentin-les-Marais,118,0,692,692,5.9
55064,Bouquemont,118,0,1597,1597,13.5
55148,Delouze-Rosières,118,0,2306,2306,19.5
55217,Goussaincourt,118,0,476,476,4
55306,Louppy-sur-Loison,118,0,4219,4219,35.8
57486,Morville-sur-Nied,118,0,390,390,3.3
60543,Rocquemont,118,0,462,462,3.9
65107,Bourréac,118,0,1127,1127,9.6
65250,Lalanne-Trie,118,0,3822,3822,32.4
70286,Hugier,118,0,80,80,0.7
70530,Vellechevreux-et-Courbenans,118,0,0,0,0
74060,La Chapelle-Saint-Maurice,118,0,911,911,7.7
76430,Mesnil-Follemprise,118,0,2756,2756,23.4
79346,Le Vert,118,0,3408,3408,28.9
80138,Bresle,118,0,16,16,0.1
80497,Machy,118,0,2922,2922,24.8
81212,Prades,118,0,1765,1765,15
86162,Mondion,118,0,2686,2686,22.8
88362,Le Puid,118,0,1147,1147,9.7
2082,Beugneux,117,0,391,391,3.3
2351,Goussancourt,117,0,2704,2704,23.1
7299,Saint-Symphorien-de-Mahun,117,0,331,331,2.8
11368,Sallèles-Cabardès,117,0,759,759,6.5
11415,Villar-Saint-Anselme,117,0,1540,1540,13.2
15263,Virargues,117,729,26,755,6.5
16197,La Magdeleine,117,290,2561,2851,24.4
21276,Fontaines-en-Duesmois,117,0,1952,1952,16.7
23010,Augères,117,0,648,648,5.5
23028,Bosroger,117,0,1536,1536,13.1
25145,Chazot,117,130,3226,3356,28.7
25180,Crouzet-Migette,117,0,853,853,7.3
25268,Germéfontaine,117,0,1382,1382,11.8
25588,Vaucluse,117,0,815,815,7
25602,Vergranne,117,0,5832,5832,49.8
26189,Montauban-sur-l'Ouvèze,117,0,6012,6012,51.4
26244,Le Poët-Sigillat,117,0,6012,6012,51.4
27699,Voiscreville,117,0,479,479,4.1
2A061,Carbini,117,0,2728,2728,23.3
2A278,Serra-di-Scopamène,117,0,2728,2728,23.3
2B153,Manso,117,0,0,0,0
31001,Agassac,117,0,2423,2423,20.7
31185,Folcarde,117,0,571,571,4.9
36116,Ménétréols-sous-Vatan,117,0,2376,2376,20.3
37088,Couziers,117,0,6422,6422,54.9
38041,Bessins,117,0,1891,1891,16.2
39163,Condes,117,1130,3405,4535,38.8
42196,Sainte-Agathe-en-Donzy,117,985,2121,3106,26.5
48079,Lajo,117,0,1202,1202,10.3
50275,Les Loges-sur-Brécey,117,0,2879,2879,24.6
50291,Margueray,117,0,1977,1977,16.9
51206,Dampierre-le-Château,117,0,1737,1737,14.8
51382,Mont-sur-Courville,117,0,2079,2079,17.8
55065,Boureuilles,117,0,1223,1223,10.5
55070,Brabant-sur-Meuse,117,0,1223,1223,10.5
55299,Loison,117,0,2138,2138,18.3
57402,Liederschiedt,117,0,2696,2696,23
57675,Torcheville,117,0,387,387,3.3
58242,Saint-Germain-des-Bois,117,0,1819,1819,15.5
60351,Lataule,117,2032,1023,3055,26.1
61262,Le Ménil-Ciboult,117,0,3953,3953,33.8
61392,Saint-Germain-d'Aunay,117,1600,846,2446,20.9
64090,Baliracq-Maumusson,117,0,1832,1832,15.7
64298,Lacarry-Arhan-Charritte-de-Haut,117,0,3040,3040,26
64397,Montagut,117,0,1832,1832,15.7
65160,Escaunets,117,0,2643,2643,22.6
66013,Baillestavy,117,0,3504,3504,29.9
67198,Hinsbourg,117,700,3153,3853,32.9
69261,Vernay,117,0,0,0,0
70141,Châtenois,117,0,433,433,3.7
78439,Mulcent,117,0,1173,1173,10
80631,Ponches-Estruval,117,0,2897,2897,24.8
81189,Mouzens,117,0,130,130,1.1
86176,Nérignac,117,0,4732,4732,40.4
88277,Luvigny,117,0,1138,1138,9.7
88427,Saint-Menge,117,0,1307,1307,11.2
88475,Tollaincourt,117,0,910,910,7.8
88502,Vervezelle,117,0,153,153,1.3
1121,Corlier,116,0,4388,4388,37.8
2682,Saint-Mard,116,0,229,229,2
2685,Saint-Nicolas-aux-Bois,116,0,2084,2084,18
7266,Sainte-Marguerite-Lafigère,116,12095,2839,14934,128.7
9008,Alos,116,0,14057,14057,121.2
9148,Lacave,116,0,14057,14057,121.2
9211,Montségur,116,0,1030,1030,8.9
10079,Channes,116,3400,2025,5425,46.8
11110,Coustouge,116,0,1572,1572,13.6
11168,Granès,116,0,1274,1274,11
11189,Laprade,116,0,1498,1498,12.9
12274,Sylvanès,116,0,4539,4539,39.1
14674,Soignolles,116,0,3507,3507,30.2
15066,Le Falgoux,116,2450,1921,4371,37.7
16117,Curac,116,710,5455,6165,53.1
16273,Raix,116,620,2539,3159,27.2
16354,Sainte-Souline,116,0,6203,6203,53.5
19172,Rilhac-Treignac,116,0,2020,2020,17.4
19215,Saint-Julien-le-Pèlerin,116,0,344,344,3
21302,Gomméville,116,0,1935,1935,16.7
21360,Lusigny-sur-Ouche,116,0,1763,1763,15.2
23012,Auriat,116,0,3637,3637,31.4
23014,Azat-Châtenet,116,0,642,642,5.5
25457,Plaimbois-Vennes,116,0,1370,1370,11.8
25552,Sourans,116,0,268,268,2.3
25563,Thurey-le-Mont,116,0,5782,5782,49.8
2A191,Olmiccia,116,0,2705,2705,23.3
2B023,Asco,116,0,436,436,3.8
2B230,Piève,116,0,701,701,6
2B306,Santa-Lucia-di-Mercurio,116,0,436,436,3.8
31562,Urau,116,0,6234,6234,53.7
32059,Bonas,116,0,4087,4087,35.2
32081,Castelnavet,116,0,1161,1161,10
32164,Juillac,116,0,2138,2138,18.4
36002,Aize,116,0,2356,2356,20.3
41188,Rhodon,116,0,349,349,3
42317,Urbise,116,0,3423,3423,29.5
43065,Chastel,116,850,1056,1906,16.4
43168,Saint-Arcons-de-Barges,116,1744,562,2306,19.9
45246,Pannecières,116,0,144,144,1.2
46299,Sauliac-sur-Célé,116,0,3426,3426,29.5
50055,Biniville,116,0,3649,3649,31.5
51122,Changy,116,0,681,681,5.9
51215,Dompremy,116,0,721,721,6.2
51274,Gizaucourt,116,0,1722,1722,14.8
52092,Chalancey,116,0,1437,1437,12.4
52325,Millières,116,0,1785,1785,15.4
53033,La Boissière,116,0,768,768,6.6
54576,Villers-le-Rond,116,0,1473,1473,12.7
55586,Xivray-et-Marvoisin,116,0,1379,1379,11.9
57018,Amelécourt,116,0,384,384,3.3
58028,Beaumont-Sardolles,116,0,581,581,5
58084,Corvol-d'Embernard,116,0,1804,1804,15.6
58172,Montambert,116,0,5983,5983,51.6
60208,Énencourt-Léage,116,650,2547,3197,27.6
60528,Reilly,116,0,2547,2547,22
62243,Coullemont,116,0,964,964,8.3
62455,Hocquinghen,116,0,710,710,6.1
63104,La Chaulme,116,0,1048,1048,9
63221,Medeyrolles,116,0,1048,1048,9
65213,Guizerix,116,0,3758,3758,32.4
70249,Francalmont,116,0,737,737,6.4
70304,Linexert,116,0,429,429,3.7
70442,Renaucourt,116,0,595,595,5.1
76053,Baillolet,116,0,856,856,7.4
76356,Hermanville,116,0,936,936,8.1
80074,Becquigny,116,0,140,140,1.2
80140,Brévillers,116,0,452,452,3.9
80511,Marestmontiers,116,0,140,140,1.2
80699,Saint-Aubin-Rivière,116,0,160,160,1.4
81082,Le Dourn,116,0,3584,3584,30.9
88208,Godoncourt,116,0,902,902,7.8
88290,Martigny-les-Gerbonvaux,116,0,1296,1296,11.2
89038,Bernouil,116,95,270,365,3.1
2584,Papleux,115,0,2051,2051,17.8
2683,Saint-Martin-Rivière,115,0,634,634,5.5
4176,Sainte-Croix-du-Verdon,115,0,4820,4820,41.9
5144,Saint-Jacques-en-Valgodemard,115,0,7651,7651,66.5
9023,Ascou,115,0,16562,16562,144
9326,Vèbre,115,2000,16562,18562,161.4
10198,Lirey,115,0,1642,1642,14.3
10247,Montfey,115,295,2141,2436,21.2
11260,Mouthoumet,115,0,1558,1558,13.5
14660,Saint-Vaast-en-Auge,115,0,1461,1461,12.7
19020,Beaumont,115,7920,2182,10102,87.8
19112,Lestards,115,0,2002,2002,17.4
21424,Montagny-lès-Seurre,115,0,862,862,7.5
21688,Villars-Fontaine,115,0,551,551,4.8
24560,Urval,115,2157,418,2575,22.4
25209,Échay,115,0,838,838,7.3
25538,Séchin,115,0,5732,5732,49.8
26142,Glandage,115,1325,6394,7719,67.1
27334,Heudreville-en-Lieuvin,115,0,1771,1771,15.4
2A279,Serriera,115,0,530,530,4.6
2B140,Lento,115,0,2144,2144,18.6
2B329,Tralonca,115,0,432,432,3.8
30093,Conqueyrac,115,0,239,239,2.1
30153,Malons-et-Elze,115,0,2331,2331,20.3
31382,Montgras,115,0,4027,4027,35
32328,Pouy-Roquelaure,115,0,65,65,0.6
34053,Carlencas-et-Levas,115,0,1071,1071,9.3
36095,Lignerolles,115,0,2526,2526,22
41208,Saint-Étienne-des-Guérets,115,0,4407,4407,38.3
43149,Pébrac,115,70,1047,1117,9.7
47200,Parranquet,115,0,2936,2936,25.5
51069,Bligny,115,0,2044,2044,17.8
51240,Étrepy,115,0,675,675,5.9
51351,Marigny,115,0,217,217,1.9
51443,Potangis,115,0,1501,1501,13.1
52055,Blécourt,115,0,426,426,3.7
52243,Huilliécourt,115,0,1769,1769,15.4
55511,Thonnelle,115,0,4111,4111,35.7
57103,Bousseviller,115,0,2650,2650,23
57495,Narbéfontaine,115,0,693,693,6
57583,Richeval,115,0,749,749,6.5
58243,Saint-Gratien-Savigny,115,0,5932,5932,51.6
58288,Teigny,115,0,1788,1788,15.5
61171,Fontaine-les-Bassets,115,0,243,243,2.1
62352,Framecourt,115,0,2484,2484,21.6
62658,Pittefaux,115,0,3888,3888,33.8
62795,Sibiville,115,0,2484,2484,21.6
64004,Abitain,115,0,2404,2404,20.9
65022,Arcizans-Dessus,115,0,4709,4709,40.9
67334,Niedersteinbach,115,0,2783,2783,24.2
70100,Broye-les-Loups-et-Verfontaine,115,0,580,580,5
70419,Pont-du-Bois,115,0,731,731,6.4
70423,Preigney,115,0,348,348,3
70553,Villargent,115,0,36,36,0.3
73168,Montgilbert,115,0,4363,4363,37.9
77218,Grisy-sur-Seine,115,1080,1629,2709,23.6
79332,Trayes,115,0,3271,3271,28.4
80118,Boufflers,115,0,2848,2848,24.8
82139,Le Pin,115,0,12356,12356,107.4
88024,Avrainville,115,0,1653,1653,14.4
88043,Bazoilles-et-Ménil,115,0,40,40,0.3
89011,Annéot,115,0,249,249,2.2
89170,Foissy-lès-Vézelay,115,0,249,249,2.2
89393,Serrigny,115,0,267,267,2.3
91067,Blandy,115,0,290,290,2.5
1006,Ambléon,114,0,1271,1271,11.1
2535,Nampcelles-la-Cour,114,0,2033,2033,17.8
2551,Neuville-sur-Margival,114,1850,225,2075,18.2
2718,Silly-la-Poterie,114,0,110,110,1
2793,Vézaponin,114,0,110,110,1
3068,Châtelus,114,0,3123,3123,27.4
4236,Vergons,114,0,4031,4031,35.4
5064,La Chapelle-en-Valgaudémar,114,0,7585,7585,66.5
6110,Roubion,114,0,2244,2244,19.7
9063,Le Bosc,114,0,3064,3064,26.9
10043,Bessy,114,0,117,117,1
10136,Éguilly-sous-Bois,114,0,1990,1990,17.5
10330,Rouvres-les-Vignes,114,0,0,0,0
11341,Saint-Ferriol,114,0,1252,1252,11
17390,Sainte-Ramée,114,0,1346,1346,11.8
19027,Bonnefond,114,0,1985,1985,17.4
19110,Latronche,114,0,1563,1563,13.7
23175,Sous-Parsat,114,0,3574,3574,31.4
26153,Laborel,114,0,3399,3399,29.8
27212,Écauville,114,0,490,490,4.3
2B073,Casamaccioli,114,0,429,429,3.8
32047,Berrac,114,0,65,65,0.6
32316,Peyrusse-Massas,114,0,4017,4017,35.2
39061,Boissia,114,240,3318,3558,31.2
39443,Présilly,114,1200,3318,4518,39.6
43098,Freycenet-la-Tour,114,0,632,632,5.5
51309,Jonquery,114,0,2026,2026,17.8
51500,Saint-Mard-sur-le-Mont,114,0,1693,1693,14.9
52122,Chaumont-la-Ville,114,0,1754,1754,15.4
52272,Lanty-sur-Aube,114,0,625,625,5.5
52438,Rougeux,114,0,2248,2248,19.7
53080,Couptrain,114,0,1014,1014,8.9
54005,Affracourt,114,0,0,0,0
54075,Bionville,114,0,1108,1108,9.7
57035,Assenoncourt,114,0,742,742,6.5
58048,Cessy-les-Bois,114,0,2273,2273,19.9
58073,Chevroches,114,0,2385,2385,20.9
60100,Brasseuse,114,0,0,0,0
63304,Roche-d'Agoux,114,0,177,177,1.6
64011,Aincille,114,0,2962,2962,26
64136,Borce,114,0,2455,2455,21.5
64323,Lasserre,114,0,1190,1190,10.4
67444,Scherlenheim,114,930,3831,4761,41.8
70067,Betoncourt-lès-Brotte,114,0,422,422,3.7
70143,Chauvirey-le-Châtel,114,0,345,345,3
71066,Burgy,114,0,2653,2653,23.3
71452,Saint-Martin-de-Salencey,114,0,792,792,6.9
84033,Castellet-en-Luberon,114,0,2324,2324,20.4
87022,Breuilaufa,114,0,185,185,1.6
88476,Totainville,114,0,1638,1638,14.4
89020,Asnières-sous-Bois,114,708,247,955,8.4
89058,Bussières,114,4250,247,4497,39.4
2151,Cerny-lès-Bucy,113,0,4315,4315,38.2
2263,Dhuizel,113,0,223,223,2
4072,Draix,113,0,4736,4736,41.9
7088,Faugères,113,3059,7879,10938,96.8
9021,Artix,113,0,3037,3037,26.9
9129,Galey,113,0,13693,13693,121.2
9190,Mérigon,113,0,13693,13693,121.2
10059,Braux,113,0,2386,2386,21.1
14238,Englesqueville-en-Auge,113,0,1816,1816,16.1
14519,Préaux-Bocage,113,0,200,200,1.8
15102,Lavigerie,113,1750,25,1775,15.7
15135,Montvert,113,1285,991,2276,20.1
15173,Saint-Bonnet-de-Condat,113,0,1743,1743,15.4
16042,Bessé,113,300,1421,1721,15.2
17324,Saint-Dizant-du-Bois,113,0,1334,1334,11.8
19046,Chapelle-Spinasse,113,0,1450,1450,12.8
21218,Curtil-Saint-Seine,113,0,0,0,0
21357,Louesme,113,0,1885,1885,16.7
21550,Saint-Germain-lès-Senailly,113,0,2201,2201,19.5
23088,Gartempe,113,0,1845,1845,16.3
24507,Sainte-Trie,113,300,1976,2276,20.1
25389,Montbéliardot,113,0,1898,1898,16.8
31306,Lourde,113,0,1082,1082,9.6
32352,Rozès,113,0,822,822,7.3
37053,Chanceaux-près-Loches,113,0,1962,1962,17.4
37090,Crissay-sur-Manse,113,0,3066,3066,27.1
46151,Lamothe-Cassel,113,0,3382,3382,29.9
48179,Saint-Privat-du-Fau,113,0,1161,1161,10.3
51642,Villiers-aux-Corneilles,113,0,1474,1474,13
52033,Avrecourt,113,0,518,518,4.6
54117,Chaouilley,113,0,0,0,0
54237,Grimonviller,113,0,3747,3747,33.2
54271,Igney,113,0,401,401,3.5
54600,Xousse,113,0,401,401,3.5
55095,Cesse,113,0,4086,4086,36.2
55170,Écurey-en-Verdunois,113,0,2065,2065,18.3
55310,Luzy-Saint-Martin,113,0,4086,4086,36.2
55472,Saulvaux,113,0,456,456,4
55473,Saulx-lès-Champlon,113,0,1463,1463,12.9
57045,Bacourt,113,0,374,374,3.3
58154,La Maison-Dieu,113,0,1757,1757,15.5
58272,Sardy-lès-Épiry,113,0,1757,1757,15.5
63176,Heume-l'Église,113,0,354,354,3.1
65033,Arrodets-ez-Angles,113,0,1080,1080,9.6
70170,Contréglise,113,0,671,671,5.9
70501,Thiénans,113,0,362,362,3.2
72277,Saint-Denis-des-Coudrais,113,0,689,689,6.1
81028,Berlats,113,0,1999,1999,17.7
81161,Massals,113,0,1421,1421,12.6
82157,Saint-Beauzeil,113,0,3538,3538,31.3
89417,Tissey,113,500,263,763,6.8
2745,Toulis-et-Attencourt,112,0,564,564,5
7239,Saint-Genest-Lachamp,112,300,2395,2695,24.1
9166,Leychert,112,0,995,995,8.9
9208,Montgauch,112,0,13572,13572,121.2
9215,Nalzen,112,0,995,995,8.9
10028,Balnot-la-Grange,112,0,2085,2085,18.6
10068,Buxeuil,112,0,1955,1955,17.5
19083,Feyt,112,0,1535,1535,13.7
21024,Arnay-sous-Vitteaux,112,0,2378,2378,21.2
21069,Beurizot,112,0,2378,2378,21.2
21282,Forléans,112,0,2378,2378,21.2
25567,Tournans,112,0,258,258,2.3
26159,Laval-d'Aix,112,600,6227,6827,61
2B289,Soveria,112,0,421,421,3.8
31060,Bélesta-en-Lauragais,112,0,2277,2277,20.3
32097,Cazaux-d'Anglès,112,0,814,814,7.3
32438,Tachoires,112,0,1322,1322,11.8
39015,Ardon,112,400,1134,1534,13.7
39551,Véria,112,1000,1708,2708,24.2
50169,Écausseville,112,0,3523,3523,31.5
51511,Saint-Quentin-le-Verger,112,0,1461,1461,13
51549,Somme-Yèvre,112,0,1663,1663,14.8
52356,Nomécourt,112,0,415,415,3.7
54440,Puxe,112,0,1040,1040,9.3
55017,Autrécourt-sur-Aire,112,0,1516,1516,13.5
55051,Biencourt-sur-Orge,112,0,2189,2189,19.5
55232,Harville,112,0,1450,1450,12.9
55315,Mandres-en-Barrois,112,0,2189,2189,19.5
55341,Moirey-Flabas-Crépion,112,0,2047,2047,18.3
56256,Tréhorenteuc,112,0,1687,1687,15.1
57258,Gréning,112,0,1912,1912,17.1
60472,Offoy,112,0,549,549,4.9
60503,Le Ployron,112,0,621,621,5.5
61118,Corbon,112,1480,393,1873,16.7
61372,Saint-Céneri-le-Gérei,112,0,3310,3310,29.6
61444,Saint-Philbert-sur-Orne,112,0,3000,3000,26.8
64192,Conchez-de-Béarn,112,0,1754,1754,15.7
64366,Mascaraàs-Haron,112,0,1754,1754,15.7
65276,Lizos,112,0,711,711,6.3
65333,Oléac-Dessus,112,0,711,711,6.3
70533,Vellefrey-et-Vellefrange,112,0,506,506,4.5
76679,Sommesnil,112,0,725,725,6.5
77015,Baby,112,830,1586,2416,21.6
79312,Séligné,112,0,3235,3235,28.9
80480,Lignières-en-Vimeu,112,0,155,155,1.4
87132,Saint-Amand-le-Petit,112,2042,1595,3637,32.5
2533,Muret-et-Crouttes,111,0,371,371,3.3
4069,Demandolx,111,0,3925,3925,35.4
6111,Roure,111,0,2185,2185,19.7
8210,Hannogne-Saint-Rémy,111,0,2123,2123,19.1
8296,Montcheutin,111,0,2686,2686,24.2
8317,La Neuville-à-Maire,111,0,3930,3930,35.4
10039,Bergères,111,0,0,0,0
11007,Albières,111,0,1504,1504,13.5
11030,Belflou,111,2550,975,3525,31.8
11121,Donazac,111,700,1461,2161,19.5
14230,Drubec,111,0,1784,1784,16.1
16062,Brie-sous-Barbezieux,111,1262,5935,7197,64.8
16194,Lupsault,111,0,1395,1395,12.6
19198,Saint-Éloy-les-Tuileries,111,0,3399,3399,30.6
21310,Grosbois-en-Montagne,111,0,624,624,5.6
21557,Saint-Marc-sur-Seine,111,0,1852,1852,16.7
21563,Saint-Mesmin,111,0,2357,2357,21.2
21704,Villiers-le-Duc,111,0,1852,1852,16.7
25061,Bief,111,0,773,773,7
25478,Randevillers,111,0,3060,3060,27.6
28065,Bullainville,111,0,204,204,1.8
28090,Les Châtelets,111,0,148,148,1.3
2B210,Pero-Casevecchie,111,0,797,797,7.2
31313,Malvezie,111,0,1063,1063,9.6
32154,Homps,111,0,419,419,3.8
32214,Loubédat,111,0,74,74,0.7
32265,Monclar-sur-Losse,111,0,1683,1683,15.2
34234,Roquessels,111,0,217,217,2
36028,La Buxerette,111,0,323,323,2.9
42117,Lavieu,111,0,995,995,9
43059,La Chapelle-Geneste,111,0,4619,4619,41.6
43103,Grenier-Montgon,111,0,5440,5440,49
46198,Montbrun,111,0,3278,3278,29.5
51324,Linthes,111,0,1448,1448,13
51348,Marfaux,111,0,1973,1973,17.8
51514,Saint-Remy-sous-Broyes,111,0,1448,1448,13
52042,Beauchemin,111,0,509,509,4.6
52335,Montot-sur-Rognon,111,0,1708,1708,15.4
52515,Verseilles-le-Bas,111,0,1375,1375,12.4
53189,Rennes-en-Grenouilles,111,0,4125,4125,37.2
54147,Crion,111,0,1665,1665,15
54556,Vého,111,0,394,394,3.5
55242,Hennemont,111,0,1437,1437,12.9
55399,Pareid,111,0,1437,1437,12.9
57485,Morville-lès-Vic,111,0,367,367,3.3
58188,Nannay,111,0,6265,6265,56.4
62322,Famechon,111,0,922,922,8.3
63027,Baffie,111,730,1003,1733,15.6
63357,Saint-Hérent,111,0,722,722,6.5
71166,Cuzy,111,0,571,571,5.1
71554,Varenne-l'Arconce,111,0,3146,3146,28.3
80638,Potte,111,0,2116,2116,19.1
84130,Suzette,111,0,3624,3624,32.6
88472,Thuillières,111,0,39,39,0.4
89194,Grimault,111,1000,536,1536,13.8
89410,Tharot,111,250,241,491,4.4
89475,Villon,111,500,258,758,6.8
95438,Moussy,111,0,5100,5100,45.9
2034,Audignicourt,110,0,106,106,1
7285,Saint-Pierre-sur-Doux,110,0,311,311,2.8
7326,Usclades-et-Rieutord,110,0,860,860,7.8
8252,Létanne,110,0,3894,3894,35.4
8326,Nouart,110,0,2662,2662,24.2
8348,Puiseux,110,0,2413,2413,21.9
9316,Troye-d'Ariège,110,0,2278,2278,20.7
10017,Aulnay,110,0,2322,2322,21.1
10390,Urville,110,0,0,0,0
12023,La Bastide-Solages,110,0,6003,6003,54.6
15161,Rézentières,110,1875,2433,4308,39.2
15167,Rouziers,110,1300,965,2265,20.6
17319,Sainte-Colombe,110,0,1299,1299,11.8
17361,Saint-Martial,110,0,3064,3064,27.9
18152,Montlouis,110,0,1991,1991,18.1
21137,Champ-d'Oiseau,110,0,2143,2143,19.5
21677,Vic-des-Prés,110,0,1672,1672,15.2
23023,Blaudeix,110,0,0,0,0
24046,Boisseuilh,110,400,1924,2324,21.1
25131,Châtelblanc,110,0,6551,6551,59.6
25503,Rosières-sur-Barbèche,110,0,3033,3033,27.6
28016,Les Autels-Villevillon,110,0,43,43,0.4
28408,Vierville,110,0,638,638,5.8
2B147,Lozzi,110,0,414,414,3.8
31062,Bellesserre,110,0,920,920,8.4
31529,Samouillan,110,0,2278,2278,20.7
34125,Lagamas,110,0,594,594,5.4
36125,Migny,110,0,2597,2597,23.6
39065,Bonnefontaine,110,500,2924,3424,31.1
39302,Louvatange,110,770,1736,2506,22.8
39336,Molain,110,100,2433,2533,23
42008,Arcon,110,95,3246,3341,30.4
43156,Présailles,110,0,610,610,5.5
43219,Saint-Préjet-Armandon,110,1100,1002,2102,19.1
45074,La Chapelle-Onzerain,110,0,155,155,1.4
51208,Dampierre-sur-Moivre,110,0,184,184,1.7
51404,Noirlieu,110,0,1633,1633,14.8
51469,Rouffy,110,0,2186,2186,19.9
51538,Sogny-aux-Moulins,110,0,184,184,1.7
53270,Vieuvy,110,0,1450,1450,13.2
54244,Hagéville,110,0,657,657,6
55096,Chaillon,110,0,1307,1307,11.9
57174,Destry,110,0,1878,1878,17.1
57555,Prévocourt,110,0,364,364,3.3
57754,Xanrey,110,0,364,364,3.3
64215,Espiute,110,0,2299,2299,20.9
64388,Momy,110,0,1148,1148,10.4
65153,Coussan,110,0,698,698,6.3
65308,Mazerolles,110,0,3563,3563,32.4
65337,Orieux,110,0,698,698,6.3
65474,Villembits,110,0,3563,3563,32.4
65477,Villenave-près-Marsac,110,0,2485,2485,22.6
70172,La Corbière,110,0,106,106,1
70436,Raincourt,110,0,333,333,3
70544,La Vergenne,110,0,35,35,0.3
76218,Doudeauville,110,0,2078,2078,18.9
80170,Cantigny,110,0,133,133,1.2
91526,Roinvilliers,110,0,277,277,2.5
2448,Mâchecourt,109,0,293,293,2.7
5117,Ribeyret,109,0,3250,3250,29.8
7136,Laveyrune,109,1300,852,2152,19.7
8159,Euilly-et-Lombut,109,0,3859,3859,35.4
8378,Saint-Clément-à-Arnes,109,0,2637,2637,24.2
10075,Champfleury,109,0,112,112,1
10093,Chaumesnil,109,0,649,649,6
10404,Verpillières-sur-Ource,109,0,1903,1903,17.5
11399,Tréville,109,0,958,958,8.8
14710,Tréprel,109,0,1707,1707,15.7
19226,Saint-Merd-les-Oussines,109,0,1494,1494,13.7
23225,Saint-Oradoux-près-Crocq,109,0,1431,1431,13.1
24399,Saint-Étienne-de-Puycorbier,109,0,5219,5219,47.9
25299,Guillon-les-Bains,109,0,5433,5433,49.8
25491,Rignosot,109,0,5433,5433,49.8
2A144,Lopigna,109,0,502,502,4.6
2B208,Perelli,109,0,782,782,7.2
2B218,Piedicorte-di-Gaggio,109,0,830,830,7.6
31059,Belbèze-en-Comminges,109,0,5858,5858,53.7
31191,Fougaron,109,0,5858,5858,53.7
32277,Montamat,109,0,680,680,6.2
34054,Cassagnoles,109,0,413,413,3.8
39346,Montagna-le-Reconduit,109,0,1662,1662,15.2
40038,Bergouey,109,0,1707,1707,15.7
40265,Saint-Julien-d'Armagnac,109,0,1245,1245,11.4
43214,Saint-Pal-de-Senouire,109,0,993,993,9.1
47008,Ambrus,109,0,1047,1047,9.6
47319,Villebramar,109,0,880,880,8.1
50229,Hamelin,109,0,2682,2682,24.6
50479,Saint-Germain-de-Varreville,109,0,591,591,5.4
51015,Argers,109,0,1618,1618,14.8
51170,Corfélix,109,0,3502,3502,32.1
51301,Isse,109,0,5540,5540,50.8
51319,Lenharrée,109,0,5540,5540,50.8
51635,Villers-le-Sec,109,0,640,640,5.9
52129,Cirey-sur-Blaise,109,0,404,404,3.7
52384,Perrogney-les-Fontaines,109,0,1350,1350,12.4
52392,Plesnoy,109,0,500,500,4.6
54458,Repaix,109,0,387,387,3.6
54499,Seicheprey,109,0,651,651,6
55034,Bazeilles-sur-Othain,109,0,3897,3897,35.8
55547,Verneuil-Petit,109,0,3897,3897,35.8
57295,Haraucourt-sur-Seille,109,0,361,361,3.3
58191,Neuilly,109,0,1695,1695,15.6
61049,Boissei-la-Lande,109,0,684,684,6.3
61316,Ommoy,109,0,230,230,2.1
63389,Saint-Quentin-sur-Sauxillanges,109,0,709,709,6.5
65074,Bazordan,109,0,3531,3531,32.4
65225,Hourc,109,0,692,692,6.3
65316,Monlong,109,0,3531,3531,32.4
65424,Sers,109,0,4463,4463,40.9
70519,Vandelans,109,0,913,913,8.4
70573,La Voivre,109,0,1254,1254,11.5
71534,Le Tartre,109,0,204,204,1.9
76170,La Chapelle-du-Bourgay,109,0,880,880,8.1
81176,Montels,109,0,5989,5989,54.9
81214,Puéchoursi,109,0,2216,2216,20.3
82058,Fajolles,109,0,1400,1400,12.8
82128,Montfermier,109,0,3223,3223,29.6
88049,Belmont-lès-Darney,109,0,847,847,7.8
2047,Barenton-Cel,108,0,544,544,5
4169,La Rochegiron,108,0,285,285,2.6
6049,Courmes,108,0,1309,1309,12.1
8467,Vaux-Montreuil,108,0,2369,2369,21.9
8496,Wagnon,108,0,2369,2369,21.9
10182,Juvancourt,108,0,0,0,0
10212,Machy,108,0,1542,1542,14.3
10389,Unienville,108,0,2280,2280,21.1
11066,Camurac,108,0,1186,1186,11
11333,Saint-Benoît,108,0,1186,1186,11
11343,Saint-Gaudéric,108,0,320,320,3
15097,Lastic,108,2720,2389,5109,47.3
16404,Vieux-Ruffec,108,3795,2222,6017,55.7
17477,Villiers-Couture,108,1300,3008,4308,39.9
21335,Lacour-d'Arcenay,108,0,2293,2293,21.2
21454,Nicey,108,0,1802,1802,16.7
23080,Féniers,108,0,1481,1481,13.7
24136,Coubjours,108,2000,1889,3889,36
24495,Saint-Romain-de-Monpazier,108,0,392,392,3.6
26343,Souspierre,108,0,3765,3765,34.9
2B055,Campitello,108,0,2014,2014,18.6
30332,Trèves,108,0,5403,5403,50
32026,Bajonnette,108,0,408,408,3.8
32291,Mormès,108,0,72,72,0.7
32402,Saint-Paul-de-Baïse,108,0,785,785,7.3
38283,Oris-en-Rattier,108,0,1131,1131,10.5
39203,Doye,108,0,1093,1093,10.1
39280,Larrivoire,108,200,398,598,5.5
39522,Supt,108,410,1093,1503,13.9
43144,Moudeyres,108,0,599,599,5.5
43226,Saint-Vert,108,0,1210,1210,11.2
46167,Lentillac-du-Causse,108,0,625,625,5.8
47072,Courbiac,108,0,622,622,5.8
47083,Doudrac,108,0,2758,2758,25.5
50324,Le Mesnil-Véneron,108,0,1597,1597,14.8
52257,Laferté-sur-Amance,108,0,2130,2130,19.7
52288,Lezéville,108,0,400,400,3.7
52399,Pont-la-Ville,108,0,592,592,5.5
54511,Sponville,108,0,645,645,6
55121,Combres-sous-les-Côtes,108,0,1398,1398,12.9
58184,Moussy,108,0,6095,6095,56.4
58274,Savigny-Poil-Fol,108,0,5571,5571,51.6
60312,Héricourt-sur-Thérain,108,0,530,530,4.9
61180,Fresnay-le-Samson,108,1225,781,2006,18.6
63197,Lisseuil,108,0,712,712,6.6
64079,Aurions-Idernes,108,0,1127,1127,10.4
64111,Bentayou-Sérée,108,0,2440,2440,22.6
67225,Issenhausen,108,240,3629,3869,35.8
70237,Fleurey-lès-Lavoncourt,108,0,554,554,5.1
70400,Ouge,108,0,2130,2130,19.7
70461,Saint-Broing,108,0,545,545,5
70486,Semmadon,108,0,327,327,3
80143,Brocourt,108,0,149,149,1.4
80522,Le Mazis,108,0,149,149,1.4
81030,Bertre,108,0,120,120,1.1
82046,Coutures,108,0,1387,1387,12.8
88529,Xaronval,108,0,1552,1552,14.4
89271,Moulins-en-Tonnerrois,108,364,521,885,8.2
2331,Franqueville,107,0,1908,1908,17.8
2526,Morgny-en-Thiérache,107,0,1179,1179,11
4179,Saint-Geniez,107,0,3190,3190,29.8
7275,Saint-Mélany,107,3950,7461,11411,106.6
9123,Fornex,107,0,1903,1903,17.8
10007,Arconville,107,0,0,0,0
10008,Argançon,107,0,637,637,6
10069,Buxières-sur-Arce,107,0,1868,1868,17.5
11143,Feuilla,107,3650,165,3815,35.7
14272,La Folie,107,0,741,741,6.9
14473,Notre-Dame-de-Livaye,107,0,1191,1191,11.1
15081,Jou-sous-Monjou,107,0,478,478,4.5
17180,Gourvillette,107,0,2980,2980,27.9
22373,Tréogan,107,0,3618,3618,33.8
24195,Gaugeac,107,0,389,389,3.6
25488,Rennes-sur-Loue,107,0,780,780,7.3
2A240,Poggiolo,107,0,493,493,4.6
2B170,Morsiglia,107,0,3924,3924,36.7
31041,Bagiry,107,0,1024,1024,9.6
32166,Justian,107,0,778,778,7.3
32267,Monferran-Plavès,107,0,1263,1263,11.8
32309,Pellefigue,107,0,668,668,6.2
33190,Goualade,107,0,36,36,0.3
34115,Gorniès,107,0,2292,2292,21.4
39127,Chaussenans,107,0,2367,2367,22.1
39312,Marigna-sur-Valouse,107,1650,3114,4764,44.5
43183,Sainte-Eugénie-de-Villeneuve,107,2210,974,3184,29.8
45041,Bordeaux-en-Gâtinais,107,0,1050,1050,9.8
45125,Dimancheville,107,0,811,811,7.6
46056,Carayac,107,0,3160,3160,29.5
47259,Saint-Maurice-de-Lestapel,107,0,2732,2732,25.5
51306,Joiselle,107,0,1396,1396,13
51325,Lisse-en-Champagne,107,0,628,628,5.9
52491,Thonnance-les-Moulins,107,0,396,396,3.7
54187,Euvezin,107,0,639,639,6
55326,Maulan,107,0,2091,2091,19.5
55357,Morgemoulin,107,0,1933,1933,18.1
55581,Willeroncourt,107,0,432,432,4
57053,Bassing,107,0,354,354,3.3
57397,Ley,107,0,354,354,3.3
57528,Oron,107,0,354,354,3.3
60502,Le Plessis-Patte-d'Oie,107,0,0,0,0
62344,Fontaine-lès-Hermans,107,0,2312,2312,21.6
63060,Bussières,107,0,166,166,1.6
63158,Fayet-Ronaye,107,2532,967,3499,32.7
65143,Chelle-Spou,107,0,320,320,3
65454,Trouley-Labarthe,107,0,2417,2417,22.6
70127,Chantes,107,0,275,275,2.6
70409,Pierrecourt,107,0,549,549,5.1
72015,Les Aulneaux,107,0,1984,1984,18.5
73119,Freney,107,0,1891,1891,17.7
76184,Colmesnil-Manneville,107,0,1300,1300,12.1
78518,Rennemoulin,107,0,887,887,8.3
80269,Épaumesnil,107,0,148,148,1.4
80425,Hédauville,107,0,120,120,1.1
80437,Heucourt-Croquoison,107,0,148,148,1.4
80538,Mesnil-en-Arrouaise,107,0,767,767,7.2
81167,Miolles,107,0,1346,1346,12.6
88192,Gelvécourt-et-Adompt,107,0,1538,1538,14.4
2486,Missy-lès-Pierrepont,106,0,285,285,2.7
8047,Barbaise,106,0,2325,2325,21.9
10377,Thil,106,0,631,631,6
10431,Villiers-le-Bois,106,0,1973,1973,18.6
11387,Taurize,106,0,688,688,6.5
11409,Vignevieille,106,0,1436,1436,13.5
12058,Cassuéjouls,106,0,3592,3592,33.9
15143,Nieudan,106,1500,929,2429,22.9
16377,La Tâche,106,350,1333,1683,15.9
21096,Boussenois,106,0,73,73,0.7
21706,Villotte-sur-Ource,106,0,1768,1768,16.7
24206,Grives,106,1400,5189,6589,62.2
28242,Méréglise,106,0,392,392,3.7
2B366,Chisa,106,0,0,0,0
31376,Montgaillard-de-Salies,106,0,5697,5697,53.7
32051,Bézéril,106,0,661,661,6.2
32139,Gaudonville,106,0,400,400,3.8
32281,Mont-de-Marrast,106,0,235,235,2.2
33169,Floudès,106,0,863,863,8.1
36130,Montlevicq,106,0,2328,2328,22
39238,Frasne-les-Meulières,106,0,2151,2151,20.3
40219,Payros-Cazautets,106,0,2449,2449,23.1
42109,L'Hôpital-sous-Rochefort,106,0,0,0,0
43019,Barges,106,0,514,514,4.8
45023,Batilly-en-Puisaye,106,0,1234,1234,11.6
46097,Estal,106,0,3458,3458,32.6
46233,Quissac-en-Quercy,106,0,3130,3130,29.5
47002,Agmé,106,0,1097,1097,10.3
50028,La Baleine,106,0,3067,3067,28.9
51421,Oyes,106,0,1383,1383,13
51502,Saint-Martin-aux-Champs,106,0,177,177,1.7
51560,Suizy-le-Franc,106,0,153,153,1.4
51600,Vaudesincourt,106,0,1884,1884,17.8
51619,Le Vieil-Dampierre,106,0,1574,1574,14.8
51645,Vindey,106,0,1383,1383,13
52009,Andilly-en-Bassigny,106,0,486,486,4.6
52413,Rachecourt-Suzémont,106,0,960,960,9.1
52452,Saint-Martin-lès-Langres,106,0,486,486,4.6
54190,Fécocourt,106,0,3514,3514,33.2
54468,Saffais,106,0,843,843,8
54512,Tanconville,106,0,376,376,3.5
55360,Mouilly,106,0,1372,1372,12.9
55522,Ugny-sur-Meuse,106,0,428,428,4
57133,Château-Voué,106,0,351,351,3.3
57621,Saint-Médard,106,0,351,351,3.3
58098,Dirol,106,0,1648,1648,15.5
61401,Saint-Gilles-des-Marais,106,400,3581,3981,37.6
62339,Fleury,106,0,2290,2290,21.6
62435,Herlincourt,106,0,2290,2290,21.6
62537,Magnicourt-sur-Canche,106,0,881,881,8.3
62768,Saint-Rémy-au-Bois,106,0,1678,1678,15.8
64295,Labeyrie,106,0,2854,2854,26.9
64356,Luc-Armau,106,0,1106,1106,10.4
65407,Sarp,106,0,694,694,6.5
66199,Taillet,106,0,4396,4396,41.5
67470,Solbach,106,1080,7671,8751,82.6
70156,Citey,106,0,479,479,4.5
70158,Clans,106,0,272,272,2.6
70457,Rupt-sur-Saône,106,0,272,272,2.6
81041,Broze,106,0,5824,5824,54.9
88096,Châtillon-sur-Saône,106,0,824,824,7.8
88164,Estrennes,106,0,37,37,0.3
3276,Sussat,105,0,2148,2148,20.5
5076,Méreuil,105,0,3130,3130,29.8
7104,Issamoulenc,105,1075,2245,3320,31.6
8271,Manre,105,0,2541,2541,24.2
9117,Esplas,105,0,473,473,4.5
9291,Sentenac-d'Oust,105,0,12724,12724,121.2
9315,Trémoulet,105,0,473,473,4.5
10410,Villadin,105,0,0,0,0
14183,Cossesseville,105,0,3174,3174,30.2
14541,La Roque-Baignard,105,0,1688,1688,16.1
15205,Saint-Paul-de-Salers,105,0,1738,1738,16.6
16267,Poullignac,105,4150,4937,9087,86.5
18024,Beddes,105,0,281,281,2.7
19221,Saint-Martial-Entraygues,105,0,312,312,3
21108,Brianny,105,0,2230,2230,21.2
21160,Chaume-lès-Baigneux,105,0,1752,1752,16.7
21417,Missery,105,0,2230,2230,21.2
23058,Le Chauchet,105,0,1378,1378,13.1
24231,Lavalade,105,1450,382,1832,17.4
25171,Courcelles,105,100,765,865,8.2
25310,Huanne-Montmartin,105,0,242,242,2.3
25474,Le Puy,105,0,5234,5234,49.8
2B340,Velone-Orneto,105,0,753,753,7.2
31520,Sajas,105,0,3677,3677,35
32092,Catonvielle,105,0,396,396,3.8
32189,Lannemaignan,105,0,0,0,0
32310,Perchède,105,0,70,70,0.7
32351,Roques,105,0,764,764,7.3
32419,Sauviac,105,0,232,232,2.2
36102,Luçay-le-Libre,105,0,2133,2133,20.3
38330,Quincieu,105,0,1697,1697,16.2
38444,Saint-Pierre-de-Méaroz,105,0,1099,1099,10.5
39430,Plumont,105,50,1657,1707,16.3
40290,Sarron,105,0,3287,3287,31.3
43097,Freycenet-la-Cuche,105,0,582,582,5.5
47256,Saint-Martin-de-Villeréal,105,0,2681,2681,25.5
51323,Linthelles,105,0,1370,1370,13
51459,Réveillon,105,0,1370,1370,13
51563,Talus-Saint-Prix,105,0,152,152,1.4
51570,Le Thoult-Trosnay,105,0,3374,3374,32.1
52136,Coiffy-le-Haut,105,0,2071,2071,19.7
54191,Fenneviller,105,0,372,372,3.5
55297,Lissey,105,0,1919,1919,18.3
55439,Ronvaux,105,0,1359,1359,12.9
57090,Blanche-Église,105,0,347,347,3.3
57380,Laneuveville-lès-Lorquin,105,0,684,684,6.5
58111,Fâchin,105,0,1237,1237,11.8
58150,Lys,105,0,1633,1633,15.6
60608,Le Saulchoy,105,0,4117,4117,39.2
64052,Arricau-Bordes,105,0,1096,1096,10.4
64162,Camou-Cihigue,105,0,2729,2729,26
65289,Luby-Betmont,105,0,3401,3401,32.4
71521,Sigy-le-Châtel,105,0,730,730,7
72174,Lucé-sous-Ballon,105,0,1947,1947,18.5
72192,Les Mées,105,0,1947,1947,18.5
76662,Sassetot-le-Malgardé,105,0,847,847,8.1
80825,Wiry-au-Mont,105,0,320,320,3
81300,Tonnac,105,0,5769,5769,54.9
88064,Bois-de-Champ,105,0,1021,1021,9.7
2069,Berlise,104,0,1146,1146,11
2107,Bourguignon-sous-Coucy,104,0,103,103,1
5086,Montjay,104,0,3100,3100,29.8
8201,Gruyères,104,0,2281,2281,21.9
8477,Villers-devant-Mouzon,104,0,3682,3682,35.4
10264,Noé-les-Mallets,104,0,1815,1815,17.5
11156,Fraisse-Cabardès,104,0,1343,1343,12.9
15121,Maurines,104,2265,2300,4565,43.9
15260,Vieillevie,104,2940,912,3852,37
16238,Moutonneau,104,400,0,400,3.8
17035,Bazauges,104,0,2897,2897,27.9
17231,Messac,104,0,1228,1228,11.8
19266,Thalamy,104,0,1426,1426,13.7
21298,Gissey-le-Vieil,104,0,2208,2208,21.2
24144,Creyssac,104,0,790,790,7.6
2B299,San-Gavino-d'Ampugnani,104,0,482,482,4.6
31017,Arlos,104,0,996,996,9.6
32028,Barcugnan,104,0,230,230,2.2
34011,Arboras,104,0,562,562,5.4
36170,Reboursin,104,670,2112,2782,26.8
40239,Puyol-Cazalet,104,0,2403,2403,23.1
40242,Rimbez-et-Baudiets,104,0,1188,1188,11.4
41019,Boisseau,104,0,313,313,3
51512,Saint-Quentin-sur-Coole,104,0,174,174,1.7
51658,Vroil,104,0,610,610,5.9
54389,Mouaville,104,0,966,966,9.3
54445,Raville-sur-Sânon,104,0,1560,1560,15
54599,Xonville,104,0,621,621,6
55072,Braquis,104,0,1879,1879,18.1
55406,Pintheville,104,0,1346,1346,12.9
57284,Hallering,104,0,4826,4826,46.4
57317,Hérange,104,0,209,209,2
60280,Gourchelles,104,0,510,510,4.9
61152,Écorches,104,0,220,220,2.1
61322,Parfondeval,104,750,365,1115,10.7
62578,Monchiet,104,0,864,864,8.3
62659,Planques,104,0,6154,6154,59.2
64155,Bustince-Iriberry,104,0,2703,2703,26
65234,Jézeau,104,0,5000,5000,48.1
65361,Peyrun,104,0,2349,2349,22.6
65459,Uzer,104,0,781,781,7.5
70088,Bourguignon-lès-la-Charité,104,0,470,470,4.5
72171,Louzes,104,0,1929,1929,18.5
76097,Biville-la-Rivière,104,0,839,839,8.1
80531,Méricourt-en-Vimeu,104,0,144,144,1.4
80629,Pœuilly,104,0,745,745,7.2
88195,Gendreville,104,0,37,37,0.4
88390,Robécourt,104,0,808,808,7.8
89297,Pierre-Perthuis,104,960,226,1186,11.4
89383,Sementron,104,1694,4696,6390,61.4
89482,Viviers,104,135,242,377,3.6
2819,Vincy-Reuil-et-Magny,103,0,1135,1135,11
5099,Oze,103,0,3854,3854,37.4
6080,Marie,103,0,2028,2028,19.7
7105,Issanlas,103,0,805,805,7.8
9100,Couflens,103,0,12481,12481,121.2
9212,Montseron,103,0,12481,12481,121.2
10107,Coursan-en-Othe,103,0,1918,1918,18.6
10243,Molins-sur-Aube,103,0,2174,2174,21.1
11044,Bouisse,103,0,1396,1396,13.6
15198,Sainte-Marie,103,5500,2278,7778,75.5
17176,Gibourne,103,0,2869,2869,27.9
19006,Alleyrat,103,0,1412,1412,13.7
21553,Saint-Jean-de-Bœuf,103,0,579,579,5.6
21608,Sincey-lès-Rouvray,103,0,296,296,2.9
23171,Sermur,103,0,1352,1352,13.1
25007,Adam-lès-Vercel,103,0,1217,1217,11.8
25572,Trouvans,103,0,238,238,2.3
28260,Montharville,103,0,189,189,1.8
2A056,Campo,103,0,77,77,0.7
30246,Sainte-Croix-de-Caderle,103,0,3220,3220,31.3
31404,Oô,103,0,986,986,9.6
32033,Bazian,103,0,749,749,7.3
32093,Caumont,103,0,1031,1031,10
32453,Tourrenquets,103,0,3629,3629,35.2
34273,Saint-Martin-de-l'Arçon,103,0,390,390,3.8
36067,Dunet,103,0,2077,2077,20.2
36242,Villegongis,103,0,17,17,0.2
39112,La Chassagne,103,0,2738,2738,26.6
42321,La Valla-sur-Rochefort,103,0,923,923,9
46308,Soucirac,103,0,3082,3082,29.9
48073,Les Hermaux,103,0,3657,3657,35.5
48085,Laval-du-Tarn,103,2000,3657,5657,54.9
50105,Catteville,103,0,3240,3240,31.5
51045,Beaunay,103,0,149,149,1.4
51441,Ponthion,103,0,604,604,5.9
52518,Vesaignes-sur-Marne,103,0,11314,11314,109.8
55028,Bantheville,103,0,3724,3724,36.2
55356,Moranville,103,0,1861,1861,18.1
56085,Hœdic,103,0,3985,3985,38.7
57231,Foville,103,0,3944,3944,38.3
60049,Bazancourt,103,1305,505,1810,17.6
60394,Ménévillers,103,0,571,571,5.5
61192,Godisson,103,270,0,270,2.6
61336,Pouvrai,103,1660,1196,2856,27.7
62134,Bimont,103,0,6095,6095,59.2
62342,Fontaine-lès-Boulans,103,0,2225,2225,21.6
64085,Aydius,103,0,2218,2218,21.5
64159,Cadillon,103,0,1075,1075,10.4
64429,Orsanco,103,0,2677,2677,26
65024,Argelès-Bagnères,103,0,773,773,7.5
65174,Estirac,103,0,2327,2327,22.6
65305,Mauléon-Barousse,103,0,674,674,6.5
66146,Porta,103,0,0,0,0
70148,Chemilly,103,0,265,265,2.6
71028,Beauvernois,103,0,13,13,0.1
71358,Pressy-sous-Dondin,103,0,716,716,7
71515,Sercy,103,0,1580,1580,15.3
76042,Auvilliers,103,0,2406,2406,23.4
76161,Carville-Pot-de-Fer,103,0,227,227,2.2
79124,Les Forges,103,0,2700,2700,26.2
80355,Fresneville,103,0,142,142,1.4
80589,Neuilly-le-Dien,103,0,2551,2551,24.8
80684,Rouy-le-Petit,103,0,1963,1963,19.1
82067,Gensac,103,0,2414,2414,23.4
84023,Buoux,103,0,2100,2100,20.4
88378,Regney,103,0,1480,1480,14.4
88421,Saint-Julien,103,0,801,801,7.8
2249,Cuiry-Housse,102,0,341,341,3.3
2424,Leury,102,0,853,853,8.4
4017,Auzet,102,0,4275,4275,41.9
6119,Saint-Dalmas-le-Selvage,102,0,2008,2008,19.7
8144,Doux,102,0,1951,1951,19.1
8286,Ménil-Annelles,102,0,1951,1951,19.1
8482,Villers-sur-le-Mont,102,0,2237,2237,21.9
11087,Cazalrenoux,102,0,302,302,3
12166,Murols,102,0,3456,3456,33.9
15194,Saint-Julien-de-Toursac,102,1400,894,2294,22.5
16315,Saint-Félix,102,1570,5454,7024,68.9
19111,Laval-sur-Luzège,102,0,1309,1309,12.8
24109,La Chapelle-Grésignac,102,1575,775,2350,23
24359,Sadillac,102,100,191,291,2.9
24541,Soudat,102,957,684,1641,16.1
25089,Bremondans,102,0,1205,1205,11.8
25182,Cubry,102,0,235,235,2.3
26007,Ambonil,102,400,1236,1636,16
26036,Beaumont-en-Diois,102,2900,5671,8571,84
26376,Villeperdrix,102,0,5241,5241,51.4
2A154,Marignana,102,0,470,470,4.6
32205,Laveraët,102,0,1880,1880,18.4
32299,Noulens,102,0,0,0,0
33224,Landerrouet-sur-Ségur,102,0,1013,1013,9.9
34326,Vélieux,102,0,386,386,3.8
43029,La Besseyre-Saint-Mary,102,0,929,929,9.1
43125,Lubilhac,102,1305,4999,6304,61.8
46234,Rampoux,102,0,2885,2885,28.3
48067,Gabriac,102,2280,5555,7835,76.8
48082,Laubert,102,3150,2067,5217,51.1
48141,Mas-Saint-Chély,102,3350,2502,5852,57.4
51239,Étréchy,102,0,2027,2027,19.9
51565,Thaas,102,0,192,192,1.9
52047,Beurville,102,0,378,378,3.7
52545,Voisines,102,0,468,468,4.6
54390,Mousson,102,0,1114,1114,10.9
54464,Rouves,102,0,604,604,5.9
54479,Saint-Mard,102,0,421,421,4.1
55579,Watronville,102,0,1320,1320,12.9
57009,Ajoncourt,102,0,338,338,3.3
58135,Isenay,102,0,5261,5261,51.6
60052,Beaugies-sous-Bois,102,0,0,0,0
61089,Champosoult,102,575,737,1312,12.9
63299,Rentières,102,0,663,663,6.5
65386,Saint-Créac,102,0,974,974,9.5
66147,Porté-Puymorens,102,0,0,0,0
66192,Sauto,102,0,0,0,0
77396,Rupéreux,102,0,368,368,3.6
79197,Oroux,102,0,2674,2674,26.2
80773,Vadencourt,102,0,398,398,3.9
81240,Saint-André,102,0,1283,1283,12.6
82103,Marignac,102,0,2391,2391,23.4
88353,Pont-lès-Bonfays,102,0,793,793,7.8
89477,Villy,102,1950,14,1964,19.3
89481,Vireaux,102,3000,237,3237,31.7
95633,Vaudherland,102,0,1265,1265,12.4
2033,Aubigny-en-Laonnois,101,0,726,726,7.2
4207,Sigoyer,101,0,3011,3011,29.8
7249,Saint-Jeure-d'Andaure,101,0,2159,2159,21.4
8438,Taizy,101,0,1932,1932,19.1
9218,Orgeix,101,5800,14546,20346,201.4
11312,Ribouisse,101,0,299,299,3
12075,Connac,101,0,5511,5511,54.6
14091,Bourgeauville,101,0,1623,1623,16.1
14533,Repentigny,101,0,1623,1623,16.1
19206,Saint-Germain-Lavolps,101,0,1385,1385,13.7
21216,Culètre,101,0,3115,3115,30.8
21635,Thoste,101,0,2145,2145,21.2
24084,Carves,101,0,4944,4944,49
24151,Doissat,101,2000,4944,6944,68.8
26082,Châteauneuf-de-Bordette,101,0,5190,5190,51.4
26200,Montfroc,101,0,2225,2225,22
26299,Sainte-Croix,101,925,5615,6540,64.8
27373,Lorleau,101,0,665,665,6.6
27405,Mesnil-sous-Vienne,101,0,82,82,0.8
27570,Saint-Martin-la-Campagne,101,0,1188,1188,11.8
27579,Saint-Ouen-de-Pontcheuil,101,0,414,414,4.1
2A127,Giuncheto,101,0,0,0,0
2B225,Pietra-di-Verde,101,0,769,769,7.6
32050,Betplan,101,0,224,224,2.2
36217,Sembleçay,101,0,102,102,1
39057,Blois-sur-Seille,101,450,2684,3134,31
39418,Picarreau,101,600,2234,2834,28.1
47126,Lachapelle,101,0,1881,1881,18.6
48158,Saint-Hilaire-de-Lavit,101,450,5501,5951,58.9
51013,Aougny,101,0,1795,1795,17.8
54278,Jevoncourt,101,0,0,0,0
54494,Saulxerotte,101,0,3349,3349,33.2
54501,Seranville,101,0,417,417,4.1
57044,Azoudange,101,0,658,658,6.5
57050,Barchain,101,0,658,658,6.5
57161,Cutting,101,0,334,334,3.3
58313,Vitry-Laché,101,0,1571,1571,15.6
60131,Catheux,101,0,2278,2278,22.6
61066,Buré,101,650,36,686,6.8
63313,Saint-Alyre-ès-Montagne,101,0,657,657,6.5
65200,Germs-sur-l'Oussouet,101,0,965,965,9.6
65219,Hères,101,0,2281,2281,22.6
65341,Oroix,101,0,2281,2281,22.6
66169,Saint-Arnac,101,0,2470,2470,24.5
70159,Cognières,101,0,323,323,3.2
70251,Francourt,101,0,518,518,5.1
70291,Jonvelle,101,0,306,306,3
70499,Theuley,101,0,518,518,5.1
70531,Velleclaire,101,0,457,457,4.5
71331,Nochize,101,0,392,392,3.9
76083,Bertheauville,101,0,654,654,6.5
76353,Héberville,101,0,654,654,6.5
80334,Fossemanant,101,0,139,139,1.4
80563,Montigny-les-Jongleurs,101,0,394,394,3.9
81072,Crespin,101,0,2311,2311,22.9
86013,Aulnay,101,0,516,516,5.1
86291,Villemort,101,0,4085,4085,40.4
88185,Frenelle-la-Grande,101,0,1452,1452,14.4
88477,Trampot,101,0,1128,1128,11.2
2284,Erloy,100,0,1783,1783,17.8
2652,Rogny,100,0,1783,1783,17.8
4074,Entrages,100,2700,4191,6891,68.9
6139,Thiéry,100,0,2254,2254,22.5
7220,Saint-Christol,100,100,2138,2238,22.4
8015,Antheny,100,0,2614,2614,26.1
8383,Saint-Juvin,100,0,2420,2420,24.2
9055,Bethmale,100,0,12118,12118,121.2
10111,Courteron,100,0,1746,1746,17.5
11400,Tréziers,100,0,1099,1099,11
12212,Saint-Beaulize,100,0,4282,4282,42.8
19021,Bellechassagne,100,0,1371,1371,13.7
21348,Licey-sur-Vingeanne,100,0,436,436,4.4
21589,Saussy,100,400,0,400,4
21681,Vieux-Château,100,0,2123,2123,21.2
23218,Saint-Maurice-près-Crocq,100,0,1313,1313,13.1
25232,Faimbe,100,0,231,231,2.3
27155,Chennebrun,100,0,2812,2812,28.1
2B280,Silvareccio,100,0,463,463,4.6
2B365,San-Gavino-di-Fiumorbo,100,0,0,0,0
31398,Nizan-Gesse,100,0,2071,2071,20.7
32308,Pébées,100,0,624,624,6.2
32411,Sansan,100,0,1180,1180,11.8
33068,Bourideys,100,0,1023,1023,10.2
36040,La Chapelle-Orthemale,100,0,158,158,1.6
38322,Presles,100,0,1616,1616,16.2
39020,Arsure-Arsurette,100,350,1012,1362,13.6
39117,Chatelay,100,650,968,1618,16.2
47236,Sainte-Colombe-de-Duras,100,0,4926,4926,49.3
50062,Boisyvon,100,0,1690,1690,16.9
51493,Saint-Léonard,100,0,1777,1777,17.8
52057,Blumeray,100,0,370,370,3.7
52310,Marbéville,100,0,10984,10984,109.8
54481,Saint-Maurice-aux-Forges,100,0,355,355,3.6
55002,Abaucourt-Hautecourt,100,0,1806,1806,18.1
55062,Bouconville-sur-Madt,100,0,1188,1188,11.9
55068,Brabant-en-Argonne,100,0,1046,1046,10.5
55482,Senoncourt-les-Maujouy,100,0,637,637,6.4
57107,Bréhain,100,0,331,331,3.3
57257,Grémecey,100,0,331,331,3.3
61512,Les Yveteaux,100,0,571,571,5.7
64265,Hosta,100,0,2599,2599,26
65249,Lalanne,100,0,3239,3239,32.4
65403,Sanous,100,0,2259,2259,22.6
70222,Étrelles-et-la-Montbleuse,100,0,452,452,4.5
71450,Saint-Martin-de-Commune,100,0,2237,2237,22.4
76710,Trémauville,100,0,762,762,7.6
80056,Bavelincourt,100,0,390,390,3.9
80459,Laleu,100,0,138,138,1.4
80683,Rouy-le-Grand,100,0,1906,1906,19.1
81110,Jouqueviel,100,0,2288,2288,22.9
81127,Lacroisille,100,0,111,111,1.1
86106,Glénouze,100,0,511,511,5.1
88031,Balléville,100,0,1117,1117,11.2
88437,Saint-Vallier,100,0,1437,1437,14.4
88455,Serécourt,100,0,777,777,7.8
88469,Thiraucourt,100,0,1437,1437,14.4
88509,Villoncourt,100,0,2515,2515,25.2
89044,Blannay,100,0,217,217,2.2
89259,Môlay,100,370,483,853,8.5
1051,Bolozon,99,0,3745,3745,37.8
2200,Clermont-les-Fermes,99,0,1091,1091,11
2778,Vendresse-Beaulne,99,0,712,712,7.2
4224,Ubraye,99,0,3501,3501,35.4
6001,Aiglun,99,0,2231,2231,22.5
6047,Conségudes,99,0,1200,1200,12.1
6096,Pierlas,99,0,2231,2231,22.5
7139,Laviolle,99,0,1690,1690,17.1
7158,Mézilhac,99,2318,1690,4008,40.5
9175,Ludiès,99,0,446,446,4.5
9183,Mauvezin-de-Prat,99,0,11997,11997,121.2
10130,Dosnon,99,0,84,84,0.8
10229,Maupas,99,0,1414,1414,14.3
11092,Citou,99,0,642,642,6.5
11317,Rodome,99,0,1088,1088,11
11347,Saint-Julia-de-Bec,99,0,1088,1088,11
15040,Chanterelle,99,1400,1527,2927,29.6
15158,Rageade,99,900,22,922,9.3
16240,Nabinaud,99,625,4655,5280,53.3
19090,Gumond,99,0,1879,1879,19
21182,Collonges-lès-Bévy,99,0,475,475,4.8
21341,Lantilly,99,0,2102,2102,21.2
21690,Villeberny,99,0,2102,2102,21.2
24545,Teillots,99,0,1731,1731,17.5
25421,Narbief,99,0,1663,1663,16.8
28121,Dambron,99,0,520,520,5.3
28303,Poupry,99,0,520,520,5.3
2A174,Murzo,99,0,456,456,4.6
2B328,Tox,99,0,754,754,7.6
31047,Bax,99,0,170,170,1.7
32387,Saint-Loube,99,0,618,618,6.2
33066,Bourdelles,99,0,806,806,8.1
33275,Martres,99,0,983,983,9.9
36238,Vigoulant,99,0,2175,2175,22
39423,Plaisia,99,715,2881,3596,36.3
39497,Saizenay,99,625,2190,2815,28.4
40176,Mauvezin-d'Armagnac,99,0,1131,1131,11.4
41034,Chambord,99,0,694,694,7
42034,Cervières,99,0,887,887,9
46079,Cras,99,0,573,573,5.8
47164,Mazières-Naresse,99,0,2528,2528,25.5
48124,Recoules-de-Fumas,99,0,2360,2360,23.8
51041,Baudement,99,0,1292,1292,13.1
51100,La Caure,99,0,143,143,1.4
51169,Corbeil,99,0,1562,1562,15.8
52459,Sarcey,99,0,10874,10874,109.8
52468,Semilly,99,0,1523,1523,15.4
54169,Domprix,99,0,436,436,4.4
54507,Sionviller,99,0,1485,1485,15
55345,Mont-devant-Sassey,99,0,3580,3580,36.2
55465,Saint-Remy-la-Calonne,99,0,1282,1282,12.9
55468,Samogneux,99,0,6136,6136,62
57036,Attilloncourt,99,0,328,328,3.3
57115,Brulange,99,0,1690,1690,17.1
57173,Desseling,99,0,645,645,6.5
57755,Xocourt,99,0,328,328,3.3
60153,Choqueuse-les-Bénards,99,0,2233,2233,22.6
61286,Montgaudry,99,1370,348,1718,17.4
63002,Aix-la-Fayette,99,1890,895,2785,28.1
63191,Lastic,99,0,3348,3348,33.8
65046,Aulon,99,0,4760,4760,48.1
65085,Bernadets-Debat,99,0,3207,3207,32.4
65247,Arrayou-Lahitte,99,0,946,946,9.6
65431,Sost,99,0,648,648,6.5
70009,Aisey-et-Richecourt,99,0,300,300,3
70047,Baignes,99,0,254,254,2.6
70050,La Barre,99,0,317,317,3.2
70225,Fahy-lès-Autrey,99,0,500,500,5.1
71020,Barnay,99,0,2215,2215,22.4
71471,Saint-Privé,99,0,1518,1518,15.3
79055,Brieuil-sur-Chizé,99,0,2859,2859,28.9
79142,Juillé,99,0,2859,2859,28.9
80220,Courtemanche,99,0,119,119,1.2
81166,Milhavet,99,0,2265,2265,22.9
81224,Le Riols,99,0,2519,2519,25.4
87058,Domps,99,0,1410,1410,14.2
88129,Derbamont,99,0,1423,1423,14.4
89043,Blacy,99,525,478,1003,10.1
2023,Armentières-sur-Ourcq,98,0,2265,2265,23.1
2412,Launoy,98,0,327,327,3.3
2485,Missy-aux-Bois,98,0,820,820,8.4
2698,Sancy-les-Cheminots,98,0,193,193,2
2732,Surfontaine,98,0,0,0,0
4120,Val d'Oronaye,98,1400,29267,30667,312.9
6051,La Croix-sur-Roudoule,98,0,2209,2209,22.5
6081,Le Mas,98,0,2502,2502,25.5
9110,Encourtiech,98,0,11876,11876,121.2
10046,Blaincourt-sur-Aube,98,0,2069,2069,21.1
15190,Saint-Hippolyte,98,3060,1511,4571,46.6
15242,Le Trioulou,98,850,859,1709,17.4
16365,Sauvignac,98,1030,5240,6270,64
19175,Roche-le-Peyroux,98,0,1343,1343,13.7
21229,Diancey,98,0,3023,3023,30.8
21378,Marcenay,98,0,1635,1635,16.7
25496,Roche-lès-Clerval,98,0,226,226,2.3
31400,Nogaret,98,0,1992,1992,20.3
35026,Bléruais,98,0,1903,1903,19.4
36205,Saint-Pierre-de-Jards,98,0,1991,1991,20.3
38375,Saint-Christophe-en-Oisans,98,0,5574,5574,56.9
39100,Champrougier,98,1800,2605,4405,44.9
39381,Les Nans,98,0,992,992,10.1
40112,Gibret,98,0,1535,1535,15.7
41079,Les Essarts,98,0,1212,1212,12.4
46282,Saint-Médard-Nicourby,98,0,2894,2894,29.5
47139,Lasserre,98,0,475,475,4.8
52482,Soulaucourt-sur-Mouzon,98,0,1508,1508,15.4
57116,Buchy,98,0,3753,3753,38.3
57166,Dalhain,98,1200,324,1524,15.6
58265,Saint-Quentin-sur-Nohain,98,0,1954,1954,19.9
61086,Les Champeaux,98,870,708,1578,16.1
62091,Beaudricourt,98,0,814,814,8.3
64151,Burgaronne,98,0,2049,2049,20.9
64451,Ponson-Debat-Pouts,98,0,2214,2214,22.6
65137,Caussade-Rivière,98,0,2214,2214,22.6
65263,Larroque,98,0,3175,3175,32.4
65311,Mingot,98,0,2214,2214,22.6
65385,Saint-Arroman,98,0,293,293,3
70010,Alaincourt,98,0,623,623,6.4
70078,Bougey,98,0,297,297,3
71046,La Boulaye,98,0,2193,2193,22.4
71488,Saint-Vincent-des-Prés,98,0,681,681,6.9
80326,Fontaine-sous-Montdidier,98,0,118,118,1.2
80502,Maison-Roland,98,0,2427,2427,24.8
81169,Missècle,98,0,1466,1466,15
88041,Bazegney,98,0,1408,1408,14.4
88286,Marainville-sur-Madon,98,0,1408,1408,14.4
89363,Sainte-Pallaye,98,600,13,613,6.3
1066,La Burbanche,97,0,1081,1081,11.1
1439,Vésines,97,0,1332,1332,13.7
2181,Chéry-lès-Rozoy,97,0,1069,1069,11
2607,Ploisy,97,0,811,811,8.4
3222,Saint-Caprais,97,0,1525,1525,15.7
4194,Saint-Pierre,97,0,3430,3430,35.4
9186,Méras,97,0,1725,1725,17.8
10428,Ville-sur-Terre,97,0,577,577,5.9
11231,Mézerville,97,0,852,852,8.8
11268,Orsans,97,0,287,287,3
21159,La Chaume,97,0,1618,1618,16.7
21237,Échalot,97,0,1618,1618,16.7
21376,Marandeuil,97,0,0,0,0
21504,Prâlon,97,0,546,546,5.6
23043,Chamberaud,97,0,3041,3041,31.4
23059,La Chaussade,97,0,1273,1273,13.1
23147,Nouzerolles,97,0,2896,2896,29.9
24192,Gabillou,97,630,1696,2326,24
25215,L'Écouvotte,97,0,4835,4835,49.8
25290,La Grange,97,0,2674,2674,27.6
25500,Ronchaux,97,0,707,707,7.3
26111,Crupies,97,0,3382,3382,34.9
27035,Bailleul-la-Vallée,97,0,1494,1494,15.4
2B302,San-Giovanni-di-Moriani,97,0,696,696,7.2
31218,Gensac-de-Boulogne,97,0,2009,2009,20.7
32225,Malabat,97,0,215,215,2.2
32323,Ponsampère,97,0,215,215,2.2
32364,Saint-Avit-Frandat,97,0,55,55,0.6
38177,La Garde,97,0,5517,5517,56.9
48098,Molezon,97,5820,5283,11103,114.5
48157,Sainte-Hélène,97,960,1966,2926,30.2
52303,Maizières-sur-Amance,97,0,1913,1913,19.7
54248,Hamonville,97,0,579,579,6
54524,Thumeréville,97,0,901,901,9.3
55067,Boviolles,97,0,391,391,4
55219,Grimaucourt-en-Woëvre,97,0,1752,1752,18.1
57181,Domnom-lès-Dieuze,97,0,321,321,3.3
65110,Bugard,97,0,3142,3142,32.4
65293,Lustar,97,0,3142,3142,32.4
66152,Prugnanes,97,0,2372,2372,24.5
66206,Le Tech,97,0,0,0,0
70153,Cintrey,97,0,294,294,3
70217,Esmoulières,97,0,1116,1116,11.5
70479,Sauvigney-lès-Gray,97,0,490,490,5.1
71551,Uchon,97,0,2170,2170,22.4
80383,Goyencourt,97,0,117,117,1.2
80787,Vercourt,97,0,2402,2402,24.8
81007,Alos,97,0,5329,5329,54.9
88471,Les Thons,97,0,754,754,7.8
95492,Le Plessis-Gassot,97,0,1203,1203,12.4
2723,Soize,96,0,1058,1058,11
4095,L'Hospitalet,96,0,253,253,2.6
8027,Auboncourt-Vauzelles,96,0,2106,2106,21.9
8155,Étalle,96,0,2510,2510,26.1
10118,Les Croûtes,96,0,1787,1787,18.6
10159,Fralignes,96,0,1676,1676,17.5
10180,Joncreuil,96,0,2027,2027,21.1
11184,Lafage,96,0,284,284,3
12109,Gissac,96,0,3756,3756,39.1
14439,Monfréville,96,0,665,665,6.9
15217,Saint-Victor,96,976,842,1818,18.9
16127,Empuré,96,700,2101,2801,29.2
21064,Benoisey,96,0,1870,1870,19.5
21343,Larrey,96,0,1602,1602,16.7
21666,Vernot,96,0,1366,1366,14.2
21669,Verrey-sous-Drée,96,0,540,540,5.6
21711,Vix,96,0,1602,1602,16.7
23157,La Pouge,96,0,3010,3010,31.4
25492,Rillans,96,0,4785,4785,49.8
2A203,Partinello,96,0,442,442,4.6
32434,Sion,96,0,64,64,0.7
34158,Minerve,96,0,363,363,3.8
38036,Beauvoir-en-Royans,96,0,1551,1551,16.2
39565,Villeneuve-d'Aval,96,290,930,1220,12.7
40008,Argelouse,96,0,755,755,7.9
40096,Estigarde,96,0,1096,1096,11.4
41213,Saint-Gourgon,96,0,1187,1187,12.4
46078,Couzou,96,0,3132,3132,32.6
46096,Espeyroux,96,0,2835,2835,29.5
46323,Ussel,96,0,2873,2873,29.9
48176,Saint-Pierre-des-Tripiers,96,3870,2355,6225,64.8
51300,Isle-sur-Marne,96,0,596,596,6.2
52115,Chatenay-Mâcheron,96,0,440,440,4.6
52196,Faverolles,96,0,440,440,4.6
52363,Orbigny-au-Val,96,0,440,440,4.6
52364,Orcevaux,96,0,1189,1189,12.4
54427,Pierre-Percée,96,0,933,933,9.7
54442,Quevilloncourt,96,0,0,0,0
57594,Roppeviller,96,0,2212,2212,23
58162,Menestreau,96,0,1914,1914,19.9
63416,Savennes,96,0,3246,3246,33.8
64099,Bastanès,96,0,2007,2007,20.9
65216,Hauban,96,0,721,721,7.5
66077,Fenouillet,96,0,2347,2347,24.4
66143,Planèzes,96,0,2347,2347,24.4
70305,Lœuilley,96,0,484,484,5
80098,Bettembos,96,0,133,133,1.4
80397,Gueudecourt,96,0,688,688,7.2
80574,Mouflers,96,0,2377,2377,24.8
2104,Bouffignereux,95,0,256,256,2.7
4154,Pontis,95,3608,7592,11200,117.9
8036,Autry,95,0,2299,2299,24.2
8073,Bossus-lès-Rumigny,95,0,2484,2484,26.1
8432,Sury,95,0,1479,1479,15.6
8453,Toges,95,0,2299,2299,24.2
9084,Castex,95,0,1690,1690,17.8
9139,L'Hospitalet-près-l'Andorre,95,0,13682,13682,144
9295,Siguer,95,0,13682,13682,144
10077,Champigny-sur-Aube,95,0,81,81,0.9
11376,La Serpent,95,0,1251,1251,13.2
11417,Villarzel-du-Razès,95,0,1251,1251,13.2
14402,Le Marais-la-Chapelle,95,0,1488,1488,15.7
14469,Norrey-en-Auge,95,0,1488,1488,15.7
15073,Fridefont,95,2710,2101,4811,50.6
16184,Lichères,95,0,1194,1194,12.6
18121,Lantan,95,0,885,885,9.3
19212,Saint-Hilaire-Taurieux,95,0,282,282,3
21448,Mussy-la-Fosse,95,0,0,0,0
21514,Quemigny-sur-Seine,95,0,1585,1585,16.7
23184,Saint-Bard,95,0,1247,1247,13.1
25595,Vellerot-lès-Belvoir,95,200,2619,2819,29.7
26205,Montmaur-en-Diois,95,480,5282,5762,60.7
2A197,Osani,95,0,438,438,4.6
2B184,Olcani,95,0,3484,3484,36.7
31122,Casties-Labrande,95,0,3327,3327,35
31260,Laffite-Toupière,95,0,5106,5106,53.7
31422,Plagne,95,0,3327,3327,35
32009,Armous-et-Cau,95,0,1440,1440,15.2
32318,Pis,95,0,54,54,0.6
32349,Roquelaure-Saint-Aubin,95,0,358,358,3.8
39147,Chilly-sur-Salins,95,900,2101,3001,31.6
45052,Breteau,95,0,1106,1106,11.6
46122,Gintrac,95,0,3099,3099,32.6
48106,Noalhac,95,170,3511,3681,38.7
48191,La Tieule,95,0,3373,3373,35.5
51437,Poilly,95,0,1688,1688,17.8
52358,Noyers,95,0,436,436,4.6
54379,Mont-l'Étroit,95,0,3150,3150,33.2
55530,Valbois,95,0,1129,1129,11.9
57662,Suisse,95,0,1622,1622,17.1
61238,Louvières-en-Auge,95,0,201,201,2.1
61498,Vaunoise,95,550,1103,1653,17.4
63220,Mazoires,95,0,618,618,6.5
64193,Corbère-Abères,95,0,992,992,10.4
64503,Samsons-Lion,95,0,992,992,10.4
70320,Magny-lès-Jussey,95,0,288,288,3
70518,Le Val-Saint-Éloi,95,0,564,564,5.9
71500,Sarry,95,0,2692,2692,28.3
73101,Doucy-en-Bauges,95,0,1208,1208,12.7
80813,Vraignes-lès-Hornoy,95,0,131,131,1.4
88155,Domvallier,95,0,1365,1365,14.4
89071,Chamoux,95,0,206,206,2.2
2146,Celles-lès-Condé,94,0,2173,2173,23.1
2496,Monnes,94,0,90,90,1
2623,Prisces,94,0,1676,1676,17.8
2651,Rogécourt,94,0,1689,1689,18
8192,Givron,94,0,2062,2062,21.9
8431,Sugny,94,0,2274,2274,24.2
9205,Montfa,94,0,1672,1672,17.8
9243,Régat,94,0,1947,1947,20.7
9294,Sieuras,94,0,1672,1672,17.8
10200,La Loge-aux-Chèvres,94,0,559,559,5.9
11169,Greffeil,94,0,1237,1237,13.2
15093,Lapeyrugue,94,740,824,1564,16.6
16331,Saint-Laurent-des-Combes,94,350,4420,4770,50.7
16398,Verneuil,94,0,1934,1934,20.6
18203,Saint-Christophe-le-Chaudry,94,0,252,252,2.7
21439,Montoillot,94,0,529,529,5.6
23098,Jalesches,94,0,253,253,2.7
23125,Le Mas-d'Artige,94,0,1289,1289,13.7
24493,Saint-Raphaël,94,40,1182,1222,13
25163,Corcelle-Mieslot,94,0,4686,4686,49.9
26047,Bellegarde-en-Diois,94,0,5226,5226,55.6
28025,Barmainville,94,0,0,0,0
28336,Saint-Éman,94,0,348,348,3.7
2B036,Bigorno,94,0,1753,1753,18.6
31012,Arbon,94,0,5052,5052,53.7
32466,Viozan,94,0,208,208,2.2
38092,Châtelus,94,0,1519,1519,16.2
39454,Recanoz,94,0,2498,2498,26.6
46037,Bouziès,94,0,794,794,8.4
46181,Lunegarde,94,0,544,544,5.8
47120,Jusix,94,0,973,973,10.4
51039,Bassu,94,0,551,551,5.9
51082,Braux-Sainte-Cohière,94,0,1396,1396,14.9
51473,Saint-Bon,94,0,1227,1227,13.1
52011,Annéville-la-Prairie,94,0,10325,10325,109.8
52181,Échenay,94,0,348,348,3.7
52231,Guindrecourt-aux-Ormes,94,0,348,348,3.7
54097,Bréménil,94,0,333,333,3.5
54420,Petit-Failly,94,0,1193,1193,12.7
55251,Ippécourt,94,0,1272,1272,13.5
57077,Bezange-la-Petite,94,0,311,311,3.3
61021,Avrilly,94,860,3176,4036,42.9
62129,Biefvillers-lès-Bapaume,94,0,467,467,5
62345,Fontaine-l'Étalon,94,0,2031,2031,21.6
62554,Maresville,94,0,1000,1000,10.6
62838,Vaulx,94,0,2031,2031,21.6
64025,Angous,94,0,1965,1965,20.9
65015,Antin,94,0,3045,3045,32.4
65164,Escoubès-Pouts,94,0,898,898,9.6
65169,Estaing,94,0,3849,3849,40.9
65187,Gaussan,94,0,3045,3045,32.4
65328,Neuilh,94,0,706,706,7.5
65467,Vier-Bordes,94,0,3849,3849,40.9
70230,Fédry,94,0,482,482,5.1
76431,Le Mesnil-Lieubray,94,0,1776,1776,18.9
76505,Pommereux,94,0,1776,1776,18.9
80356,Fresnoy-Andainville,94,0,130,130,1.4
80371,Froyelles,94,0,2328,2328,24.8
81148,Loubers,94,0,2392,2392,25.4
88154,Domrémy-la-Pucelle,94,0,1050,1050,11.2
88307,Mont-lès-Lamarche,94,0,731,731,7.8
88314,Morizécourt,94,0,731,731,7.8
2536,Nampteuil-sous-Muret,93,0,311,311,3.3
2796,Vichel-Nanteuil,93,0,2150,2150,23.1
3096,Deneuille-lès-Chantelle,93,0,1902,1902,20.5
5009,Aspres-lès-Corps,93,0,6188,6188,66.5
6061,Les Ferres,93,0,1127,1127,12.1
7226,Saint-Clément,93,0,1988,1988,21.4
8033,Authe,93,0,2250,2250,24.2
8171,Fléville,93,0,2250,2250,24.2
8382,Saint-Jean-aux-Bois,93,0,2040,2040,21.9
8421,Signy-Montlibert,93,0,3293,3293,35.4
9200,Montbel,93,0,1926,1926,20.7
14239,Englesqueville-la-Percée,93,0,644,644,6.9
16155,Les Gours,93,8660,1169,9829,105.7
17401,Saint-Séverin-sur-Boutonne,93,0,2590,2590,27.8
19166,Pierrefitte,93,0,1765,1765,19
21044,Balot,93,0,1552,1552,16.7
21286,Frénois,93,0,0,0,0
21299,Gissey-sous-Flavigny,93,0,0,0,0
21524,Riel-les-Eaux,93,0,1552,1552,16.7
28257,Mondonville-Saint-Jean,93,0,540,540,5.8
31133,Cazeaux-de-Larboust,93,0,890,890,9.6
32113,Cravencères,93,0,62,62,0.7
38258,Mont-Saint-Martin,93,0,3593,3593,38.6
46244,Sabadel-Latronquière,93,0,2746,2746,29.5
46306,Sonac,93,0,2746,2746,29.5
52147,Courcelles-en-Montagne,93,0,427,427,4.6
52376,Pansey,93,0,344,344,3.7
54386,Moriviller,93,0,384,384,4.1
55220,Grimaucourt-près-Sampigny,93,0,375,375,4
57182,Donjeux,93,0,308,308,3.3
57272,Guermange,93,0,605,605,6.5
58130,Grenois,93,0,1446,1446,15.5
58190,Neuffontaines,93,0,1446,1446,15.5
62137,Blangerval-Blangermont,93,0,2009,2009,21.6
62266,Denier,93,0,773,773,8.3
65194,Générest,93,0,609,609,6.5
66061,Coustouges,93,0,0,0,0
71163,Curtil-sous-Buffières,93,0,646,646,6.9
76383,Lestanville,93,0,750,750,8.1
80304,Fay,93,0,1683,1683,18.1
81135,Laparrouquial,93,0,2366,2366,25.4
1190,Innimond,92,0,1570,1570,17.1
2764,Vassogne,92,0,661,661,7.2
8169,Flaignes-Havys,92,0,2405,2405,26.1
9018,Arrout,92,0,11148,11148,121.2
14223,Le Détroit,92,0,1441,1441,15.7
21051,Baulme-la-Roche,92,0,517,517,5.6
21063,Beneuvre,92,0,1535,1535,16.7
21151,Chassey,92,0,1954,1954,21.2
21309,Griselles,92,0,1535,1535,16.7
21395,Massingy-lès-Vitteaux,92,0,1954,1954,21.2
21601,Semezanges,92,0,441,441,4.8
23009,Auge,92,0,1383,1383,15
25419,Nans,92,0,212,212,2.3
27259,Foucrainville,92,0,1082,1082,11.8
27395,Mélicourt,92,0,397,397,4.3
2A128,Granace,92,0,0,0,0
2A204,Pastricciola,92,0,424,424,4.6
2B105,Erbajolo,92,0,346,346,3.8
33139,Coutures,92,0,914,914,9.9
33148,Dardenac,92,0,1795,1795,19.5
36196,Saint-Gilles,92,0,1855,1855,20.2
38224,Mayres-Savel,92,3550,963,4513,49.1
39575,Le Villey,92,0,2445,2445,26.6
40013,Arthez-d'Armagnac,92,0,879,879,9.6
41215,Saint-Jacques-des-Guérets,92,485,1138,1623,17.6
46093,Espagnac-Sainte-Eulalie,92,0,2717,2717,29.5
48110,Paulhac-en-Margeride,92,0,945,945,10.3
50529,Saint-Nicolas-des-Bois,92,0,2264,2264,24.6
51430,Pierre-Morains,92,0,1828,1828,19.9
52090,Celsoy,92,0,1814,1814,19.7
52320,Merrey,92,0,1415,1415,15.4
54398,Neuviller-lès-Badonviller,92,0,326,326,3.5
54601,Xures,92,0,1380,1380,15
55582,Wiseppe,92,0,3327,3327,36.2
57248,Givrycourt,92,0,304,304,3.3
58113,Fertrève,92,0,461,461,5
59186,Eccles,92,0,729,729,7.9
61064,Brullemail,92,3550,32,3582,38.9
62814,Thièvres,92,0,764,764,8.3
64050,Arrast-Larrebieu,92,0,2391,2391,26
70042,Autrey-le-Vay,92,0,29,29,0.3
70374,Motey-Besuche,92,0,62,62,0.7
71451,Saint-Martin-de-Lixy,92,0,1786,1786,19.4
73193,Ontex,92,0,509,509,5.5
80157,Bussy-lès-Poix,92,0,127,127,1.4
82118,Montaïn,92,0,1182,1182,12.8
89081,La Chapelle-Vaupelteigne,92,500,13,513,5.6
89164,Festigny,92,1120,1925,3045,33.1
2091,Blanzy-lès-Fismes,91,0,179,179,2
2171,Chaudardes,91,0,245,245,2.7
2577,Ostel,91,0,179,179,2
3143,Lételon,91,0,1431,1431,15.7
4210,Soleilhas,91,0,3218,3218,35.4
7047,Cellier-du-Luc,91,1978,712,2690,29.6
8288,Mesmont,91,0,1996,1996,21.9
9271,Saint-Michel,91,0,410,410,4.5
10194,Lévigny,91,0,542,542,6
10302,Praslin,91,0,1694,1694,18.6
12055,La Capelle-Bonance,91,0,8619,8619,94.7
14748,Vieux-Bourg,91,0,1463,1463,16.1
17422,Seigné,91,0,2535,2535,27.9
19205,Saint-Geniez-ô-Merle,91,0,270,270,3
21326,Jours-lès-Baigneux,91,0,1518,1518,16.7
21447,Musigny,91,0,2807,2807,30.8
21627,Thenissey,91,0,0,0,0
24502,Saint-Séverin-d'Estissac,91,50,496,546,6
25175,Courtetain-et-Salans,91,0,1075,1075,11.8
25338,Lizine,91,0,663,663,7.3
25404,Montmahoux,91,0,663,663,7.3
25613,Viéthorey,91,0,210,210,2.3
30219,Rogues,91,0,1468,1468,16.1
32048,Betcave-Aguin,91,0,1156,1156,12.7
32077,Castelnau-d'Anglès,91,0,1380,1380,15.2
32148,Giscaro,91,0,1156,1156,12.7
32280,Mont-d'Astarac,91,0,1074,1074,11.8
32401,Saint-Ost,91,0,201,201,2.2
38056,Bressieux,91,0,993,993,10.9
39010,Andelot-Morval,91,1950,2648,4598,50.5
39054,Biefmorin,91,325,2013,2338,25.7
43035,Bonneval,91,400,3786,4186,46
43228,Saint-Victor-sur-Arlanc,91,832,3786,4618,50.7
46196,Montamel,91,0,2723,2723,29.9
46245,Sabadel-Lauzès,91,0,526,526,5.8
51157,Coizard-Joches,91,0,132,132,1.5
51395,Nesle-la-Reposte,91,0,1187,1187,13
51503,Saint-Martin-l'Heureux,91,0,1617,1617,17.8
52287,Levécourt,91,0,1400,1400,15.4
54355,Martincourt,91,0,994,994,10.9
54407,Ognéville,91,0,0,0,0
54530,Tramont-Lassus,91,0,3017,3017,33.2
55199,Froidos,91,0,951,951,10.5
55377,Nepvant,91,0,3291,3291,36.2
55572,Vittarville,91,0,1663,1663,18.3
57328,Holacourt,91,0,4223,4223,46.4
58097,Diennes-Aubigny,91,0,456,456,5
61188,La Genevraie,91,200,0,200,2.2
65193,Gembrie,91,0,595,595,6.5
65260,Lapeyre,91,0,2948,2948,32.4
65342,Osmets,91,0,2948,2948,32.4
65441,Thèbe,91,0,595,595,6.5
66092,Lansac,91,0,2225,2225,24.5
80180,Cavillon,91,0,157,157,1.7
80391,Grivillers,91,0,110,110,1.2
80413,Hancourt,91,0,652,652,7.2
81094,Fraissines,91,0,2812,2812,30.9
81213,Pratviel,91,0,1361,1361,15
81321,Le Vintrou,91,0,786,786,8.6
82133,Mouillac,91,0,1287,1287,14.1
88013,Aroffe,91,0,1017,1017,11.2
88052,Belrupt,91,0,707,707,7.8
88056,Bettoncourt,91,0,1308,1308,14.4
88058,Biécourt,91,0,1308,1308,14.4
88062,Blevaincourt,91,0,707,707,7.8
2828,Vregny,90,0,753,753,8.4
4091,Ganagobie,90,0,3772,3772,41.9
5112,Rabou,90,0,3368,3368,37.4
8146,Draize,90,0,1974,1974,21.9
9298,Sorgeat,90,150,12961,13111,145.7
10108,Courtaoult,90,0,1676,1676,18.6
10305,Prémierfait,90,0,93,93,1
14136,Cardonville,90,0,623,623,6.9
14446,Montigny,90,0,159,159,1.8
17372,Saint-Médard,90,0,1063,1063,11.8
25053,Belvoir,90,0,2481,2481,27.6
25117,Champoux,90,0,1586,1586,17.6
25450,Pessans,90,0,656,656,7.3
26104,Cornillac,90,0,4625,4625,51.4
26126,Eygalayes,90,0,4625,4625,51.4
2A117,Forciolo,90,0,67,67,0.7
2B183,Ogliastro,90,0,3301,3301,36.7
31134,Cazeneuve-Montaut,90,0,1864,1864,20.7
31152,Coueilles,90,0,1864,1864,20.7
31532,Sarremezan,90,0,1864,1864,20.7
32015,Aujan-Mournède,90,0,1062,1062,11.8
32270,Mongausy,90,0,1143,1143,12.7
32363,Sainte-Aurence-Cazaux,90,0,199,199,2.2
39085,Cerniébaud,90,0,911,911,10.1
39386,Neuvilley,90,150,1991,2141,23.8
41236,Sasnières,90,0,1113,1113,12.4
43171,Saint-Bérain,90,550,820,1370,15.2
43180,Saint-Étienne-du-Vigan,90,0,436,436,4.8
46230,Puyjourdes,90,0,2658,2658,29.5
48187,Les Salces,90,0,3196,3196,35.5
51302,Les Istres-et-Bury,90,0,1789,1789,19.9
51491,Saint-Jean-sur-Tourbe,90,0,847,847,9.4
52233,Guyonvelle,90,0,1775,1775,19.7
52295,Louvières,90,0,9886,9886,109.8
54003,Aboncourt,90,0,2984,2984,33.2
55036,Beauclair,90,0,3254,3254,36.2
55415,Ranzières,90,0,1326,1326,14.7
57342,Ibigny,90,0,586,586,6.5
57399,Lezey,90,0,298,298,3.3
58013,Arthel,90,0,5079,5079,56.4
58114,Fléty,90,0,4642,4642,51.6
58125,Gien-sur-Cure,90,0,1061,1061,11.8
62470,Incourt,90,0,1425,1425,15.8
65277,Lombrès,90,0,589,589,6.5
70468,Saint-Marcel,90,0,272,272,3
71017,Ballore,90,0,349,349,3.9
76454,Mortemer,90,0,2102,2102,23.4
81123,Lacapelle-Ségalar,90,0,2290,2290,25.4
88057,Le Beulay,90,0,875,875,9.7
88137,Dolaincourt,90,0,1005,1005,11.2
88443,Sartes,90,0,1005,1005,11.2
2241,La Croix-sur-Ourcq,89,0,2057,2057,23.1
2634,Raillimont,89,0,981,981,11
4159,Redortiers,89,0,235,235,2.6
4186,Saint-Laurent-du-Verdon,89,0,1035,1035,11.6
5089,Montrond,89,0,2653,2653,29.8
8086,Briquenay,89,0,2153,2153,24.2
8196,Grandchamp,89,0,1952,1952,21.9
8238,Jonval,89,0,1952,1952,21.9
8256,Liry,89,0,2153,2153,24.2
8274,Marcq,89,0,2153,2153,24.2
8426,Son,89,0,1702,1702,19.1
11179,Labastide-en-Val,89,0,577,577,6.5
11287,Peyrolles,89,630,1172,1802,20.2
12019,Balaguier-sur-Rance,89,0,3482,3482,39.1
15112,Malbo,89,1400,1969,3369,37.9
21030,Aubaine,89,0,1353,1353,15.2
21468,Orain,89,0,388,388,4.4
24378,Saint-Avit-Rivière,89,2100,323,2423,27.2
25506,Rougemontot,89,0,4436,4436,49.8
26022,Ballons,89,0,4573,4573,51.4
26229,La Penne-sur-l'Ouvèze,89,0,4573,4573,51.4
26253,Poyols,89,1250,4948,6198,69.6
31014,Arguenos,89,0,4783,4783,53.7
31039,Bachas,89,0,1844,1844,20.7
33295,Mouillac,89,0,1340,1340,15.1
39070,Bourg-de-Sirod,89,0,901,901,10.1
39207,Écrille,89,0,2590,2590,29.1
39281,Le Latet,89,0,901,901,10.1
46146,Ladirat,89,0,2904,2904,32.6
48153,Saint-Gal,89,1050,1048,2098,23.6
48192,Trélans,89,4050,3160,7210,81
51321,Lhéry,89,0,1582,1582,17.8
51533,Servon-Melzicourt,89,0,1322,1322,14.9
54119,Charey,89,0,531,531,6
54204,Forcelles-sous-Gugney,89,0,0,0,0
55118,Cléry-le-Grand,89,0,3218,3218,36.2
55185,Èvres,89,0,1205,1205,13.5
55330,Méligny-le-Grand,89,0,359,359,4
55469,Sassey-sur-Meuse,89,0,3218,3218,36.2
57141,Chicourt,89,0,295,295,3.3
61062,Brieux,89,0,188,188,2.1
62722,Rougefay,89,0,1923,1923,21.6
64195,Coublucq,89,0,1394,1394,15.7
64432,Ossas-Suhare,89,0,2313,2313,26
65399,Saligos,89,0,3644,3644,40.9
70443,La Grande-Résie,89,0,449,449,5
71113,Châteauneuf,89,0,1727,1727,19.4
73311,Le Verneil,89,0,1592,1592,17.9
80065,Beaucourt-sur-l'Ancre,89,0,100,100,1.1
80455,Lachapelle,89,0,123,123,1.4
80537,Mesnil-Domqueur,89,0,2204,2204,24.8
80587,Neslette,89,0,123,123,1.4
88255,Jubainville,89,0,994,994,11.2
88359,Prey,89,0,117,117,1.3
88478,Tranqueville-Graux,89,0,994,994,11.2
2152,Cerseuil,88,0,174,174,2
8308,Mont-Saint-Martin,88,0,2129,2129,24.2
10009,Arrelles,88,0,1536,1536,17.5
10309,Prusy,88,0,1638,1638,18.6
11244,Montfort-sur-Boulzane,88,0,967,967,11
11377,Serres,88,0,1158,1158,13.2
12067,Le Clapier,88,0,3768,3768,42.8
12295,Viala-du-Pas-de-Jaux,88,0,3768,3768,42.8
14550,Rumesnil,88,0,1118,1118,12.7
18260,Tendron,88,0,172,172,2
21040,Avosnes,88,0,1869,1869,21.2
23183,Saint-Avit-le-Pauvre,88,0,2759,2759,31.4
25005,Accolans,88,0,203,203,2.3
25006,Adam-lès-Passavant,88,0,4386,4386,49.8
26190,Montaulieu,88,0,4522,4522,51.4
2A266,Salice,88,0,405,405,4.6
2A322,Tasso,88,0,66,66,0.8
31353,Monès,88,0,3082,3082,35
34331,Verreries-de-Moussans,88,0,333,333,3.8
39337,Molamboz,88,189,1946,2135,24.3
45181,Léouville,88,0,320,320,3.6
46002,Albiac,88,0,2599,2599,29.5
50271,Lingeard,88,0,2165,2165,24.6
50634,Videcosville,88,0,2768,2768,31.5
51373,Moncetz-l'Abbaye,88,0,547,547,6.2
52131,Cirfontaines-en-Ornois,88,0,326,326,3.7
52207,Frécourt,88,0,404,404,4.6
52284,Leschères-sur-le-Blaiseron,88,0,326,326,3.7
52433,Romain-sur-Meuse,88,0,1354,1354,15.4
52473,Signéville,88,0,1354,1354,15.4
54068,Beuvezin,88,0,2918,2918,33.2
55087,Bure,88,0,1720,1720,19.5
57236,Frémery,88,0,291,291,3.3
57676,Tragny,88,0,3370,3370,38.3
58183,Mouron-sur-Yonne,88,0,1368,1368,15.5
61374,Saint-Christophe-de-Chaulieu,88,540,2973,3513,39.9
64372,Maure,88,0,1988,1988,22.6
65416,Seich,88,0,576,576,6.5
71172,Dettey,88,0,1969,1969,22.4
72018,Avesnes-en-Saosnois,88,0,1632,1632,18.5
73221,Saint-Alban-des-Villards,88,0,12608,12608,143.3
80829,Y,88,0,1677,1677,19.1
81137,Lasfaillades,88,0,822,822,9.3
82143,Poupas,88,0,2063,2063,23.4
88045,Beaufremont,88,0,31,31,0.4
89325,Ronchères,88,1375,3974,5349,60.8
89375,Santigny,88,2100,425,2525,28.7
89403,Stigny,88,0,204,204,2.3
2442,Loupeigne,87,0,2011,2011,23.1
6160,Villeneuve-d'Entraunes,87,0,1961,1961,22.5
8217,Haulmé,87,0,1354,1354,15.6
8411,Semuy,87,0,1908,1908,21.9
8455,Tourcelles-Chaumont,87,0,2105,2105,24.2
9323,Vals,87,0,1802,1802,20.7
10065,Brillecourt,87,0,74,74,0.9
10135,Éclance,87,0,518,518,6
10167,Grandville,87,0,74,74,0.9
11309,Rennes-le-Château,87,7350,1145,8495,97.6
12179,Peux-et-Couffouleux,87,0,3404,3404,39.1
14358,Léaupartie,87,0,1398,1398,16.1
19200,Saint-Étienne-la-Geneste,87,0,1193,1193,13.7
21015,Antigny-la-Ville,87,0,2683,2683,30.8
21204,Courcelles-lès-Montbard,87,0,1695,1695,19.5
21457,Noidan,87,0,1847,1847,21.2
21696,Villeneuve-sous-Charigny,87,0,1847,1847,21.2
24122,Cladech,87,350,4259,4609,53
25088,Breconchaux,87,0,4337,4337,49.9
25211,Échevannes,87,0,634,634,7.3
2A268,Sampolo,87,0,65,65,0.7
31030,Ausseing,87,0,4676,4676,53.7
31437,Pouze,87,0,1418,1418,16.3
32023,Avezan,87,0,328,328,3.8
32228,Manent-Montané,87,0,1027,1027,11.8
32371,Saint-Créac,87,0,328,328,3.8
32375,Saint-Élix-Theux,87,0,193,193,2.2
32415,Sarraguzan,87,0,193,193,2.2
39222,Fay-en-Montagne,87,175,1924,2099,24.1
39267,Ivory,87,250,1924,2174,25
39473,Saffloz,87,1050,881,1931,22.2
39556,Vertamboz,87,300,2532,2832,32.6
47286,Sauméjan,87,0,1468,1468,16.9
51062,Binarville,87,0,1292,1292,14.9
51182,Courcemain,87,0,1135,1135,13
51578,Trécon,87,0,1729,1729,19.9
52149,Courcelles-sur-Blaise,87,0,322,322,3.7
54013,Amenoncourt,87,0,309,309,3.6
54140,Courcelles,87,0,2885,2885,33.2
54324,Lorey,87,0,359,359,4.1
55104,Chassey-Beaupré,87,0,1700,1700,19.5
55281,Latour-en-Woëvre,87,0,1126,1126,12.9
55282,Lavallée,87,0,1178,1178,13.5
55363,Moulotte,87,0,1126,1126,12.9
57478,Montdidier,87,0,288,288,3.3
58128,Glux-en-Glenne,87,0,1025,1025,11.8
60237,Fléchy,87,0,1962,1962,22.6
60294,Hainvillers,87,0,761,761,8.7
61271,Le Ménil-Scelleur,87,0,391,391,4.5
61360,Saint-Agnan-sur-Sarthe,87,2768,31,2799,32.2
61420,Sainte-Marie-la-Robert,87,1560,391,1951,22.4
62375,Gommecourt,87,0,433,433,5
62593,Morval,87,0,433,433,5
65176,Ferrières,87,0,930,930,10.7
65196,Gensac,87,0,1965,1965,22.6
66156,Rabouillet,87,0,2127,2127,24.4
70072,Beveuge,87,0,28,28,0.3
70316,Le Magnoray,87,0,278,278,3.2
70538,Vellemoz,87,0,393,393,4.5
71352,Le Planois,87,0,163,163,1.9
81264,Saint-Michel-Labadié,87,0,2688,2688,30.9
88023,Avillers,87,0,1250,1250,14.4
88229,Harchéchamp,87,0,972,972,11.2
88338,Ortoncourt,87,0,434,434,5
4175,Sainte-Croix-à-Lauze,86,0,227,227,2.6
7163,Montselgues,86,0,2104,2104,24.5
8154,Estrebay,86,0,2248,2248,26.1
11226,Mayreville,86,0,756,756,8.8
11314,Rieux-en-Val,86,0,558,558,6.5
11424,Villefort,86,0,945,945,11
14613,Saint-Marcouf,86,0,595,595,6.9
15091,Landeyrat,86,1500,19,1519,17.7
19168,Pradines,86,0,1497,1497,17.4
21381,Marcilly-et-Dracy,86,0,1826,1826,21.2
21700,Villers-Patras,86,0,1435,1435,16.7
23044,Chambon-Sainte-Croix,86,0,2567,2567,29.8
25017,Amondans,86,0,627,627,7.3
25077,La Bosse,86,0,1444,1444,16.8
2B235,Pioggiola,86,0,1207,1207,14
31010,Antignac,86,0,823,823,9.6
31207,Galié,86,0,823,823,9.6
32010,Arrouède,86,0,1015,1015,11.8
32161,Izotges,86,0,1585,1585,18.4
33409,Saint-Genis-du-Bois,86,0,0,0,0
39178,Crans,86,150,871,1021,11.9
39425,Les Planches-près-Arbois,86,1180,1902,3082,35.8
43173,Saint-Christophe-d'Allier,86,0,417,417,4.8
45180,Langesse,86,0,1113,1113,12.9
46104,Flaujac-Gare,86,0,2540,2540,29.5
47245,Saint-Géraud,86,0,4236,4236,49.3
48031,Brion,86,10987,3178,14165,164.7
48108,La Panouse,86,3195,1013,4208,48.9
51197,La Croix-en-Champagne,86,0,809,809,9.4
51222,Éclaires,86,0,1277,1277,14.8
52015,Arbigny-sous-Varennes,86,0,1696,1696,19.7
54085,Borville,86,0,355,355,4.1
55089,Burey-la-Côte,86,0,347,347,4
55100,Champougny,86,0,347,347,4
55141,Dagonville,86,0,347,347,4
55411,Rambluzin-et-Benoite-Vaux,86,0,547,547,6.4
58029,Beuvron,86,220,1337,1557,18.1
58253,Sainte-Marie,86,0,431,431,5
60271,Gerberoy,86,0,422,422,4.9
62822,Tollent,86,0,1858,1858,21.6
63088,La Chapelle-sur-Usson,86,0,559,559,6.5
65026,Aries-Espénan,86,0,2786,2786,32.4
65052,Averan,86,0,822,822,9.6
65144,Cheust,86,0,822,822,9.6
65298,Marquerie,86,0,546,546,6.3
65457,Ugnouas,86,0,1943,1943,22.6
71224,Grandvaux,86,0,333,333,3.9
80264,Éclusier-Vaux,86,0,96,96,1.1
80418,Hardecourt-aux-Bois,86,0,616,616,7.2
80565,Montonvillers,86,0,335,335,3.9
80604,Offignies,86,0,119,119,1.4
84021,Brantes,86,0,101,101,1.2
88102,Chermisey,86,0,961,961,11.2
88511,Villouxel,86,0,961,961,11.2
90085,Riervescemont,86,310,2562,2872,33.4
2234,Craonne,85,0,611,611,7.2
2606,Le Plessier-Huleu,85,0,284,284,3.3
4012,Aubenas-les-Alpes,85,0,224,224,2.6
5102,La Piarre,85,0,2534,2534,29.8
8130,Contreuve,85,0,2057,2057,24.2
8184,Fromy,85,0,3009,3009,35.4
8446,Thénorgues,85,0,2057,2057,24.2
8502,Yoncq,85,0,3009,3009,35.4
9252,Rouze,85,0,12241,12241,144
10214,Magnicourt,85,0,1794,1794,21.1
14445,Montfiquet,85,0,588,588,6.9
15172,Saint-Antoine,85,1225,745,1970,23.2
19087,Gourdon-Murat,85,0,1480,1480,17.4
19284,Viam,85,0,1480,1480,17.4
21364,Magny-Lambert,85,0,1418,1418,16.7
21533,Rouvres-sous-Meilly,85,0,1292,1292,15.2
24393,Sainte-Croix,85,1450,309,1759,20.7
25244,Fleurey,85,0,592,592,7
27042,Barville,85,0,1309,1309,15.4
2B149,Lugo-di-Nazza,85,0,0,0,0
31130,Cazaril-Tambourès,85,0,1761,1761,20.7
31333,Mauvezin,85,0,1761,1761,20.7
31337,Melles,85,0,814,814,9.6
39119,Le Chateley,85,200,1880,2080,24.5
40174,Mauries,85,0,1964,1964,23.1
50258,Joganville,85,0,2674,2674,31.5
51127,La Chapelle-Lasson,85,0,1109,1109,13
51135,Châtillon-sur-Broué,85,0,528,528,6.2
52007,Ambonville,85,0,315,315,3.7
52039,Baudrecourt,85,0,315,315,3.7
52063,Bourg-Sainte-Marie,85,0,1308,1308,15.4
52091,Cerisières,85,0,9337,9337,109.8
52135,Coiffy-le-Bas,85,0,1676,1676,19.7
54293,Landécourt,85,0,351,351,4.1
55487,Seuzey,85,0,1253,1253,14.7
57080,Bickenholtz,85,0,553,553,6.5
58224,Ruages,85,0,1322,1322,15.6
63399,Saint-Sulpice,85,0,2874,2874,33.8
64258,Haux,85,0,2209,2209,26
64340,Lichans-Sunhar,85,0,2209,2209,26
64392,Moncla,85,0,1331,1331,15.7
70397,Ormenans,85,0,272,272,3.2
81234,Roussayrolles,85,0,2163,2163,25.4
89146,Domecy-sur-le-Vault,85,200,184,384,4.5
2055,Beaumé,84,0,1649,1649,19.6
2343,Germaine,84,0,761,761,9.1
2421,Lesges,84,0,166,166,2
5167,Sigottier,84,0,2504,2504,29.8
6115,Saint-Antonin,84,0,1893,1893,22.5
8307,Montmeillant,84,0,1842,1842,21.9
9048,Belloc,84,0,1740,1740,20.7
9159,Lassur,84,1650,12097,13747,163.7
10134,Échemines,84,0,0,0,0
10146,Fay-lès-Marcilly,84,0,0,0,0
11239,Montauriol,84,5160,738,5898,70.2
14502,Pierrepont,84,0,1316,1316,15.7
15020,Beaulieu,84,0,430,430,5.1
15098,Laurie,84,1060,19,1079,12.8
18061,Chaumoux-Marcilly,84,730,387,1117,13.3
19159,Péret-Bel-Air,84,0,1078,1078,12.8
21250,Essarois,84,0,1401,1401,16.7
21384,Marey-lès-Fussey,84,0,403,403,4.8
24113,La Chapelle-Saint-Jean,84,710,1469,2179,25.9
26134,Félines-sur-Rimandoule,84,0,1018,1018,12.1
27404,Mesnil-Rousset,84,0,362,362,4.3
2B274,Scolca,84,0,1566,1566,18.6
32327,Pouy-Loubrin,84,0,991,991,11.8
32392,Saint-Martin-Gimois,84,0,1067,1067,12.7
41266,Valaire,84,0,3219,3219,38.3
50373,Neuville-au-Plain,84,0,455,455,5.4
51084,Bréban,84,0,1325,1325,15.8
51095,Le Buisson,84,0,493,493,5.9
51150,Cherville,84,0,4270,4270,50.8
51178,Coupetz,84,0,140,140,1.7
51294,Hourges,84,0,1493,1493,17.8
52217,Germainvilliers,84,0,1292,1292,15.4
52254,Lachapelle-en-Blaisy,84,0,9227,9227,109.8
52548,Vraincourt,84,0,9227,9227,109.8
54207,Fraisnes-en-Saintois,84,0,0,0,0
54555,Vaxainville,84,0,371,371,4.4
55275,Lamouilly,84,0,3037,3037,36.2
55446,Rumont,84,0,1013,1013,12.1
57233,Fraquelfing,84,0,547,547,6.5
58019,Avrée,84,0,4333,4333,51.6
58076,Chougny,84,0,4333,4333,51.6
61082,Le Chalange,84,0,30,30,0.4
62079,Bancourt,84,0,418,418,5
63359,Saint-Hilaire-les-Monges,84,0,2840,2840,33.8
64412,Nabas,84,0,1756,1756,20.9
65037,Artiguemy,84,0,251,251,3
65241,Laborde,84,0,251,251,3
65382,Sacoué,84,0,550,550,6.5
70061,Belfahy,84,0,966,966,11.5
71043,Les Bordes,84,0,969,969,11.5
71080,Champagny-sous-Uxelles,84,0,1018,1018,12.1
80081,Belloy-Saint-Léonard,84,0,116,116,1.4
81207,Peyregoux,84,0,1256,1256,15
81256,Saint-Jean-de-Vals,84,0,785,785,9.3
88345,La Petite-Fosse,84,0,817,817,9.7
88411,Saint-Baslemont,84,0,653,653,7.8
89012,Annoux,84,350,405,755,9
89244,Marmeaux,84,700,405,1105,13.2
2169,Châtillon-lès-Sons,83,0,418,418,5
2435,Logny-lès-Aubenton,83,0,1629,1629,19.6
2538,Nanteuil-Notre-Dame,83,0,1918,1918,23.1
2654,Romery,83,0,458,458,5.5
2817,Ville-Savoye,83,0,164,164,2
3269,Sauvagny,83,0,2965,2965,35.7
4043,Val-de-Chalvagne,83,0,2935,2935,35.4
8398,Sainte-Vaubourg,83,0,1820,1820,21.9
9250,Roquefort-les-Cascades,83,0,737,737,8.9
9266,Saint-Julien-de-Gras-Capou,83,0,1719,1719,20.7
14348,Juvigny-sur-Seulles,83,0,1018,1018,12.3
15064,Escorailles,83,1145,1374,2519,30.3
15229,Soulages,83,1250,1836,3086,37.2
17301,Romazières,83,0,2312,2312,27.9
17437,Talmont-sur-Gironde,83,0,1307,1307,15.7
21036,Auxant,83,0,1261,1261,15.2
21549,Saint-Germain-le-Rocheux,83,0,1385,1385,16.7
21612,Souhey,83,0,1762,1762,21.2
23156,Pontcharraud,83,0,1090,1090,13.1
25104,By,83,0,605,605,7.3
25277,Gondenans-les-Moulins,83,0,191,191,2.3
26291,Saint-Andéol,83,0,4615,4615,55.6
28067,Cernay,83,0,307,307,3.7
2A310,Santa-Maria-Figaniella,83,0,0,0,0
31414,Peyrissas,83,0,1719,1719,20.7
32226,Manas-Bastanous,83,0,184,184,2.2
32238,Marseillan,83,0,1258,1258,15.2
32355,Sadeillan,83,0,184,184,2.2
36098,Lizeray,83,0,1686,1686,20.3
39045,Beffia,83,590,2416,3006,36.2
39091,Les Chalesmes,83,550,840,1390,16.7
39234,Foulenay,83,150,2206,2356,28.4
39363,Montrevel,83,1700,2416,4116,49.6
51646,Virginy,83,0,1232,1232,14.8
52169,Domblain,83,0,752,752,9.1
52495,Trémilly,83,0,307,307,3.7
52506,Vaudrémont,83,0,455,455,5.5
55241,Heippes,83,0,528,528,6.4
55552,Vigneul-sous-Montmédy,83,0,2967,2967,35.7
57401,Lidrezing,83,0,275,275,3.3
58049,Chalaux,83,0,978,978,11.8
58066,Châtin,83,0,978,978,11.8
61266,Le Ménil-Guyon,83,0,29,29,0.3
61396,Saint-Germain-de-Martigny,83,30,291,321,3.9
63398,Saint-Sauveur-la-Sagne,83,0,750,750,9
65354,Pailhac,83,0,3990,3990,48.1
65420,Sère-en-Lavedan,83,0,3399,3399,41
65449,Tournous-Devant,83,0,248,248,3
65463,Viella,83,0,3399,3399,41
71115,Châtel-Moron,83,0,1273,1273,15.3
71128,Chiddes,83,0,577,577,7
71504,Saunières,83,0,958,958,11.5
72102,Courcival,83,0,1539,1539,18.5
73175,Montsapey,83,0,3149,3149,37.9
80203,Colincamps,83,0,93,93,1.1
80259,Dromesnil,83,0,115,115,1.4
88456,Serocourt,83,0,645,645,7.8
89187,Gigny,83,0,193,193,2.3
89406,Talcy,83,300,401,701,8.4
91075,Bois-Herpin,83,0,209,209,2.5
2225,Courchamps,82,0,1895,1895,23.1
2265,Dohis,82,0,903,903,11
2463,Marfontaine,82,0,1462,1462,17.8
2578,Oulches-la-Vallée-Foulon,82,0,589,589,7.2
4164,Revest-Saint-Martin,82,0,1665,1665,20.3
8102,Chappes,82,0,1799,1799,21.9
8454,Touligny,82,0,1799,1799,21.9
9126,Freychenet,82,0,728,728,8.9
9163,Lescousse,82,0,369,369,4.5
9196,Montagagne,82,0,9937,9937,121.2
10430,Villiers-Herbisse,82,0,70,70,0.9
11321,Roquefort-de-Sault,82,0,901,901,11
19017,Bassignac-le-Bas,82,0,243,243,3
19283,Veyrières,82,0,1124,1124,13.7
21430,Montigny-Saint-Barthélemy,82,0,1741,1741,21.2
21494,Poncey-sur-l'Ignon,82,0,0,0,0
21625,Ternant,82,0,393,393,4.8
25166,Côtebrune,82,0,4087,4087,49.8
25264,Gémonval,82,0,189,189,2.3
25507,Rouhe,82,0,598,598,7.3
32287,Monties,82,0,968,968,11.8
32413,Sarcos,82,0,0,0,0
33428,Saint-Laurent-du-Plan,82,0,668,668,8.1
34228,Rieussec,82,0,310,310,3.8
38469,La Salette-Fallavaux,82,0,859,859,10.5
39372,Mournans-Charbonny,82,0,830,830,10.1
39548,Vaux-sur-Poligny,82,1370,0,1370,16.7
43107,Josat,82,0,747,747,9.1
43109,Lafarre,82,1700,397,2097,25.6
45105,Cortrat,82,0,841,841,10.3
46081,Crégols,82,0,461,461,5.6
48065,Fraissinet-de-Fourques,82,2250,2011,4261,52
51451,Queudes,82,0,1070,1070,13
51608,Vernancourt,82,0,481,481,5.9
52019,Arnancourt,82,0,304,304,3.7
52403,Praslay,82,0,1016,1016,12.4
54058,Béchamps,82,0,761,761,9.3
54219,Gellenoncourt,82,0,485,485,5.9
54255,Haudonville,82,0,362,362,4.4
54554,Vaudigny,82,0,0,0,0
55133,Couvertpuis,82,0,1603,1603,19.5
55373,Nant-le-Grand,82,0,989,989,12.1
55471,Saulmory-Villefranche,82,0,2965,2965,36.2
55549,Véry,82,0,857,857,10.5
57691,Valmunster,82,0,494,494,6
61080,Chahains,82,1075,369,1444,17.6
65012,Anla,82,0,537,537,6.5
65209,Grézian,82,0,3942,3942,48.1
70502,Tincey-et-Pontrebeau,82,0,421,421,5.1
71037,Bissy-sur-Fley,82,0,1258,1258,15.3
71280,Marly-sous-Issy,82,0,422,422,5.1
80005,Agenville,82,0,320,320,3.9
80059,Bazentin,82,0,92,92,1.1
80125,Boussicourt,82,0,99,99,1.2
80134,Brassy,82,0,113,113,1.4
81154,Marnaves,82,0,2086,2086,25.4
88389,Repel,82,0,1178,1178,14.4
88473,Tignécourt,82,0,637,637,7.8
2012,Ambrief,81,0,271,271,3.3
2068,Berlancourt,81,0,1444,1444,17.8
2522,Mont-Saint-Jean,81,0,1590,1590,19.6
2747,Trefcon,81,0,734,734,9.1
4099,Lambruisse,81,1000,2864,3864,47.7
5159,Saléon,81,0,2415,2415,29.8
8029,Auflance,81,0,2868,2868,35.4
11112,Cubières-sur-Cinoble,81,800,1066,1866,23
15155,Pradiers,81,2830,18,2848,35.2
16389,Turgon,81,475,1667,2142,26.4
19232,Saint-Pardoux-le-Neuf,81,0,1110,1110,13.7
21011,Ampilly-les-Bordes,81,0,1351,1351,16.7
21152,Châteauneuf,81,0,1231,1231,15.2
21479,Pellerey,81,0,0,0,0
24232,Lavaur,81,760,139,899,11.1
25247,Fontenelle-Montby,81,0,187,187,2.3
2B025,Avapessa,81,0,0,0,0
2B102,Crocicchia,81,0,375,375,4.6
2B126,Giuncaggio,81,0,617,617,7.6
30289,Saint-Nazaire-des-Gardies,81,0,168,168,2.1
31086,Bouzin,81,0,1678,1678,20.7
31123,Castillon-de-Larboust,81,0,775,775,9.6
31226,Gouzens,81,0,139,139,1.7
31350,Mondilhan,81,0,1678,1678,20.7
31408,Payssous,81,0,775,775,9.6
31415,Peyrouzet,81,0,1678,1678,20.7
32447,Tirent-Pontéjac,81,0,1029,1029,12.7
33377,Saint-Avit-de-Soulège,81,0,611,611,7.5
38112,Clavans-en-Haut-Oisans,81,0,4607,4607,56.9
39191,Darbonnay,81,150,1792,1942,24
50283,La Luzerne,81,0,1198,1198,14.8
51083,Braux-Saint-Remy,81,0,1203,1203,14.9
51228,Élise-Daucourt,81,0,1203,1203,14.9
52354,Noidant-Chatenoy,81,0,1597,1597,19.7
55004,Aincreville,81,0,2929,2929,36.2
55537,Douaumont-Vaux,81,0,5021,5021,62
57112,Brouck,81,0,488,488,6
57719,Villers-sur-Nied,81,0,268,268,3.3
61122,Coulmer,81,2430,586,3016,37.2
62238,Conteville-en-Ternois,81,0,1750,1750,21.6
63097,Chassagne,81,0,527,527,6.5
64153,Burosse-Mendousse,81,2311,1268,3579,44.2
64394,Monpezat,81,0,846,846,10.4
64401,Mont-Disse,81,0,1268,1268,15.7
64464,Ribarrouy,81,0,1268,1268,15.7
65050,Avajan,81,0,3894,3894,48.1
65114,Buzon,81,0,1830,1830,22.6
65414,Ségalas,81,0,1830,1830,22.6
65461,Vidou,81,0,2624,2624,32.4
65466,Vielle-Louron,81,0,3894,3894,48.1
70540,Velloreille-lès-Choye,81,0,366,366,4.5
88227,Hagnéville-et-Roncourt,81,0,29,29,0.4
88254,Jorxey,81,0,1164,1164,14.4
88274,Longchamp-sous-Châtenois,81,0,905,905,11.2
89177,Fontenay-sous-Fouronnes,81,0,3657,3657,45.1
2088,Bièvres,80,0,3055,3055,38.2
2250,Cuiry-lès-Chaudardes,80,0,575,575,7.2
2354,Grandrieux,80,0,881,881,11
6045,Collongues,80,0,2043,2043,25.5
9013,Arabaux,80,0,2150,2150,26.9
9027,Augirein,80,0,9694,9694,121.2
10168,Les Granges,80,0,1489,1489,18.6
11208,La Louvière-Lauragais,80,0,703,703,8.8
11218,Marquein,80,2650,703,3353,41.9
11249,Montjardin,80,0,879,879,11
11348,Saint-Julien-de-Briola,80,0,237,237,3
14743,Victot-Pontfol,80,0,1016,1016,12.7
21029,Athie,80,0,1558,1558,19.5
21465,Obtrée,80,0,1335,1335,16.7
21477,Panges,80,0,0,0,0
24278,Monmadalès,80,700,150,850,10.6
25261,Froidevaux,80,0,2206,2206,27.6
25504,Rosureux,80,0,557,557,7
2A022,Arro,80,0,369,369,4.6
2B101,Croce,80,0,370,370,4.6
2B180,Novella,80,0,1123,1123,14
2B219,Piedicroce,80,0,370,370,4.6
31279,Latour,80,0,138,138,1.7
31392,Mourvilles-Basses,80,0,390,390,4.9
32186,Lamaguère,80,0,944,944,11.8
32188,Lamothe-Goas,80,0,45,45,0.6
32399,Saint-Orens,80,0,302,302,3.8
33419,Saint-Hilaire-du-Bois,80,0,794,794,9.9
39139,Chêne-Bernard,80,600,474,1074,13.4
40161,Lubbon,80,0,914,914,11.4
41196,Ruan-sur-Egvonne,80,937,406,1343,16.8
46250,Saint-Caprais,80,0,2263,2263,28.3
48044,Chauchailles,80,4128,2956,7084,88.6
52025,Audeloncourt,80,0,1231,1231,15.4
52051,Bize,80,0,1578,1578,19.7
55021,Avillers-Sainte-Croix,80,0,1036,1036,13
57138,Chenois,80,0,265,265,3.3
57247,Gerbécourt,80,0,265,265,3.3
58119,Frasnay-Reugny,80,0,401,401,5
58240,Saint-Franchy,80,0,401,401,5
60436,Mory-Montcrux,80,0,1804,1804,22.6
60571,Saint-Deniscourt,80,0,392,392,4.9
61291,Montreuil-la-Cambe,80,1600,169,1769,22.1
63064,La Celle,80,0,2705,2705,33.8
64044,Arget,80,0,1253,1253,15.7
65089,Betpouey,80,0,3276,3276,41
70124,Champtonnay,80,0,404,404,5
70582,Vy-lès-Rupt,80,0,206,206,2.6
71151,Créot,80,0,1790,1790,22.4
71363,Le Puley,80,0,1227,1227,15.3
71505,Savianges,80,0,1227,1227,15.3
72148,Jauzé,80,0,1483,1483,18.5
76335,Gueutteville,80,0,646,646,8.1
80258,Driencourt,80,0,573,573,7.2
80783,Vaux-Marquenneville,80,0,244,244,3
81071,Courris,80,0,2472,2472,30.9
81265,Saint-Michel-de-Vax,80,0,2036,2036,25.4
88036,Barville,80,0,894,894,11.2
88103,Circourt,80,0,1150,1150,14.4
88283,Malaincourt,80,0,28,28,0.4
89300,Pisy,80,500,386,886,11.1
1309,Pouillat,79,0,1527,1527,19.3
2582,Paissy,79,0,568,568,7.2
5160,Salérans,79,0,2355,2355,29.8
8018,Ardeuil-et-Montfauxelles,79,0,1911,1911,24.2
8269,Malandry,79,0,2797,2797,35.4
8273,Marby,79,0,2065,2065,26.1
9136,Gourbit,79,0,305,305,3.9
9179,Malléon,79,0,2123,2123,26.9
11016,Arquettes-en-Val,79,0,512,512,6.5
15065,Espinasse,79,2100,1747,3847,48.7
16394,Vaux-Lavalette,79,0,3715,3715,47
19108,Laroche-près-Feyt,79,0,1083,1083,13.7
21140,Champignolles,79,0,2437,2437,30.8
21161,Chaumont-le-Bois,79,0,1318,1318,16.7
21243,Écutigny,79,0,1201,1201,15.2
21403,Ménessaire,79,0,2437,2437,30.8
21451,Nesle-et-Massoult,79,0,1539,1539,19.5
21593,Savilly,79,0,2437,2437,30.8
23046,Chambonchard,79,0,1187,1187,15
25046,Battenans-Varin,79,0,550,550,7
25384,Mondon,79,0,182,182,2.3
26050,Bésignan,79,0,4059,4059,51.4
26214,Mornans,79,350,957,1307,16.5
2A014,Ambiegna,79,0,364,364,4.6
31294,Lespiteau,79,0,1636,1636,20.7
31295,Lespugue,79,0,1636,1636,20.7
31434,Poubeau,79,0,756,756,9.6
32293,Mouchès,79,0,1198,1198,15.2
38329,Quet-en-Beaumont,79,0,827,827,10.5
50351,Montrabot,79,0,1168,1168,14.8
51241,Euvy,79,0,149,149,1.9
52526,Villars-Santenoge,79,0,978,978,12.4
54164,Dommarie-Eulmont,79,0,0,0,0
55535,Vaudoncourt,79,0,1444,1444,18.3
57004,Achain,79,0,261,261,3.3
62242,Couin,79,0,656,656,8.3
62433,Héricourt,79,0,1707,1707,21.6
62778,Sars-le-Bois,79,0,656,656,8.3
63433,Tortebesse,79,0,2671,2671,33.8
65158,Esbareich,79,0,517,517,6.5
66155,Py,79,0,2366,2366,29.9
67199,Hinsingen,79,505,990,1495,18.9
70453,La Rosière,79,0,909,909,11.5
70462,Saint-Ferjeux,79,0,25,25,0.3
71539,Tintry,79,0,1768,1768,22.4
80336,Foucaucourt-Hors-Nesle,79,0,109,109,1.4
80646,Punchy,79,0,1430,1430,18.1
80728,Saulchoy-sous-Poix,79,0,109,109,1.4
81095,Frausseilles,79,0,2010,2010,25.4
88042,Bazien,79,0,394,394,5
88398,Les Rouges-Eaux,79,0,768,768,9.7
89016,Argentenay,79,100,184,284,3.6
2015,Ancienville,78,0,75,75,1
2542,Neuflieux,78,0,1401,1401,18
2604,Pithon,78,0,1487,1487,19.1
7004,Ajoux,78,0,260,260,3.3
7098,Gourdon,78,0,260,260,3.3
8143,Doumely-Bégny,78,0,1711,1711,21.9
8390,Sainte-Marie,78,0,1887,1887,24.2
8464,Vaux-lès-Mouron,78,0,1887,1887,24.2
11006,Albas,78,0,1057,1057,13.6
11155,Fourtou,78,0,1027,1027,13.2
15126,Molèdes,78,3300,18,3318,42.5
15180,Saint-Clément,78,3550,348,3898,50
18244,Saugy,78,0,217,217,2.8
18264,Thou,78,0,1405,1405,18
18283,Villecelin,78,0,1412,1412,18.1
19244,Saint-Sulpice-les-Bois,78,0,1069,1069,13.7
21516,Quincerot,78,0,1519,1519,19.5
25066,Blussangeaux,78,0,180,180,2.3
25342,Longechaux,78,0,921,921,11.8
25590,Vaudrivillers,78,0,2150,2150,27.6
26040,Beaurières,78,1532,4337,5869,75.2
31200,Frontignan-de-Comminges,78,0,747,747,9.6
31593,Cazac,78,0,1616,1616,20.7
32069,Cadeillan,78,0,487,487,6.2
32178,Lagardère,78,0,300,300,3.8
39507,Séligney,78,780,462,1242,15.9
40148,Lauret,78,0,1802,1802,23.1
40193,Montégut,78,0,745,745,9.6
48041,Chastanier,78,200,699,899,11.5
50578,Sortosville,78,0,2453,2453,31.4
52124,Chézeaux,78,0,1538,1538,19.7
52127,Choiseul,78,0,358,358,4.6
52372,Outremécourt,78,0,1200,1200,15.4
54325,Loromontzey,78,0,322,322,4.1
55080,Brixey-aux-Chanoines,78,0,315,315,4
55575,Vouthon-Haut,78,0,1525,1525,19.6
61120,Coudehard,78,0,165,165,2.1
64182,Castillon (Canton de Lembeye),78,0,814,814,10.4
65018,Arbéost,78,0,834,834,10.7
65405,Sarlabous,78,0,233,233,3
65448,Tournous-Darré,78,0,2527,2527,32.4
70049,Barges,78,0,236,236,3
70406,Percey-le-Grand,78,0,400,400,5.1
70527,Vaux-le-Moncelot,78,0,353,353,4.5
71478,Saint-Romain-sous-Versigny,78,0,401,401,5.1
80707,Saint-Léger-sur-Bresle,78,0,108,108,1.4
80819,Wargnies,78,0,304,304,3.9
81268,Saint-Salvi-de-Carcavès,78,0,1380,1380,17.7
1023,Asnières-sur-Saône,77,0,1057,1057,13.7
2021,Archon,77,0,848,848,11
2530,Moulins,77,0,554,554,7.2
2647,Ribeauville,77,0,424,424,5.5
2729,Soucy,77,0,74,74,1
2744,Torcy-en-Valois,77,0,1780,1780,23.1
4037,Le Caire,77,596,2296,2892,37.6
7081,Dompnac,77,848,5369,6217,80.7
8304,Montigny-sur-Meuse,77,0,494,494,6.4
15024,Brageac,77,880,1275,2155,28
17049,Blanzay-sur-Boutonne,77,0,2145,2145,27.9
17178,Givrezac,77,0,909,909,11.8
19139,Millevaches,77,0,1056,1056,13.7
21314,Hauteroche,77,0,0,0,0
23051,La Chapelle-Saint-Martial,77,0,2414,2414,31.4
24517,Salles-de-Belvès,77,360,3769,4129,53.6
24533,Servanches,77,650,269,919,11.9
25589,Vauclusotte,77,0,536,536,7
27530,Saint-Denis-d'Augerons,77,0,332,332,4.3
2B159,Meria,77,0,2824,2824,36.7
30044,Bonnevaux,77,0,2407,2407,31.3
31591,Escoulis,77,0,4138,4138,53.7
32430,Sère,77,0,909,909,11.8
36075,Fontenay,77,0,1564,1564,20.3
39249,Germigney,77,800,746,1546,20.1
39282,La Latette,77,0,780,780,10.1
39461,Rix,77,1650,780,2430,31.6
40166,Lussagnet,77,0,360,360,4.7
40189,Monget,77,0,1779,1779,23.1
47192,Monviel,77,0,1966,1966,25.5
50026,Azeville,77,0,2422,2422,31.5
52142,Consigny,77,0,1185,1185,15.4
52286,Leurville,77,0,1185,1185,15.4
52476,Sommerécourt,77,0,1185,1185,15.4
54030,Autrepierre,77,0,273,273,3.5
55057,Boinville-en-Woëvre,77,0,1391,1391,18.1
55212,Girauvoisin,77,0,915,915,11.9
55350,Montigny-lès-Vaucouleurs,77,0,311,311,4
55374,Nant-le-Petit,77,0,1505,1505,19.5
55376,Nantois,77,0,928,928,12.1
55525,Vadelaincourt,77,0,490,490,6.4
58108,Empury,77,0,907,907,11.8
61450,Saint-Quentin-de-Blavou,77,250,27,277,3.6
62301,Équirre,77,0,1663,1663,21.6
63436,Tralaigues,77,0,2604,2604,33.8
64544,Urost,77,0,804,804,10.4
65326,Mun,77,0,489,489,6.4
65419,Sentous,77,0,230,230,3
66151,Prats-de-Sournia,77,0,1883,1883,24.5
66216,Trilla,77,0,1883,1883,24.5
68293,Saint-Cosme,77,0,1096,1096,14.2
70549,La Vernotte,77,0,348,348,4.5
71179,Dompierre-sous-Sanvignes,77,0,396,396,5.1
71563,Vaux-en-Pré,77,0,1181,1181,15.3
72372,Vezot,77,0,1428,1428,18.5
80742,Surcamps,77,0,133,133,1.7
88138,Dombasle-devant-Darney,77,0,599,599,7.8
89249,Mercy,77,7296,498,7794,101.2
89385,Sennevoy-le-Bas,77,850,179,1029,13.4
2229,Courtrizy-et-Fussigny,76,0,205,205,2.7
2823,Voharies,76,0,1355,1355,17.8
8082,Brécy-Brières,76,0,1839,1839,24.2
8244,Lametz,76,0,1667,1667,21.9
9046,Bédeille,76,0,9210,9210,121.2
11107,Courtauly,76,0,835,835,11
11139,Fenouillet-du-Razès,76,0,225,225,3
11278,Pech-Luna,76,0,225,225,3
11283,Peyrefitte-sur-l'Hers,76,0,668,668,8.8
14285,Le Fournet,76,0,1221,1221,16.1
21207,Courlon,76,0,53,53,0.7
21252,Étais,76,0,1480,1480,19.5
21321,Jailly-les-Moulins,76,0,0,0,0
24131,Connezac,76,570,509,1079,14.2
24492,Sainte-Radegonde,76,0,142,142,1.9
25093,Bretigney,76,0,4811,4811,63.3
25183,Cusance,76,0,3788,3788,49.8
26015,Aubenasson,76,0,2066,2066,27.2
26048,Bénivay-Ollon,76,0,3905,3905,51.4
2A094,Corrano,76,0,57,57,0.8
2B275,Sermano,76,0,286,286,3.8
32086,Castex,76,0,168,168,2.2
32250,Meilhan,76,0,897,897,11.8
32409,Samaran,76,0,897,897,11.8
34168,Montesquieu,76,0,149,149,2
36079,Francillon,76,0,12,12,0.2
36080,Frédille,76,0,954,954,12.6
39376,Moutoux,76,760,769,1529,20.1
43094,Ferrussac,76,0,692,692,9.1
50021,Audouville-la-Hubert,76,0,412,412,5.4
51420,Outrepont,76,0,446,446,5.9
51539,Sogny-en-l'Angle,76,0,446,446,5.9
54019,Ansauville,76,0,159,159,2.1
54220,Gémonville,76,0,2520,2520,33.2
55269,Lahaymeix,76,0,1029,1029,13.5
55353,Montsec,76,0,903,903,11.9
61017,Les Authieux-du-Puits,76,0,0,0,0
61416,Saint-Léonard-des-Parcs,76,0,27,27,0.4
62253,Couturelle,76,0,632,632,8.3
65135,Castillon,76,0,227,227,3
65272,Lhez,76,0,483,483,6.4
65355,Paréac,76,0,726,726,9.6
65438,Talazac,76,0,1717,1717,22.6
70053,Les Bâties,76,0,344,344,4.5
70476,Saponcourt,76,0,451,451,5.9
76635,Saint-Pierre-des-Jonquières,76,0,561,561,7.4
88117,Courcelles-sous-Châtenois,76,0,849,849,11.2
88199,Gignéville,76,0,591,591,7.8
88370,Rancourt,76,0,1092,1092,14.4
88532,Zincourt,76,0,1911,1911,25.1
89394,Sery,76,1712,10,1722,22.7
2272,Droizy,75,0,251,251,3.3
4051,Châteauneuf-Miravail,75,0,1652,1652,22
5131,Saint-Auban-d'Oze,75,0,2807,2807,37.4
8134,Coulommes-et-Marqueny,75,0,1645,1645,21.9
9007,Allières,75,0,9088,9088,121.2
10355,Saint-Nicolas-la-Chapelle,75,0,463,463,6.2
21046,Bard-le-Régulier,75,0,2313,2313,30.8
21121,Bussy-la-Pesle,75,0,422,422,5.6
21372,Maisey-le-Duc,75,0,1251,1251,16.7
21491,Poiseul-lès-Saulx,75,0,1068,1068,14.2
22139,Magoar,75,0,1343,1343,17.9
23037,Bussière-Nouvelle,75,0,985,985,13.1
24111,La Chapelle-Montmoreau,75,1200,1057,2257,30.1
25052,Belmont,75,0,886,886,11.8
25090,Brères,75,0,547,547,7.3
25630,Voires,75,0,886,886,11.8
26105,Cornillon-sur-l'Oule,75,0,3854,3854,51.4
2A021,Argiusta-Moriccio,75,0,0,0,0
2B176,Nocario,75,0,347,347,4.6
31367,Montclar-de-Comminges,75,0,2626,2626,35
32140,Gaujac,75,0,468,468,6.2
36020,Bonneuil,75,0,1513,1513,20.2
43101,Goudet,75,0,416,416,5.5
50495,Saint-Jean-du-Corail-des-Bois,75,0,1845,1845,24.6
51057,Bettancourt-la-Longue,75,0,440,440,5.9
51211,Dommartin-Dampierre,75,0,1114,1114,14.9
51260,Le Fresne,75,0,125,125,1.7
51296,Humbauville,75,0,1183,1183,15.8
51495,Saint-Loup,75,0,979,979,13.1
52173,Domremy-Landéville,75,0,1154,1154,15.4
52275,Lavernoy,75,0,344,344,4.6
52366,Ormancey,75,0,344,344,4.6
54017,Angomont,75,0,266,266,3.5
54183,Essey-la-Côte,75,0,310,310,4.1
54388,Mouacourt,75,0,1125,1125,15
57048,Bannay,75,0,452,452,6
60437,Mouchy-le-Châtel,75,0,312,312,4.2
60529,Rémécourt,75,0,398,398,5.3
61488,Touquettes,75,0,773,773,10.3
64242,Gestas,75,0,1568,1568,20.9
65453,Troubat,75,0,491,491,6.5
66120,Nahuja,75,0,0,0,0
66159,Réal,75,0,0,0,0
70065,Besnans,75,0,240,240,3.2
70086,Bourbévelle,75,0,227,227,3
77532,Vulaines-lès-Provins,75,0,270,270,3.6
80053,Balâtre,75,0,91,91,1.2
88215,Grandrupt,75,0,729,729,9.7
89039,Béru,75,40,10,50,0.7
89329,Rugny,75,160,174,334,4.5
2501,Montchâlons,74,0,2826,2826,38.2
4054,Châteauredon,74,0,3102,3102,41.9
5080,Montbrand,74,0,2769,2769,37.4
8100,Champlin,74,0,1935,1935,26.1
8204,Guincourt,74,0,1623,1623,21.9
8278,Marquigny,74,0,1623,1623,21.9
8310,Mouron,74,0,1791,1791,24.2
9011,Antras,74,0,8967,8967,121.2
11149,Fonters-du-Razès,74,0,219,219,3
14412,Le Mesnil-au-Grain,74,0,2744,2744,37.1
18196,Saint-Aignan-des-Noyers,74,0,1186,1186,16
19281,Veix,74,0,1288,1288,17.4
21365,Magny-la-Ville,74,0,1571,1571,21.2
22129,Loc-Envel,74,0,1325,1325,17.9
27369,Lilly,74,0,487,487,6.6
27459,Les Places,74,0,1140,1140,15.4
31292,Lescuns,74,0,2591,2591,35
32002,Ansan,74,0,940,940,12.7
36132,La Motte-Feuilly,74,0,1625,1625,22
39046,Bellecombe,74,1000,272,1272,17.2
39052,Bief-des-Maisons,74,470,749,1219,16.5
39322,Menétrux-en-Joux,74,0,2154,2154,29.1
43075,Collat,74,0,674,674,9.1
46246,Saignes,74,0,2414,2414,32.6
46338,Bessonies,74,0,2185,2185,29.5
51190,Courtagnon,74,0,1315,1315,17.8
52256,Lafauche,74,0,1138,1138,15.4
54471,Saint-Boingt,74,0,306,306,4.1
55331,Méligny-le-Petit,74,0,299,299,4
55339,Mogeville,74,0,1337,1337,18.1
55371,Nançois-le-Grand,74,0,299,299,4
55485,Sepvigny,74,0,299,299,4
55565,Villers-sous-Pareid,74,0,958,958,12.9
57558,Puttigny,74,0,245,245,3.3
63452,Verrières,74,0,481,481,6.5
64222,Etchebar,74,0,1923,1923,26
64486,Saint-Jean-Poudge,74,0,1159,1159,15.7
65090,Betpouy,74,0,2397,2397,32.4
65170,Estampures,74,0,2397,2397,32.4
65275,Lies,74,0,555,555,7.5
65472,Villefranque,74,0,1672,1672,22.6
72238,Pizieux,74,0,1372,1372,18.5
76519,Rainfreville,74,0,597,597,8.1
84125,Savoillan,74,0,87,87,1.2
88336,Ollainville,74,0,827,827,11.2
88492,Le Valtin,74,0,125,125,1.7
8484,Ville-sur-Retourne,73,0,1396,1396,19.1
9141,Illartein,73,0,8846,8846,121.2
9201,Montégut-en-Couserans,73,0,8846,8846,121.2
10128,Donnement,73,0,1541,1541,21.1
11017,Artigues,73,0,802,802,11
14652,Saint-Pierre-du-Mont,73,0,505,505,6.9
24114,Chassaignes,73,200,554,754,10.3
25289,Grandfontaine-sur-Creuse,73,0,862,862,11.8
26013,Arpavon,73,0,3751,3751,51.4
26046,Bellecombe-Tarendol,73,0,3751,3751,51.4
2A129,Grossa,73,0,0,0,0
31217,Génos,73,0,699,699,9.6
32021,Avensac,73,0,275,275,3.8
32218,Loussous-Débat,73,0,731,731,10
32324,Ponsan-Soubiran,73,0,862,862,11.8
32337,Puységur,73,0,41,41,0.6
38132,Les Côtes-de-Corps,73,0,764,764,10.5
38361,Saint-Arey,73,730,764,1494,20.5
39133,Chaux-Champagny,73,280,1615,1895,26
39192,Denezières,73,50,2125,2175,29.8
39230,Fontenu,73,1100,2125,3225,44.2
39247,Genod,73,800,2125,2925,40.1
39495,Saint-Thiébaud,73,250,1615,1865,25.5
46210,Nadillac,73,0,422,422,5.8
51273,Givry-lès-Loisy,73,0,1451,1451,19.9
54452,Reillon,73,0,259,259,3.5
55303,Loupmont,73,0,868,868,11.9
58133,Héry,73,0,1135,1135,15.5
61502,Vidai,73,0,26,26,0.4
62565,Mencas,73,0,4320,4320,59.2
62577,Monchel-sur-Canche,73,0,1577,1577,21.6
63153,Espinchal,73,0,533,533,7.3
64267,Ibarrolle,73,0,1897,1897,26
64532,Tadousse-Ussau,73,0,1143,1143,15.7
65323,Montsérié,73,0,478,478,6.5
66183,Saint-Marsal,73,0,0,0,0
70013,Ambiévillers,73,0,464,464,6.4
70302,Lieucourt,73,0,368,368,5
80057,Bayencourt,73,0,82,82,1.1
80378,Ginchy,73,0,523,523,7.2
80504,Malpart,73,0,88,88,1.2
80575,Mouflières,73,0,101,101,1.4
80705,Saint-Léger-lès-Authie,73,0,82,82,1.1
81111,Labarthe-Bleys,73,0,1857,1857,25.4
83040,Châteauvieux,73,0,284,284,3.9
84048,Gignac,73,0,1488,1488,20.4
88501,Le Vermont,73,0,710,710,9.7
95144,Châtenay-en-France,73,0,422,422,5.8
1279,Oncieu,72,0,1229,1229,17.1
2206,Colonfay,72,0,1284,1284,17.8
2696,Saint-Thomas,72,0,518,518,7.2
4170,La Rochette,72,0,2546,2546,35.4
4180,Saint-Jacques,72,0,2546,2546,35.4
8106,Charnois,72,0,462,462,6.4
8335,Omont,72,0,1579,1579,21.9
8466,Vaux-lès-Mouzon,72,0,2549,2549,35.4
10380,Torcy-le-Petit,72,1070,61,1131,15.7
15043,Charmensac,72,1650,16,1666,23.1
21047,Bard-lès-Époisses,72,0,1529,1529,21.2
21283,Fraignot-et-Vesvrotte,72,0,50,50,0.7
21438,Montmoyen,72,0,1201,1201,16.7
21588,Saussey,72,0,1094,1094,15.2
24057,Bourg-des-Maisons,72,6700,547,7247,100.7
26186,Miscon,72,1050,4003,5053,70.2
26303,Sainte-Euphémie-sur-Ouvèze,72,0,3700,3700,51.4
27098,Bouchevilliers,72,0,1360,1360,18.9
28009,Ardelu,72,0,378,378,5.2
2A060,Cannelle,72,0,332,332,4.6
2A100,Cristinacce,72,0,332,332,4.6
31236,Herran,72,0,3870,3870,53.8
31531,Sarrecave,72,0,1491,1491,20.7
32049,Bétous,72,0,48,48,0.7
32099,Cazaux-Villecomtal,72,0,1327,1327,18.4
39518,Songeson,72,80,2095,2175,30.2
43155,Prades,72,0,656,656,9.1
46212,Orniac,72,0,417,417,5.8
48138,Saint-Bonnet-de-Chirac,72,0,1717,1717,23.8
50246,Hiesville,72,0,390,390,5.4
50621,Vaudreville,72,0,2265,2265,31.5
51520,Saint-Utin,72,0,1136,1136,15.8
52089,Celles-en-Bassigny,72,0,330,330,4.6
52161,Daillecourt,72,0,330,330,4.6
52285,Leuchey,72,0,892,892,12.4
54419,Parux,72,0,255,255,3.5
55421,Reffroy,72,0,291,291,4
57353,Juvelize,72,0,238,238,3.3
58283,Taconnay,72,0,1120,1120,15.6
61190,Ginai,72,0,152,152,2.1
61481,Tellières-le-Plessis,72,4050,25,4075,56.6
65411,Sassis,72,0,2948,2948,40.9
70027,Argillières,72,0,370,370,5.1
70186,La Creuse,72,0,266,266,3.7
76371,Les Ifs,72,0,455,455,6.3
80035,Aubercourt,72,0,442,442,6.1
80487,Longavesnes,72,0,516,516,7.2
88249,Jainvillotte,72,0,804,804,11.2
88350,Pleuvezain,72,0,804,804,11.2
88436,Saint-Stail,72,0,700,700,9.7
1456,Vongnes,71,0,791,791,11.1
2252,Cuissy-et-Geny,71,0,510,510,7.2
8147,Dricourt,71,0,1718,1718,24.2
8301,Montgon,71,0,1718,1718,24.2
8394,Saint-Pierremont,71,0,1718,1718,24.2
9078,Carcanières,71,0,10225,10225,144
9098,Contrazy,71,0,8604,8604,121.2
10398,Vaucogne,71,0,60,60,0.8
11319,Roquefère,71,0,917,917,12.9
11326,Rouffiac-des-Corbières,71,0,109,109,1.5
12180,Peyreleau,71,0,734,734,10.3
14023,Asnières-en-Bessin,71,0,491,491,6.9
14343,Les Isles-Bardel,71,0,1112,1112,15.7
14512,Pontécoulant,71,0,32,32,0.5
15075,Girgols,71,1200,1176,2376,33.5
15199,Saint-Martial,71,1400,1570,2970,41.8
17276,Le Pin,71,0,838,838,11.8
19064,Couffy-sur-Sarsonne,71,0,973,973,13.7
23224,Saint-Oradoux-de-Chirouze,71,0,973,973,13.7
26051,Bézaudun-sur-Bîne,71,0,2475,2475,34.9
2A196,Orto,71,0,327,327,4.6
30238,Saint-Bresson,71,0,1145,1145,16.1
31204,Fustignac,71,0,2486,2486,35
32008,Armentieux,71,0,1309,1309,18.4
32366,Saint-Brès,71,0,268,268,3.8
32454,Traversères,71,0,838,838,11.8
39394,Onoz,71,1080,2066,3146,44.3
51012,Anthenay,71,0,1262,1262,17.8
51053,Berzieux,71,0,1054,1054,14.8
51438,Poix,71,0,119,119,1.7
52065,Bouzancourt,71,0,263,263,3.7
52133,Clinchamp,71,0,1092,1092,15.4
52185,Enfonvelle,71,0,1400,1400,19.7
52201,Flammerécourt,71,0,263,263,3.7
52298,Maâtz,71,0,879,879,12.4
52330,Montheries,71,0,389,389,5.5
52397,Poiseul,71,0,326,326,4.6
52445,Saint-Broingt-le-Bois,71,0,1400,1400,19.7
54107,Buriville,71,0,252,252,3.5
54228,Giriviller,71,0,293,293,4.1
55284,Lavincourt,71,0,1388,1388,19.5
55430,Ribeaucourt,71,0,1388,1388,19.5
55563,Villers-lès-Mangiennes,71,0,1298,1298,18.3
57417,Lostroff,71,0,235,235,3.3
60161,Conteville,71,0,1601,1601,22.5
61399,Saint-Gervais-des-Sablons,71,0,150,150,2.1
65096,Bonnemazon,71,0,212,212,3
72233,Peray,71,0,1317,1317,18.5
80174,Le Cardonnois,71,0,86,86,1.2
88272,Lironcourt,71,0,552,552,7.8
88287,Marey,71,0,552,552,7.8
88474,Tilleux,71,0,793,793,11.2
89002,Aigremont,71,335,10,345,4.9
89032,Beauvilliers,71,1320,154,1474,20.8
91145,Chatignonville,71,0,179,179,2.5
2428,Licy-Clignon,70,0,1618,1618,23.1
2516,Montigny-sous-Marle,70,0,353,353,5
2523,Mont-Saint-Martin,70,0,138,138,2
2678,Sainte-Geneviève,70,0,771,771,11
2809,Villers-Agron-Aiguizy,70,0,1618,1618,23.1
4007,Angles,70,0,2475,2475,35.4
6063,Gars,70,0,1787,1787,25.5
8167,La Férée,70,0,1830,1830,26.1
8280,Marvaux-Vieux,70,0,1694,1694,24.2
10154,Fontenay-de-Bossery,70,0,433,433,6.2
11373,Salvezines,70,0,769,769,11
15218,Saint-Vincent-de-Salers,70,1550,1159,2709,38.7
17096,Chaunac,70,0,827,827,11.8
21244,Éguilly,70,0,1064,1064,15.2
21693,Villedieu,70,0,1168,1168,16.7
24403,Saint-Félix-de-Bourdeilles,70,0,986,986,14.1
24542,Soulaures,70,100,254,354,5.1
25092,La Bretenière,70,0,3489,3489,49.8
25327,Lanthenans,70,0,161,161,2.3
25528,Samson,70,0,510,510,7.3
2A259,Rezza,70,0,322,322,4.6
2B075,Casevecchie,70,0,533,533,7.6
2B263,Rospigliani,70,0,1209,1209,17.3
32294,Mourède,70,0,509,509,7.3
32314,Peyrecave,70,0,40,40,0.6
33133,Coubeyrac,70,0,488,488,7
38550,Villard-Reculas,70,0,3981,3981,56.9
39155,Clucy,70,150,1548,1698,24.3
43082,Cronce,70,452,637,1089,15.6
46116,Frontenac,70,0,2067,2067,29.5
50221,Grimesnil,70,0,2025,2025,28.9
50357,Morigny,70,0,1183,1183,16.9
52200,Flagey,70,0,867,867,12.4
54170,Domptail-en-l'Air,70,0,289,289,4.1
54241,Gugney,70,0,0,0,0
54447,Réclonville,70,0,248,248,3.5
54552,Vaudémont,70,0,0,0,0
55216,Gouraincourt,70,0,1279,1279,18.3
55475,Sauvoy,70,0,283,283,4
55515,Trésauvaux,70,0,906,906,12.9
57130,Château-Bréhain,70,0,232,232,3.3
60061,Belloy,70,0,612,612,8.7
60555,Rouvroy-les-Merles,70,0,1579,1579,22.6
62157,Boubers-lès-Hesmond,70,0,1108,1108,15.8
62833,Vacquerie-le-Boucq,70,0,1512,1512,21.6
64542,Urdos,70,0,1507,1507,21.5
65190,Gazave,70,0,209,209,3
70003,Achey,70,0,359,359,5.1
70360,Montdoré,70,0,445,445,6.4
71344,Passy,70,606,487,1093,15.6
71381,Sailly,70,1410,487,1897,27.1
77452,Sigy,70,0,991,991,14.2
80217,Courcelles-au-Bois,70,0,78,78,1.1
80361,Frettecuisse,70,0,97,97,1.4
80491,Longuevillette,70,0,273,273,3.9
84006,Auribeau,70,0,1427,1427,20.4
88214,Grandrupt-de-Bains,70,0,544,544,7.8
2556,Noircourt,69,0,760,760,11
6133,Sauze,69,0,1555,1555,22.5
8268,Maisoncelle-et-Villers,69,0,2443,2443,35.4
10205,Longpré-le-Sec,69,0,411,411,6
10364,Saint-Usage,69,0,1204,1204,17.4
11127,Escouloubre,69,0,758,758,11
11166,Gourvieille,69,0,606,606,8.8
14742,Vicques,69,0,1081,1081,15.7
21311,Grosbois-lès-Tichey,69,0,517,517,7.5
21664,Verdonnet,69,0,1344,1344,19.5
24121,Chourgnac,69,0,1207,1207,17.5
27441,Notre-Dame-d'Épine,69,0,297,297,4.3
32144,Gazax-et-Baccarisse,69,0,502,502,7.3
32260,Monbardon,69,0,0,0,0
32284,Montégut-Savès,69,0,431,431,6.2
34236,Rouet,69,0,1286,1286,18.6
39175,Coyron,69,350,2008,2358,34.2
42164,Palogneux,69,0,618,618,9
52067,Brainville-sur-Meuse,69,0,1062,1062,15.4
52228,Grandchamp,69,0,855,855,12.4
52316,Mathons,69,0,256,256,3.7
52369,Orquevaux,69,0,1062,1062,15.4
52424,Rivières-le-Bois,69,0,1361,1361,19.7
52439,Rouvres-sur-Aube,69,0,855,855,12.4
54050,Bathelémont,69,0,1035,1035,15
54057,Beaumont,69,0,412,412,6
54461,Romain,69,0,285,285,4.1
55174,Épinonville,69,0,721,721,10.4
55313,Malancourt,69,0,721,721,10.4
57692,Vannecourt,69,0,228,228,3.3
58014,Arzembouy,69,0,3894,3894,56.4
58141,Lavault-de-Frétoy,69,0,813,813,11.8
60397,Le Mesnil-Conteville,69,0,339,339,4.9
61018,Avernes-Saint-Gourgon,69,0,499,499,7.2
61159,Fay,69,620,711,1331,19.3
62547,Marant,69,0,1092,1092,15.8
64107,Béhorléguy,69,0,1793,1793,26
64408,Mouhous,69,0,1080,1080,15.7
65476,Villenave-près-Béarn,69,0,1559,1559,22.6
79205,Pers,69,0,0,0,0
81015,Appelle,69,0,77,77,1.1
81122,Lacapelle-Pinet,69,0,2132,2132,30.9
88025,Avranville,69,0,771,771,11.2
88404,Rozières-sur-Mouzon,69,0,536,536,7.8
2036,Augy,68,0,134,134,2
2690,Sainte-Preuve,68,0,183,183,2.7
8052,Bayonville,68,0,1645,1645,24.2
8205,Hagnicourt,68,0,1491,1491,21.9
8246,Landres-et-Saint-Georges,68,0,1645,1645,24.2
8315,Neufmaison,68,0,1491,1491,21.9
10303,Précy-Notre-Dame,68,0,1436,1436,21.1
10378,Thors,68,0,405,405,6
10432,Villiers-sous-Praslin,68,0,1266,1266,18.6
15077,Gourdièges,68,0,1504,1504,22.1
15139,Narnhac,68,470,1504,1974,29
16364,Sauvagnac,68,130,1399,1529,22.5
17423,Semillac,68,0,803,803,11.8
21061,Bellenod-sur-Seine,68,0,1135,1135,16.7
21075,Billy-lès-Chanceaux,68,0,1135,1135,16.7
21078,Bissey-la-Pierre,68,0,1135,1135,16.7
21444,Mosson,68,0,1135,1135,16.7
21489,Poiseul-la-Grange,68,0,0,0,0
23122,Mansat-la-Courrière,68,0,2132,2132,31.4
23152,Pierrefitte,68,0,1022,1022,15
25185,Cussey-sur-Lison,68,495,496,991,14.6
25379,Mesmay,68,0,496,496,7.3
25441,Ouvans,68,0,803,803,11.8
2B110,Favalello,68,0,256,256,3.8
2B177,Noceta,68,0,1175,1175,17.3
30353,Vissec,68,0,1097,1097,16.1
31072,Boissède,68,0,1409,1409,20.7
32251,Mérens,68,0,2396,2396,35.2
32423,Séailles,68,0,0,0,0
38217,Marcieu,68,200,712,912,13.4
39314,Marnézia,68,781,1979,2760,40.6
50368,Nay,68,0,1421,1421,20.9
51543,Somme-Bionne,68,0,1010,1010,14.9
52278,Lavilleneuve-au-Roi,68,0,373,373,5.5
52483,Soyers,68,0,1341,1341,19.7
54180,Erbéviller-sur-Amezule,68,0,402,402,5.9
55320,Marchéville-en-Woëvre,68,0,880,880,12.9
55323,Martincourt-sur-Meuse,68,0,2459,2459,36.2
55420,Récourt-le-Creux,68,0,433,433,6.4
58137,Lamenay-sur-Loire,68,0,175,175,2.6
58153,Magny-Lormes,68,0,1057,1057,15.5
58230,Saint-Aubin-des-Chaumes,68,0,1057,1057,15.5
61259,Le Ménil-Bérard,68,2650,701,3351,49.3
62208,Canettemont,68,0,565,565,8.3
70350,Molay,68,0,206,206,3
70398,Ormoiche,68,0,65,65,1
70449,Roche-sur-Linotte-et-Sorans-les-Cordiers,68,0,218,218,3.2
70569,Vilory,68,480,404,884,13
71036,Bissy-sous-Uxelles,68,0,824,824,12.1
72057,Champrond,68,0,415,415,6.1
82070,Glatens,68,0,1594,1594,23.4
86122,Lauthiers,68,0,2750,2750,40.4
88522,Vomécourt-sur-Madon,68,0,977,977,14.4
8131,Cornay,67,0,1621,1621,24.2
11248,Montirat,67,0,435,435,6.5
17478,Vinax,67,120,1866,1986,29.6
18007,Apremont-sur-Allier,67,0,21,21,0.3
18250,Serruelles,67,0,1213,1213,18.1
21705,Villotte-Saint-Seine,67,0,0,0,0
24060,Bourniquel,67,500,243,743,11.1
26026,Barret-de-Lioure,67,0,3443,3443,51.4
26369,Verclause,67,0,3443,3443,51.4
31201,Frontignan-Savès,67,0,1388,1388,20.7
31243,Juzes,67,0,1362,1362,20.3
31378,Montgaillard-sur-Save,67,0,1388,1388,20.7
34100,Ferrières-Poussarou,67,0,254,254,3.8
43060,Charraix,67,645,610,1255,18.7
43263,Vielprat,67,635,325,960,14.3
50234,La Haye-Bellefond,67,0,1132,1132,16.9
51166,Contault,67,0,995,995,14.9
51364,Méry-Prémecy,67,0,1191,1191,17.8
52027,Aujeurres,67,0,830,830,12.4
52053,Blaisy,67,0,7359,7359,109.8
52223,Gilley,67,0,1321,1321,19.7
52350,Neuvelle-lès-Voisey,67,0,1321,1321,19.7
55163,Doncourt-aux-Templiers,67,0,867,867,12.9
57423,Lubécourt,67,0,222,222,3.3
57759,Zarbeling,67,0,222,222,3.3
58136,Jailly,67,0,336,336,5
63101,Château-sur-Cher,67,0,104,104,1.6
63134,Dauzat-sur-Vodable,67,0,436,436,6.5
64045,Arhansus,67,0,1741,1741,26
65232,Jacque,67,0,425,425,6.3
70164,Colombotte,67,0,248,248,3.7
70211,Écuelle,67,0,338,338,5
70273,Grammont,67,0,21,21,0.3
70293,Lambrey,67,0,203,203,3
70329,Malvillers,67,0,203,203,3
80015,Aizecourt-le-Haut,67,0,480,480,7.2
88001,Les Ableuvenettes,67,0,963,963,14.4
88002,Ahéville,67,0,963,963,14.4
88278,Maconcourt,67,0,748,748,11.2
88433,Saint-Prancher,67,0,963,963,14.4
89371,Sainte-Vertu,67,0,323,323,4.8
89377,Sauvigny-le-Beuréal,67,0,323,323,4.8
2588,Pargnan,66,0,474,474,7.2
6107,La Roque-en-Provence,66,0,800,800,12.1
7120,Lachamp-Raphaël,66,0,516,516,7.8
8066,Bignicourt,66,0,1262,1262,19.1
8259,Longwé,66,0,1597,1597,24.2
8351,Quilly,66,0,1597,1597,24.2
8393,Saint-Pierre-à-Arnes,66,0,1597,1597,24.2
11419,Villautou,66,0,195,195,3
14510,La Pommeraye,66,0,1995,1995,30.2
19103,Lamazière-Haute,66,0,905,905,13.7
21184,Colombier,66,0,1003,1003,15.2
21234,Drée,66,0,371,371,5.6
21257,Étormay,66,0,1101,1101,16.7
25106,Cademène,66,0,481,481,7.3
26350,Teyssières,66,0,2301,2301,34.9
27341,L'Hosmes,66,0,1856,1856,28.1
27556,Saint-Laurent-du-Tencement,66,0,285,285,4.3
2A363,Zoza,66,0,1539,1539,23.3
31322,Martisserre,66,0,1367,1367,20.7
32276,Montadet,66,0,412,412,6.2
32420,Sauvimont,66,0,412,412,6.2
32441,Taybosc,66,0,37,37,0.6
34338,Villeneuvette,66,0,75,75,1.1
39174,Coyrière,66,0,243,243,3.7
52168,Dinteville,66,0,362,362,5.5
52266,Laneuville-à-Rémy,66,0,598,598,9.1
52523,Vignes-la-Côte,66,0,1015,1015,15.4
54422,Pettonville,66,0,292,292,4.4
54497,Saxon-Sion,66,0,0,0,0
57002,Aboncourt-sur-Seille,66,0,218,218,3.3
63447,Vergheas,66,0,102,102,1.5
66234,Le Vivier,66,0,1614,1614,24.5
70099,Brotte-lès-Ray,66,0,339,339,5.1
70412,Plainemont,66,0,419,419,6.3
70515,Le Val-de-Gouhenans,66,0,2901,2901,44
71335,Ouroux-sous-le-Bois-Sainte-Marie,66,0,1281,1281,19.4
76168,Les Cent-Acres,66,0,533,533,8.1
80048,Avesnes-Chaussoy,66,0,91,91,1.4
80108,Boisbergues,66,0,257,257,3.9
80219,Courcelles-sous-Thoix,66,0,91,91,1.4
2117,Bray-Saint-Christophe,65,0,9290,9290,142.9
3295,Valignat,65,0,1330,1330,20.5
7175,Le Plagnal,65,145,508,653,10
7206,Saint-Alban-en-Montagne,65,350,508,858,13.2
8123,Chuffilly-Roche,65,0,1426,1426,21.9
8251,Lépron-les-Vallées,65,0,1699,1699,26.1
14448,Montreuil-en-Auge,65,0,724,724,11.1
19210,Saint-Hilaire-Luc,65,0,891,891,13.7
21396,Mauvilly,65,0,1084,1084,16.7
21626,Terrefondrée,65,0,1084,1084,16.7
25221,Esnans,65,0,3240,3240,49.8
25596,Vellerot-lès-Vercel,65,0,768,768,11.8
2A285,Sorbollano,65,0,1516,1516,23.3
2B045,Bustanico,65,0,244,244,3.8
31131,Cazaunous,65,0,3493,3493,53.7
31539,Sédeilhac,65,0,1346,1346,20.7
39110,La Charme,65,50,1728,1778,27.4
39538,Uxelles,65,100,1892,1992,30.6
41284,Villeneuve-Frouville,65,0,196,196,3
43247,Torsiac,65,0,3185,3185,49
47304,Taillebourg,65,0,673,673,10.4
51426,Péas,65,0,848,848,13
52319,Mennouveaux,65,0,1000,1000,15.4
52337,Montreuil-sur-Thonnance,65,0,241,241,3.7
52428,Rochefort-sur-la-Côte,65,0,7140,7140,109.8
54106,Bures,65,0,975,975,15
54246,Halloville,65,0,231,231,3.6
54470,Saint-Baussant,65,0,388,388,6
54487,Saint-Rémy-aux-Bois,65,0,269,269,4.1
55201,Fromezey,65,0,1174,1174,18.1
61398,Saint-Germain-le-Vieux,65,355,23,378,5.8
62357,Fresnoy,65,0,1029,1029,15.8
62682,Quilen,65,0,3846,3846,59.2
64098,Bassillon-Vauzé,65,0,679,679,10.4
65060,Banios,65,0,488,488,7.5
65141,Cazaux-Fréchet-Anéran-Camors,65,0,3125,3125,48.1
65300,Marsas,65,0,488,488,7.5
65378,Ricaud,65,0,413,413,6.4
65475,Villemur,65,0,2106,2106,32.4
71458,Saint-Martin-la-Patrouille,65,0,452,452,7
71461,Saint-Maurice-des-Champs,65,0,997,997,15.3
72164,Livet-en-Saosnois,65,0,3060,3060,47.1
78264,Gambaiseuil,65,0,127,127,2
80014,Aizecourt-le-Bas,65,0,466,466,7.2
80449,Ignaucourt,65,0,399,399,6.1
82006,Auterive,65,0,1524,1524,23.4
89374,Sambourg,65,850,151,1001,15.4
1162,Flaxieu,64,0,713,713,11.1
2193,Cierges,64,0,1479,1479,23.1
2244,Crupilly,64,0,353,353,5.5
7200,Le Roux,64,0,500,500,7.8
8023,Artaise-le-Vivier,64,0,2266,2266,35.4
8128,Condé-lès-Autry,64,0,1549,1549,24.2
8470,Verpel,64,0,1549,1549,24.2
10219,Maisons-lès-Soulaines,64,0,381,381,6
10252,Montmartin-le-Haut,64,0,381,381,6
10424,Villeret,64,0,1351,1351,21.1
11235,Missègre,64,2800,842,3642,56.9
14043,Barou-en-Auge,64,0,1003,1003,15.7
14511,Pont-Bellanger,64,0,29,29,0.5
15256,Vèze,64,900,14,914,14.3
19065,Courteix,64,0,877,877,13.7
19228,Saint-Pantaléon-de-Lapleau,64,0,877,877,13.7
21463,Normier,64,0,1359,1359,21.2
25355,Magny-Châtelard,64,0,756,756,11.8
2B051,Cambia,64,0,241,241,3.8
31428,Polastron,64,0,2241,2241,35
31440,Proupiary,64,0,3440,3440,53.8
31522,Salerm,64,0,1326,1326,20.7
32257,Mirannes,64,0,465,465,7.3
32317,Peyrusse-Vieille,64,0,465,465,7.3
32468,Aussos,64,0,755,755,11.8
38521,La Valette,64,0,670,670,10.5
39062,La Boissière,64,610,1863,2473,38.6
39393,Onglières,64,0,648,648,10.1
39511,Sergenaux,64,700,1701,2401,37.5
39529,Thésy,64,485,1416,1901,29.7
41191,Roches,64,0,193,193,3
42146,Montarcher,64,0,573,573,9
43064,Chassignolles,64,0,717,717,11.2
48048,Cheylard-l'Évêque,64,1200,573,1773,27.7
51174,Corribert,64,0,93,93,1.5
51233,Escardes,64,0,835,835,13
51498,Saint-Mard-sur-Auve,64,0,950,950,14.8
52016,Arbot,64,0,793,793,12.4
52264,Laneuvelle,64,0,1262,1262,19.7
52539,Violot,64,0,1262,1262,19.7
54092,Bouzanville,64,0,0,0,0
54356,Mattexey,64,0,264,264,4.1
58203,Oulon,64,0,3612,3612,56.4
60056,Beaurepaire,64,0,94,94,1.5
61493,La Trinité-des-Laitiers,64,0,463,463,7.2
62590,Monts-en-Ternois,64,0,1383,1383,21.6
63087,La Chapelle-Marcousse,64,0,416,416,6.5
64357,Lucarré,64,0,668,668,10.4
66022,Boule-d'Amont,64,0,86,86,1.3
71188,Épertully,64,0,1432,1432,22.4
80189,La Chavatte,64,0,1158,1158,18.1
81009,Amarens,64,0,1628,1628,25.4
89211,Junay,64,600,149,749,11.7
2038,Les Autels,63,0,694,694,11
2150,Cerny-en-Laonnois,63,0,2406,2406,38.2
2204,Coingt,63,0,1237,1237,19.6
2547,La Neuville-Housset,63,0,1123,1123,17.8
5135,Sainte-Colombe,63,0,1878,1878,29.8
6040,Châteauneuf-d'Entraunes,63,0,1420,1420,22.5
7195,La Rochette,63,33085,493,33578,533
7283,Saint-Pierre-la-Roche,63,0,1349,1349,21.4
8165,Faux,63,0,1382,1382,21.9
9171,Lordat,63,0,9073,9073,144
10085,Charmoy,63,0,0,0,0
10285,Perthes-lès-Brienne,63,0,1330,1330,21.1
19137,Meyrignac-l'Église,63,0,808,808,12.8
21025,Arrans,63,0,1227,1227,19.5
21165,Chemin-d'Aisey,63,0,1051,1051,16.7
21539,Saint-Anthot,63,0,354,354,5.6
25249,Fontenotte,63,0,3140,3140,49.8
25312,Hyèvre-Magny,63,0,3140,3140,49.8
27141,Champ-Dolent,63,0,560,560,8.9
2A258,Renno,63,0,290,290,4.6
2A331,Urbalacone,63,0,47,47,0.7
2B178,Nonza,63,0,2310,2310,36.7
2B264,Rusio,63,0,237,237,3.8
31359,Montastruc-Savès,63,0,2206,2206,35
31470,Saint-Aventin,63,0,603,603,9.6
32151,Goux,63,0,631,631,10
32367,Saint-Christaud,63,0,955,955,15.2
39427,Plénise,63,150,638,788,12.5
43242,Tailhac,63,210,574,784,12.4
48020,Bassurels,63,580,3431,4011,63.7
51133,Le Châtelier,63,0,935,935,14.8
51223,Écollemont,63,0,391,391,6.2
51475,Saint-Chéron,63,0,994,994,15.8
52038,Bassoncourt,63,0,969,969,15.4
52502,Valleret,63,0,571,571,9.1
54209,Franconville,63,0,278,278,4.4
54446,Réchicourt-la-Petite,63,0,945,945,15
55375,Nantillois,63,0,2278,2278,36.2
57473,Moncourt,63,0,208,208,3.3
63183,Labessette,63,0,197,197,3.1
63337,Saint-Éloy-la-Glacière,63,0,569,569,9
64223,Etsaut,63,0,1357,1357,21.5
65358,Peyret-Saint-André,63,0,2041,2041,32.4
66001,L'Albère,63,0,2613,2613,41.5
66054,Conat,63,0,1887,1887,30
70140,Châteney,63,0,233,233,3.7
70297,Larret,63,0,323,323,5.1
70430,La Quarte,63,0,1242,1242,19.7
79023,Avon,63,0,350,350,5.6
79223,Puihardy,63,0,519,519,8.2
81223,Le Rialet,63,0,544,544,8.6
88066,Boulaincourt,63,0,905,905,14.4
88264,Légéville-et-Bonfays,63,0,905,905,14.4
88382,Remicourt,63,0,905,905,14.4
2043,Bagneux,62,0,519,519,8.4
2349,Goudelancourt-lès-Berrieux,62,0,446,446,7.2
2396,Jumigny,62,0,446,446,7.2
2633,Quincy-sous-le-Mont,62,0,122,122,2
4040,Le Castellard-Mélan,62,0,2599,2599,41.9
4085,Faucon-du-Caire,62,0,1848,1848,29.8
8279,Mars-sous-Bourcq,62,0,1500,1500,24.2
9025,Aucazein,62,0,7513,7513,121.2
9151,Lanoux,62,0,1103,1103,17.8
10366,Saulcy,62,0,369,369,6
11180,Labastide-Esparbairenque,62,0,801,801,12.9
11331,Saint-Amans,62,0,184,184,3
18078,Crézançay-sur-Cher,62,0,1122,1122,18.1
18251,Sévry,62,0,214,214,3.5
21014,Antheuil,62,0,942,942,15.2
21484,Planay,62,0,1208,1208,19.5
2A066,Cargiaca,62,0,1446,1446,23.3
2B161,Moïta,62,0,472,472,7.6
31343,Mirambeau,62,0,1284,1284,20.7
31431,Portet-d'Aspet,62,0,3332,3332,53.7
32034,Bazugues,62,0,137,137,2.2
32303,Pallanne,62,0,1143,1143,18.4
36216,Selles-sur-Nahon,62,0,778,778,12.5
39268,Ivrey,62,0,1371,1371,22.1
39419,Pillemoine,62,0,628,628,10.1
42072,La Côte-en-Couzan,62,0,0,0,0
46269,Saint-Hilaire,62,0,1831,1831,29.5
50156,Crosville-sur-Douve,62,0,1950,1950,31.5
51143,Le Chemin,62,0,921,921,14.9
51191,Courtémont,62,0,921,921,14.9
51226,Écury-le-Repos,62,0,1232,1232,19.9
51594,Vassimont-et-Chapelaine,62,0,3151,3151,50.8
52066,Brachay,62,0,230,230,3.7
52138,Colmier-le-Haut,62,0,768,768,12.4
52198,Fays,62,0,562,562,9.1
52416,Rangecourt,62,0,284,284,4.6
52487,Thilleux,62,0,562,562,9.1
52513,Velles,62,0,1223,1223,19.7
52525,Villars-en-Azois,62,0,340,340,5.5
54531,Tramont-Saint-André,62,0,2056,2056,33.2
54551,Vaucourt,62,0,220,220,3.5
55054,Bislée,62,0,914,914,14.7
55081,Brizeaux,62,0,839,839,13.5
57278,Guinzeling,62,0,205,205,3.3
57753,Wuisse,62,0,205,205,3.3
61264,Ménil-Froger,62,0,448,448,7.2
62607,Neuville-au-Cornet,62,0,1339,1339,21.6
63351,Saint-Germain-près-Herment,62,0,2097,2097,33.8
65356,Péré,62,0,185,185,3
66018,La Bastide,62,0,0,0,0
70394,Onay,62,0,313,313,5
88125,Darney-aux-Chênes,62,0,693,693,11.2
89028,Baon,62,450,144,594,9.6
89183,Fresnes,62,258,299,557,9
89299,Pimelles,62,200,144,344,5.5
89409,Tharoiseau,62,150,134,284,4.6
89431,Vassy-sous-Pisy,62,800,299,1099,17.7
95387,Menouville,62,0,1636,1636,26.4
2214,Contescourt,61,0,8718,8718,142.9
2357,Gronard,61,0,1088,1088,17.8
2449,Macogny,61,0,59,59,1
8176,Fossé,61,0,1476,1476,24.2
8182,Le Fréty,61,0,1595,1595,26.1
8372,Rubigny,61,0,1338,1338,21.9
9092,Cazenave-Serres-et-Allens,61,0,235,235,3.9
9230,Le Pla,61,0,8785,8785,144
11019,Aunat,61,0,670,670,11
11065,Camps-sur-l'Agly,61,0,803,803,13.2
11174,Les Ilhes,61,0,788,788,12.9
11412,Villardebelle,61,0,803,803,13.2
15249,Le Vaulmier,61,0,1010,1010,16.6
21224,Dampierre-en-Montagne,61,0,1295,1295,21.2
21392,Martrois,61,0,927,927,15.2
24279,Monmarvès,61,750,114,864,14.2
27434,Noards,61,0,939,939,15.4
2A253,Quasquara,61,0,46,46,0.8
31103,Canens,61,0,105,105,1.7
31132,Cazaux-Layrisse,61,0,584,584,9.6
32217,Louslitges,61,0,925,925,15.2
36203,Saint-Médard,61,0,1523,1523,25
39002,Abergement-le-Grand,61,0,1349,1349,22.1
43116,Laval-sur-Doulon,61,750,2538,3288,53.9
48151,Saint-Frézal-d'Albuges,61,0,1236,1236,20.3
51602,Vavray-le-Petit,61,0,358,358,5.9
51652,Vouarces,61,0,796,796,13
52160,Daillancourt,61,0,6700,6700,109.8
52390,Pisseloup,61,0,1203,1203,19.7
55172,Les Éparges,61,0,790,790,13
55194,Foucaucourt-sur-Thabas,61,0,826,826,13.5
55211,Gincrey,61,0,1102,1102,18.1
55409,Pretz-en-Argonne,61,0,826,826,13.5
55453,Saint-André-en-Barrois,61,0,388,388,6.4
58070,Chazeuil,61,0,949,949,15.6
58308,Vignol,61,0,949,949,15.6
59420,Moustier-en-Fagne,61,0,1001,1001,16.4
61113,Comblot,61,750,214,964,15.8
63122,Courgoul,61,0,397,397,6.5
65288,Lubret-Saint-Luc,61,0,1976,1976,32.4
65428,Sireix,61,0,2498,2498,41
70071,Beulotte-Saint-Laurent,61,0,702,702,11.5
72123,Dureil,61,0,1419,1419,23.3
80169,Cannessières,61,0,84,84,1.4
88003,Aingeville,61,0,21,21,0.3
88144,Domèvre-sous-Montfort,61,0,21,21,0.3
4235,Verdaches,60,0,2515,2515,41.9
7049,Le Chambon,60,95,1283,1378,23
8407,Séchault,60,0,1452,1452,24.2
9154,Larbont,60,0,7271,7271,121.2
10405,Verricourt,60,0,51,51,0.8
11029,Belcastel-et-Buc,60,0,790,790,13.2
19219,Sainte-Marie-Lapanouze,60,0,823,823,13.7
21084,Source-Seine,60,0,0,0,0
21090,Boudreville,60,0,1001,1001,16.7
21583,Santosse,60,0,261,261,4.4
21695,La Villeneuve-les-Convers,60,0,0,0,0
25044,Bartherans,60,300,437,737,12.3
25283,Goux-sous-Landet,60,705,437,1142,19
26089,Chaudebonne,60,0,3083,3083,51.4
26128,Eygluy-Escoulin,60,0,727,727,12.1
26221,Omblèze,60,0,727,727,12.1
2B122,Gavignano,60,0,226,226,3.8
31479,Saint-Ferréol-de-Comminges,60,0,1243,1243,20.7
33372,Saint-Antoine-du-Queyret,60,0,596,596,9.9
34278,Saint-Michel,60,0,674,674,11.2
39060,Bois-de-Gand,60,550,1595,2145,35.8
43225,Saint-Vénérand,60,0,291,291,4.8
48182,Saint-Sauveur-de-Ginestoux,60,500,707,1207,20.1
51089,Brouillet,60,0,1066,1066,17.8
51110,Chaltrait,60,0,1192,1192,19.9
51412,Ognes,60,0,113,113,1.9
51458,Reuves,60,0,783,783,13
52204,Forcey,60,0,6591,6591,109.8
52486,Ternat,60,0,743,743,12.4
55403,Peuvillers,60,0,1097,1097,18.3
55452,Saint-Amand-sur-Ornain,60,0,723,723,12
57265,Guébestroff,60,0,199,199,3.3
57664,Tarquimpol,60,0,199,199,3.3
61381,Saint-Denis-sur-Huisne,60,700,211,911,15.2
65091,Bettes,60,0,450,450,7.5
65207,Gourgue,60,0,179,179,3
65217,Hautaget,60,0,393,393,6.6
66032,Calmeilles,60,0,804,804,13.4
66076,Feilluns,60,0,1467,1467,24.4
66122,Nohèdes,60,0,1797,1797,30
70395,Oppenans,60,0,19,19,0.3
88298,Ménarmont,60,0,299,299,5
2149,Cerizy,59,0,0,0,0
4016,Authon,59,0,1759,1759,29.8
4067,Curel,59,0,1299,1299,22
4093,Gigors,59,0,1759,1759,29.8
7160,Monestier,59,850,304,1154,19.6
8020,Les Petites-Armoises,59,0,1428,1428,24.2
9001,Aigues-Juntes,59,0,7150,7150,121.2
11073,Cassaignes,59,0,777,777,13.2
11187,Lanet,59,0,799,799,13.5
14381,Louvagny,59,0,924,924,15.7
15086,Lacapelle-Barrès,59,1480,1305,2785,47.2
15253,Vernols,59,4093,13,4106,69.6
21143,Channay,59,0,984,984,16.7
21460,Noiron-sur-Seine,59,0,984,984,16.7
25269,Germondans,59,250,2941,3191,54.1
25443,Palantine,59,50,430,480,8.1
26067,Chalancon,59,0,3280,3280,55.6
2B113,Ficaja,59,0,273,273,4.6
31007,Ambax,59,0,1222,1222,20.7
31121,Castéra-Vignoles,59,0,1222,1222,20.7
31272,Lapeyrère,59,0,101,101,1.7
32240,Mascaras,59,0,895,895,15.2
32403,Saint-Pierre-d'Aubézies,59,0,429,429,7.3
39237,Fraroz,59,0,597,597,10.1
48046,Chaulhac,59,0,606,606,10.3
48071,Grandvals,59,1400,2180,3580,60.7
50070,Boutteville,59,0,320,320,5.4
52291,Longchamp,59,0,908,908,15.4
52352,Ninville,59,0,6481,6481,109.8
54185,Étreval,59,0,0,0,0
54193,Fey-en-Haye,59,0,352,352,6
54245,Haigneville,59,0,244,244,4.1
55260,Julvécourt,59,0,376,376,6.4
55395,Osches,59,0,376,376,6.4
55540,Vaux-lès-Palameix,59,0,869,869,14.7
57391,Lemoncourt,59,0,195,195,3.3
64185,Cette-Eygun,59,0,1271,1271,21.5
65111,Bulan,59,0,176,176,3
65391,Sainte-Marie,59,0,386,386,6.5
70090,Boursières,59,0,152,152,2.6
70183,Courtesoult-et-Gatey,59,0,303,303,5.1
70420,Pont-sur-l'Ognon,59,0,19,19,0.3
71322,Morlet,59,0,1320,1320,22.4
81080,Donnazac,59,0,1501,1501,25.4
81172,Montauriol,59,0,1350,1350,22.9
2384,Houry,58,0,1034,1034,17.8
2482,Meurival,58,0,156,156,2.7
2622,Priez,58,0,1341,1341,23.1
2724,Sommelans,58,0,1341,1341,23.1
8030,Auge,58,0,1516,1516,26.1
9146,Justiniac,58,0,261,261,4.5
9193,Mijanès,58,0,8353,8353,144
9216,Nescus,58,0,7028,7028,121.2
10201,La Loge-Pomblin,58,0,1080,1080,18.6
10236,Mesnil-Lettre,58,0,49,49,0.8
10294,Poligny,58,0,1012,1012,17.4
10434,Villy-le-Bois,58,0,828,828,14.3
15032,Celoux,58,360,13,373,6.4
16112,Courlac,58,470,2727,3197,55.1
17149,Les Éduts,58,0,1616,1616,27.9
21628,Thoires,58,0,968,968,16.7
25436,Orve,58,0,1599,1599,27.6
26164,Lesches-en-Diois,58,1200,3225,4425,76.3
2B179,Novale,58,0,416,416,7.2
2B226,Pietraserena,58,0,442,442,7.6
2B301,San-Gavino-di-Tenda,58,0,351,351,6.1
31235,Guran,58,0,555,555,9.6
31514,Saint-Rome,58,0,283,283,4.9
32223,Magnas,58,0,219,219,3.8
32229,Mansempuy,58,0,219,219,3.8
32427,Sembouès,58,0,1069,1069,18.4
39165,Conte,58,0,587,587,10.1
39298,Longcochon,58,0,587,587,10.1
41178,Le Plessis-l'Échelle,58,0,175,175,3
48181,Saint-Saturnin,58,1400,2060,3460,59.7
52028,Aulnoy-sur-Aube,58,0,718,718,12.4
52245,Humberville,58,0,892,892,15.4
52301,Maisoncelles,58,0,892,892,15.4
52395,Poinson-lès-Grancey,58,0,718,718,12.4
52467,Savigny,58,0,1144,1144,19.7
55322,Marson-sur-Barboure,58,0,234,234,4
65139,Cazarilh,58,0,380,380,6.6
66203,Taulis,58,0,0,0,0
70389,Noiron,58,0,293,293,5.1
71068,Burzy,58,0,403,403,6.9
80103,Biarre,58,0,70,70,1.2
80239,Devise,58,0,416,416,7.2
81302,Tréban,58,0,1327,1327,22.9
88200,Gigney,58,0,1459,1459,25.2
95214,Épinay-Champlâtreux,58,0,335,335,5.8
4129,Montjustin,57,0,150,150,2.6
6124,Saint-Léger,57,0,1285,1285,22.5
7018,Astet,57,515,446,961,16.9
8074,Bouconville,57,0,1379,1379,24.2
8104,Chardeny,57,0,1379,1379,24.2
8500,Wignicourt,57,0,1250,1250,21.9
9256,Saint-Bauzeil,57,0,1532,1532,26.9
10027,Balignicourt,57,0,1203,1203,21.1
10403,Vernonvilliers,57,0,339,339,5.9
11038,Bessède-de-Sault,57,0,626,626,11
11305,Quintillan,57,0,772,772,13.5
14496,Périgny,57,0,26,26,0.5
17416,Saleignes,57,100,1588,1688,29.6
21248,Éringes,57,0,1110,1110,19.5
21350,Lignerolles,57,0,951,951,16.7
21597,Segrois,57,0,273,273,4.8
24110,La Chapelle-Montabourlet,57,650,433,1083,19
25546,Silley-Bléfond,57,0,2841,2841,49.8
2B063,Carcheto-Brustico,57,0,264,264,4.6
30199,Pommiers,57,0,919,919,16.1
34040,Brenas,57,0,531,531,9.3
34091,Le Cros,57,0,640,640,11.2
34156,Mérifons,57,0,65,65,1.1
39080,Broissia,57,1280,1659,2939,51.6
39512,Sergenon,57,125,1515,1640,28.8
45138,Escrignelles,57,0,664,664,11.6
51128,La Chapelle-sous-Orbais,57,0,83,83,1.5
51336,Maffrécourt,57,0,846,846,14.8
51456,Remicourt,57,0,846,846,14.8
52277,Lavilleneuve,57,0,262,262,4.6
52312,Mardor,57,0,262,262,4.6
54132,Clérey-sur-Brenon,57,0,0,0,0
54153,Dampvitoux,57,0,340,340,6
55084,Broussey-en-Blois,57,0,230,230,4
55343,Montblainville,57,0,596,596,10.5
55577,Waly,57,0,772,772,13.5
57059,Bellange,57,0,189,189,3.3
58186,Murlin,57,0,3217,3217,56.4
61217,La Lande-de-Lougé,57,0,120,120,2.1
62625,Noyelles-lès-Humières,57,0,902,902,15.8
63467,Voingt,57,0,1927,1927,33.8
65013,Ansost,57,0,1288,1288,22.6
65345,Ossun-ez-Angles,57,0,545,545,9.6
66154,Puyvalador,57,0,0,0,0
70568,Villers-Vaudey,57,0,293,293,5.1
70574,Volon,57,0,293,293,5.1
80744,Tailly,57,0,79,79,1.4
80756,Thièvres,57,0,64,64,1.1
88074,Brechainville,57,0,637,637,11.2
2583,Pancy-Courtecon,56,0,403,403,7.2
3228,Saint-Éloy-d'Allier,56,0,228,228,4.1
5049,Esparron,56,0,79,79,1.4
8433,Suzanne,56,0,1228,1228,21.9
8434,Sy,56,0,1355,1355,24.2
9006,Alliat,56,0,216,216,3.9
9089,Cazals-des-Baylès,56,0,1160,1160,20.7
10235,Mesnil-la-Comtesse,56,0,48,48,0.9
11083,Caunettes-en-Val,56,0,363,363,6.5
11104,Counozouls,56,0,615,615,11
12143,Mélagues,56,0,2191,2191,39.1
14224,Deux-Jumeaux,56,0,388,388,6.9
21359,Lucey,56,0,934,934,16.7
21631,Thomirey,56,0,851,851,15.2
21660,Veilly,56,0,851,851,15.2
23129,La Mazière-aux-Bons-Hommes,56,0,735,735,13.1
25179,Le Crouzet,56,0,3335,3335,59.6
26117,Échevis,56,0,3507,3507,62.6
27399,Mercey,56,0,294,294,5.2
27610,Saint-Victor-sur-Avre,56,0,1575,1575,28.1
28414,Villebon,56,0,207,207,3.7
2B292,Sant'Andréa-di-Bozio,56,0,211,211,3.8
2B317,Santa-Reparata-di-Moriani,56,0,402,402,7.2
31115,Castelgaillard,56,0,1160,1160,20.7
32236,Marguestau,56,0,0,0,0
32456,Tudelle,56,0,407,407,7.3
38216,Malleval-en-Vercors,56,0,905,905,16.2
39055,Billecul,56,500,567,1067,19.1
39108,Charency,56,0,567,567,10.1
39505,Saugeot,56,0,1630,1630,29.1
43085,Desges,56,0,510,510,9.1
52184,Effincourt,56,0,207,207,3.7
52511,Vaux-sur-Saint-Urbain,56,0,207,207,3.7
54230,Gogney,56,0,199,199,3.6
55289,Levoncourt,56,0,758,758,13.5
55431,Richecourt,56,0,665,665,11.9
55559,Villeroy-sur-Méholle,56,0,226,226,4
57525,Oriocourt,56,0,185,185,3.3
64264,L'Hôpital-Saint-Blaise,56,0,1455,1455,26
66142,Planès,56,0,0,0,0
70335,Maussans,56,0,179,179,3.2
71031,Berzé-le-Châtel,56,0,389,389,6.9
71203,Fontenay,56,0,217,217,3.9
71361,Prizy,56,0,217,217,3.9
80325,Fontaine-lès-Cappy,56,0,1013,1013,18.1
80460,Lamaronde,56,0,77,77,1.4
2573,Orgeval,55,0,2100,2100,38.2
8397,Saint-Remy-le-Petit,55,0,1052,1052,19.1
10241,Metz-Robert,55,0,1024,1024,18.6
11046,Bourigeole,55,0,724,724,13.2
11232,Miraval-Cabardès,55,0,710,710,12.9
21082,Blancey,55,0,836,836,15.2
21354,Longecourt-lès-Culêtre,55,0,1696,1696,30.8
21380,Marcigny-sous-Thil,55,0,1168,1168,21.2
21418,Moitron,55,0,918,918,16.7
23110,Lioux-les-Monges,55,0,722,722,13.1
23237,Saint-Priest-Palus,55,0,1725,1725,31.4
25065,Blarians,55,0,2742,2742,49.9
28346,Saint-Lubin-de-Cravant,55,0,74,74,1.3
2B213,Pianello,55,0,419,419,7.6
31452,Rieucazé,55,0,1139,1139,20.7
31456,Riolas,55,0,1139,1139,20.7
34133,Lavalette,55,0,618,618,11.2
34195,Pégairolles-de-Buèges,55,1367,1025,2392,43.5
39457,Les Repôts,55,380,1462,1842,33.5
52030,Autigny-le-Petit,55,0,204,204,3.7
52232,Guindrecourt-sur-Blaise,55,0,6041,6041,109.8
52393,Poinsenot,55,0,681,681,12.4
52475,Sommancourt,55,0,498,498,9.1
54438,Pulney,55,0,1824,1824,33.2
55257,Jouy-en-Argonne,55,0,575,575,10.5
55280,Lanhères,55,0,994,994,18.1
58052,Champallement,55,0,855,855,15.5
62828,Tramecourt,55,0,871,871,15.8
63156,Esteil,55,0,358,358,6.5
63328,Sainte-Catherine,55,1100,497,1597,29
64236,Gayon,55,0,574,574,10.4
65205,Gouaux,55,0,2644,2644,48.1
70337,Melin,55,0,167,167,3
71568,Vérissey,55,0,226,226,4.1
81134,Lamontélarié,55,0,973,973,17.7
82146,Puygaillard-de-Lomagne,55,0,1289,1289,23.4
88127,Deinvillers,55,0,274,274,5
88331,Nonzeville,55,0,72,72,1.3
88482,Urville,55,0,19,19,0.3
2122,Brie,54,0,970,970,18
2632,Quincy-Basse,54,0,53,53,1
4137,Nibles,54,498,1610,2108,39
8019,Les Grandes-Armoises,54,0,1307,1307,24.2
8094,Cernion,54,0,1412,1412,26.1
8272,Maranwez,54,0,1184,1184,21.9
8463,Vaux-en-Dieulet,54,0,1307,1307,24.2
10057,Bouy-sur-Orvin,54,0,334,334,6.2
10445,Yèvres-le-Petit,54,0,1140,1140,21.1
11282,Peyrefitte-du-Razès,54,1450,593,2043,37.8
21066,Bessey-la-Cour,54,0,821,821,15.2
24446,Saint-Marcory,54,3396,196,3592,66.5
25408,Montussaint,54,0,125,125,2.3
26279,La Rochette-du-Buis,54,0,2775,2775,51.4
26328,Saint-Sauveur-en-Diois,54,0,1468,1468,27.2
2A011,Altagène,54,0,1259,1259,23.3
2B012,Altiani,54,0,411,411,7.6
2B297,San-Damiano,54,0,250,250,4.6
32428,Sémézies-Cachan,54,0,686,686,12.7
43182,Saint-Étienne-sur-Blesle,54,2015,2646,4661,86.3
43202,Saint-Julien-des-Chazes,54,890,492,1382,25.6
48161,Saint-Juéry,54,1611,1996,3607,66.8
51371,Moivre,54,0,90,90,1.7
54078,Blémerey,54,0,192,192,3.6
54480,Saint-Martin,54,0,192,192,3.6
55207,Géry,54,0,731,731,13.5
55266,Lachalade,54,0,565,565,10.5
55379,Le Neufour,54,0,565,565,10.5
58257,Saint-Maurice,54,0,271,271,5
60602,Saint-Valery,54,0,265,265,4.9
61363,Saint-Aquilin-de-Corbion,54,600,190,790,14.6
63277,Peslières,54,0,351,351,6.5
65253,Lamarque-Rustaing,54,0,1749,1749,32.4
66091,Lamanère,54,0,0,0,0
70454,Rosières-sur-Mance,54,0,163,163,3
79139,Les Groseillers,54,0,445,445,8.2
87193,Surdoux,54,0,25,25,0.5
88296,Médonville,54,0,19,19,0.4
89064,Censy,54,0,261,261,4.8
7209,Saint-Andéol-de-Fourchades,53,0,1133,1133,21.4
8098,Champigneulle,53,0,1282,1282,24.2
8309,Mont-Saint-Remy,53,0,1282,1282,24.2
10127,Dommartin-le-Coq,53,0,45,45,0.8
10189,Lassicourt,53,0,1119,1119,21.1
11101,Coudons,53,0,582,582,11
11352,Saint-Louis-et-Parahou,53,0,582,582,11
15060,Deux-Verges,53,750,1172,1922,36.3
21324,Jeux-lès-Bard,53,0,1125,1125,21.2
21470,Origny,53,0,884,884,16.7
26003,Aleyrac,53,0,1848,1848,34.9
2A038,Bilia,53,0,0,0,0
31267,Lahitère,53,0,91,91,1.7
31354,Monestrol,53,0,259,259,4.9
32072,Callian,53,0,385,385,7.3
39455,Reithouse,53,540,1542,2082,39.3
40030,Baudignan,53,0,605,605,11.4
43139,Montclard,53,0,483,483,9.1
52507,Vauxbons,53,0,656,656,12.4
54560,Veney,53,0,234,234,4.4
57446,Marimont-lès-Bénestroff,53,0,175,175,3.3
58043,Bussy-la-Pesle,53,0,824,824,15.5
61104,La Chaux,53,1730,238,1968,37.1
63172,Grandeyrolles,53,0,345,345,6.5
63442,Valz-sous-Châteauneuf,53,0,345,345,6.5
65229,Ilheu,53,0,347,347,6.5
74203,Novel,53,500,2746,3246,61.2
82163,Saint-Jean-du-Bouzet,53,0,1242,1242,23.4
95611,Theuville,53,0,2435,2435,45.9
4030,Blieux,52,1662,1839,3501,67.3
9184,Mauvezin-de-Sainte-Croix,52,0,6301,6301,121.2
10041,Bertignolles,52,0,908,908,17.5
10071,Chacenay,52,0,908,908,17.5
10346,Saint-Léger-sous-Margerie,52,0,1098,1098,21.1
11060,Cailla,52,0,571,571,11
11154,Fournes-Cabardès,52,0,672,672,12.9
11186,Lairière,52,0,705,705,13.6
11213,Maisons,52,0,80,80,1.5
21018,Arcey,52,0,292,292,5.6
21095,Bousselange,52,0,390,390,7.5
21117,Busseaut,52,0,868,868,16.7
21328,Juillenay,52,0,1104,1104,21.2
21529,Roilly,52,0,1104,1104,21.2
21544,Sainte-Colombe-en-Auxois,52,0,1104,1104,21.2
25513,Sainte-Anne,52,0,379,379,7.3
26269,Rochebrune,52,0,2672,2672,51.4
2A262,Rosazia,52,0,240,240,4.6
2B072,Casalta,52,0,241,241,4.6
2B111,Felce,52,0,373,373,7.2
2B155,Matra,52,0,396,396,7.6
32084,Castéron,52,0,196,196,3.8
39444,Pretin,52,340,1150,1490,28.7
43145,Ouides,52,1890,252,2142,41.2
43169,Saint-Austremoine,52,300,474,774,14.9
45070,Champoulet,52,0,605,605,11.6
48069,Gatuzières,52,2100,1275,3375,64.9
52464,Saulles,52,0,1026,1026,19.7
54240,Grosrouvres,52,0,108,108,2.1
54381,Montreux,52,0,184,184,3.5
55208,Gesnes-en-Argonne,52,0,544,544,10.5
55290,Lignières-sur-Aire,52,0,704,704,13.5
58078,Cizely,52,0,261,261,5
62411,Haravesnes,52,0,1123,1123,21.6
64434,Ossenx,52,0,1087,1087,20.9
70188,Creveney,52,0,192,192,3.7
70359,Montcourt,52,0,157,157,3
71427,Saint-Huruge,52,0,361,361,6.9
88149,Dommartin-lès-Vallois,52,0,404,404,7.8
88306,Le Mont,52,0,506,506,9.7
89320,Quincerot,52,20,121,141,2.7
89445,Vézannes,52,0,121,121,2.3
6076,Lieuche,51,0,1149,1149,22.5
8077,Bourcq,51,0,1234,1234,24.2
8186,Germont,51,0,1234,1234,24.2
8306,Mont-Laurent,51,0,975,975,19.1
11133,Fajac-en-Val,51,0,331,331,6.5
11134,Fajac-la-Relenque,51,0,448,448,8.8
11162,Generville,51,0,151,151,3
11294,Pomy,51,2502,671,3173,62.2
14300,Gerrots,51,0,0,0,0
15241,La Trinitat,51,1271,1128,2399,47
19074,L'Église-aux-Bois,51,0,888,888,17.4
23264,La Villedieu,51,0,1929,1929,37.8
25607,Vernois-lès-Belvoir,51,0,1406,1406,27.6
2A019,Arbori,51,0,235,235,4.6
2A358,Zévaco,51,0,38,38,0.7
2B248,Prato-di-Giovellina,51,0,192,192,3.8
33103,Castelmoron-d'Albret,51,0,506,506,9.9
34046,Cambon-et-Salvergues,51,0,902,902,17.7
34323,Valmascle,51,0,58,58,1.1
36015,Beaulieu,51,0,1029,1029,20.2
40015,Arx,51,0,582,582,11.4
43014,Autrac,51,0,2499,2499,49
48007,Arzenc-d'Apcher,51,0,1885,1885,37
51020,Aubilly,51,0,906,906,17.8
52199,Ferrière-et-Lafolie,51,0,189,189,3.7
52375,Palaiseul,51,0,1006,1006,19.7
52542,Vivey,51,0,632,632,12.4
54354,Marthemont,51,0,519,519,10.2
55127,Courcelles-en-Barrois,51,0,690,690,13.5
55157,Dommartin-la-Montagne,51,0,660,660,12.9
55561,Villers-devant-Dun,51,0,1844,1844,36.2
57673,Thonville,51,0,2367,2367,46.4
61178,La Fresnaie-Fayel,51,0,369,369,7.2
64174,Castéra-Loubix,51,0,1152,1152,22.6
65124,Camparan,51,0,2452,2452,48.1
70301,Lieffrans,51,0,231,231,4.5
71127,Chevagny-sur-Guye,51,0,354,354,6.9
80046,Avelesges,51,0,70,70,1.4
82047,Cumont,51,0,1195,1195,23.4
82107,Maumusson,51,0,1195,1195,23.4
83105,Riboux,51,0,32,32,0.6
84100,La Roque-Alric,51,0,1665,1665,32.6
2515,Montigny-lès-Condé,50,0,1156,1156,23.1
4177,Hautes-Duyes,50,0,2096,2096,41.9
6008,Auvare,50,0,1127,1127,22.5
8035,Autruche,50,0,1210,1210,24.2
10161,Fresnay,50,0,298,298,6
11109,Coustaussa,50,1150,658,1808,36.2
11306,Quirbajou,50,0,549,549,11
11350,Saint-Just-et-le-Bézu,50,0,549,549,11
18177,Parnay,50,50,466,516,10.3
21091,Bouhey,50,0,760,760,15.2
21498,Posanges,50,0,1062,1062,21.2
21671,Vertault,50,0,834,834,16.7
27686,Vieux-Port,50,315,205,520,10.4
2A027,Azzana,50,0,230,230,4.6
2B125,Giocatojo,50,0,232,232,4.6
2B217,Piazzole,50,0,232,232,4.6
31397,Nénigan,50,0,1036,1036,20.7
39004,Abergement-lès-Thésy,50,0,1106,1106,22.1
39277,Le Larderet,50,0,506,506,10.1
43057,La Chapelle-Bertin,50,250,2080,2330,46.6
51125,Chapelaine,50,0,789,789,15.8
52216,Germaines,50,0,619,619,12.4
55422,Regnéville-sur-Meuse,50,0,523,523,10.5
55429,Riaville,50,0,647,647,12.9
55434,Rigny-Saint-Martin,50,0,202,202,4
62720,Rombly,50,0,825,825,16.5
64456,Pouliacq,50,0,783,783,15.7
65155,Devèze,50,0,1620,1620,32.4
73166,Montendry,50,0,894,894,17.9
76074,La Bellière,50,0,945,945,18.9
80508,Marché-Allouarde,50,0,60,60,1.2
88171,Fignévelle,50,0,389,389,7.8
88279,Madecourt,50,0,719,719,14.4
89065,Cérilly,50,0,97,97,1.9
89290,Pasilly,50,0,241,241,4.8
2467,Marizy-Saint-Mard,49,0,47,47,1
5169,Sorbiers,49,0,1461,1461,29.8
6002,Amirat,49,0,1251,1251,25.5
7173,Péreyres,49,1150,201,1351,27.6
9155,Larcat,49,1500,7057,8557,174.6
9242,Raissac,49,0,435,435,8.9
11246,Montgradail,49,0,645,645,13.2
11388,Termes,49,0,664,664,13.6
19052,Chavanac,49,0,672,672,13.7
21649,Uncey-le-Franc,49,0,1040,1040,21.2
21653,Vannaire,49,0,818,818,16.7
25625,Villers-la-Combe,49,0,579,579,11.8
26136,Val-Maravel,49,855,2724,3579,73
2A146,Loreto-di-Tallano,49,0,1143,1143,23.3
2B097,Costa,49,0,688,688,14
39118,Châtel-de-Joux,49,0,1426,1426,29.1
39272,Ladoye-sur-Seille,49,200,1302,1502,30.7
51124,Chantemerle,49,0,639,639,13
51186,Courjeonnet,49,0,71,71,1.4
51317,Laval-sur-Tourbe,49,0,461,461,9.4
52218,Germay,49,0,181,181,3.7
52304,Malaincourt-sur-Meuse,49,0,754,754,15.4
52436,Rouécourt,49,0,5382,5382,109.8
54124,Chazelles-sur-Albe,49,0,174,174,3.6
54218,Gélaucourt,49,0,1625,1625,33.2
55325,Maucourt-sur-Orne,49,0,885,885,18.1
55380,Neuville-en-Verdunois,49,0,663,663,13.5
55450,Rupt-sur-Othain,49,0,896,896,18.3
55528,Varnéville,49,0,582,582,11.9
55534,Vaudeville-le-Haut,49,0,958,958,19.6
55556,Ville-devant-Chaumont,49,0,896,896,18.3
57405,Lindre-Haute,49,0,162,162,3.3
58310,Villiers-le-Sec,49,0,1025,1025,20.9
60205,Élencourt,49,0,240,240,4.9
61289,Mont-Ormel,49,0,103,103,2.1
62062,Avesnes,49,0,2900,2900,59.2
63429,Ternant-les-Eaux,49,0,319,319,6.5
65145,Chèze,49,0,2006,2006,40.9
65283,Loudervielle,49,0,2356,2356,48.1
65468,Vieuzos,49,0,1587,1587,32.4
70332,Marast,49,0,16,16,0.3
70565,Villers-Pater,49,0,157,157,3.2
80201,Coigneux,49,0,55,55,1.1
80435,Hesbécourt,49,0,351,351,7.2
88187,Frénois,49,0,381,381,7.8
90061,Lamadeleine-Val-des-Anges,49,0,1460,1460,29.8
4181,Saint-Jeannet,48,0,2012,2012,41.9
8425,Sommerance,48,0,1161,1161,24.2
11108,La Courtète,48,0,632,632,13.2
19088,Grandsaigne,48,0,836,836,17.4
21156,Chaudenay-le-Château,48,0,730,730,15.2
25102,Burnevillers,48,0,334,334,7
26080,Chastel-Arnaud,48,0,1305,1305,27.2
30208,Puechredon,48,0,100,100,2.1
32067,Cabas-Loumassès,48,0,0,0,0
39003,Abergement-le-Petit,48,0,1062,1062,22.1
43015,Auvers,48,0,437,437,9.1
48077,Julianges,48,780,493,1273,26.5
51516,Saint-Saturnin,48,0,626,626,13
52043,Belmont,48,0,947,947,19.7
52097,Chambroncourt,48,0,178,178,3.7
52516,Verseilles-le-Haut,48,0,594,594,12.4
55116,Le Claon,48,0,502,502,10.5
55137,Cuisy,48,0,502,502,10.5
55580,Wavrille,48,0,877,877,18.3
57501,Neufvillage,48,0,159,159,3.3
57595,Rorbach-lès-Dieuze,48,0,159,159,3.3
61273,Ménil-Vin,48,0,274,274,5.7
64118,Bétracq,48,0,501,501,10.4
65347,Ourde,48,0,314,314,6.5
66184,Saint-Martin-de-Fenouillet,48,0,1174,1174,24.5
70274,Grandecourt,48,0,246,246,5.1
70369,Mont-Saint-Léger,48,0,246,246,5.1
71349,La Petite-Verrière,48,0,1074,1074,22.4
80719,Sainte-Segrée,48,0,66,66,1.4
88100,Chef-Haut,48,0,690,690,14.4
1311,Prémillieu,47,0,1778,1778,37.8
2674,Saint-Clément,47,0,923,923,19.6
5081,Montclus,47,0,1401,1401,29.8
6131,Sallagriffon,47,0,1059,1059,22.5
9034,Balacet,47,0,5695,5695,121.2
9087,Caussou,47,3020,6769,9789,208.3
9292,Sentenac-de-Sérou,47,0,5695,5695,121.2
10010,Arrembécourt,47,0,992,992,21.1
10279,Pars-lès-Chavanges,47,0,992,992,21.1
11039,La Bezole,47,0,619,619,13.2
11163,Gincla,47,0,516,516,11
25498,Rognon,47,0,108,108,2.3
25556,Tallans,47,0,108,108,2.3
30327,Tharaux,47,0,1908,1908,40.6
31477,Saint-Élix-Séglan,47,0,974,974,20.7
32342,Ricourt,47,0,866,866,18.4
34238,Saint-André-de-Buèges,47,0,876,876,18.6
51650,Voilemont,47,0,698,698,14.9
52519,Vesvres-sous-Chalancey,47,0,582,582,12.4
52536,Villiers-lès-Aprey,47,0,582,582,12.4
54095,Bratte,47,0,278,278,5.9
55048,Béthincourt,47,0,2913,2913,62
55333,Ménil-aux-Bois,47,0,693,693,14.7
55484,Septsarges,47,0,491,491,10.4
62143,Boffles,47,0,1015,1015,21.6
64531,Tabaille-Usquain,47,0,982,982,20.9
65178,Fréchède,47,0,1523,1523,32.4
70032,Attricourt,47,0,237,237,5
70287,Hurecourt,47,0,299,299,6.4
80794,Villecourt,47,0,896,896,19.1
80828,Woirel,47,0,65,65,1.4
83020,Le Bourguet,47,0,183,183,3.9
88007,Ameuvelle,47,0,365,365,7.8
88071,Bouzemont,47,0,675,675,14.4
88186,Frenelle-la-Petite,47,0,675,675,14.4
88220,Grignoncourt,47,0,365,365,7.8
88394,Romain-aux-Bois,47,0,365,365,7.8
7092,Freyssenet,46,0,153,153,3.3
8065,Bièvres,46,0,1629,1629,35.4
8120,Chevières,46,0,1113,1113,24.2
9232,Prades,46,2200,6625,8825,191.8
9279,Salsein,46,0,5574,5574,121.2
10087,Chaserey,46,0,856,856,18.6
10315,Rances,46,0,971,971,21.1
11176,Jonquières,46,0,623,623,13.5
14531,Rapilly,46,0,721,721,15.7
18060,Chaumont,46,0,737,737,16
21235,Duesme,46,0,767,767,16.7
21703,Villiers-en-Morvan,46,0,1419,1419,30.8
26163,Léoncel,46,0,2881,2881,62.6
26300,Saint-Dizier-en-Diois,46,0,2558,2558,55.6
2A357,Zérubia,46,0,1073,1073,23.3
2B255,Quercitello,46,0,213,213,4.6
2B267,Saliceto,46,0,173,173,3.8
32111,Courties,46,0,848,848,18.4
32232,Maravat,46,0,174,174,3.8
34099,Ferrières-les-Verreries,46,0,857,857,18.6
39157,Coiserette,46,0,169,169,3.7
39168,Courbette,46,0,1339,1339,29.1
51353,Marsangis,46,0,600,600,13
51368,Minaucourt-le-Mesnil-lès-Hurlus,46,0,683,683,14.8
51377,Montépreux,46,0,2338,2338,50.8
51659,Wargemoulin-Hurlus,46,0,683,683,14.8
52040,Bay-sur-Aube,46,0,570,570,12.4
52084,Busson,46,0,170,170,3.7
52116,Chatenay-Vaudin,46,0,211,211,4.6
52499,Vaillant,46,0,570,570,12.4
55082,Brocourt-en-Argonne,46,0,481,481,10.5
55107,Chaumont-devant-Damvillers,46,0,841,841,18.3
55168,Duzey,46,0,841,841,18.3
55247,Horville-en-Ornois,46,0,899,899,19.5
62791,Séricourt,46,0,994,994,21.6
65076,Bazus-Neste,46,0,137,137,3
65088,Betbèze,46,0,1490,1490,32.4
65154,Créchets,46,0,301,301,6.5
65214,Hachan,46,0,1490,1490,32.4
65261,Laran,46,0,1490,1490,32.4
65430,Soréac,46,0,292,292,6.3
66083,Fosse,46,0,1125,1125,24.5
76393,Longmesnil,46,0,869,869,18.9
77356,Passy-sur-Seine,46,1000,651,1651,35.9
2024,Arrancy,45,0,1719,1719,38.2
2534,Muscourt,45,0,121,121,2.7
7038,Borne,45,750,352,1102,24.5
7124,Lafarre,45,0,1288,1288,28.6
7144,Loubaresse,45,45,3138,3183,70.7
8215,Harricourt,45,0,1089,1089,24.2
9072,Calzan,45,0,1210,1210,26.9
9090,Cazaux,45,0,1210,1210,26.9
21264,Le Fête,45,0,1388,1388,30.8
21313,Gurgy-le-Château,45,0,751,751,16.7
21377,Marcellois,45,0,956,956,21.2
23265,La Villeneuve,45,0,591,591,13.1
24313,Orliac,45,100,77,177,3.9
25373,Le Mémont,45,0,756,756,16.8
31308,Luscan,45,0,431,431,9.6
32195,Larroque-Engalin,45,0,26,26,0.6
32230,Mansencôme,45,0,173,173,3.8
33064,Bossugan,45,0,314,314,7
39259,Grange-de-Vaivre,45,2000,436,2436,54.1
48054,Cubiérettes,45,1110,912,2022,44.9
48091,Marchastel,45,110,1663,1773,39.4
51126,La Chapelle-Felcourt,45,0,668,668,14.8
51213,Dommartin-sous-Hans,45,0,668,668,14.8
55115,Cierges-sous-Montfaucon,45,0,470,470,10.4
55188,Flassigny,45,0,1609,1609,35.8
55424,Remennecourt,45,0,999,999,22.2
58050,Challement,45,0,700,700,15.6
62494,Léchelle,45,0,224,224,5
64074,Aubous,45,0,705,705,15.7
65117,Cadeilhan-Trachère,45,0,2163,2163,48.1
65132,Castéra-Lanusse,45,0,286,286,6.4
65172,Estensan,45,0,2163,2163,48.1
66153,Prunet-et-Belpuig,45,0,61,61,1.4
66219,Urbanya,45,0,1348,1348,30
70089,Bourguignon-lès-Morey,45,0,136,136,3
70091,Bousseraucourt,45,0,136,136,3
70200,Dampvalley-Saint-Pancras,45,0,286,286,6.4
70450,La Rochelle,45,0,887,887,19.7
80139,Breuil,45,0,858,858,19.1
80158,Buverchy,45,0,858,858,19.1
80263,L'Échelle-Saint-Aurin,45,0,54,54,1.2
2773,Vauxtin,44,0,87,87,2
4142,Oppedette,44,0,116,116,2.6
8465,Vaux-lès-Rubigny,44,0,965,965,21.9
9068,Burret,44,0,1183,1183,26.9
9233,Pradettes,44,0,911,911,20.7
10266,Nogent-en-Othe,44,0,768,768,17.5
10388,Turgy,44,0,819,819,18.6
11047,Le Bousquet,44,0,483,483,11
11118,Dernacueillette,44,0,596,596,13.5
11227,Mayronnes,44,0,285,285,6.5
12009,Arnac-sur-Dourdou,44,0,1722,1722,39.1
16321,Saint-Georges,44,0,963,963,21.9
21104,Brémur-et-Vaurois,44,0,734,734,16.7
21119,Bussières,44,0,30,30,0.7
21221,Cussy-la-Colonne,44,0,669,669,15.2
26201,Montguers,44,0,2261,2261,51.4
2B245,Porri,44,0,204,204,4.6
31067,Bezins-Garraux,44,0,421,421,9.6
32145,Gée-Rivière,44,0,1377,1377,31.3
39077,Bretenières,44,550,261,811,18.4
42040,La Chamba,44,0,394,394,9
43027,Berbezit,44,160,401,561,12.8
46135,Labastide-du-Haut-Mont,44,0,1299,1299,29.5
51047,Belval-en-Argonne,44,0,653,653,14.8
52378,Paroy-sur-Saulx,44,0,163,163,3.7
55218,Gremilly,44,0,804,804,18.3
57763,Zommange,44,0,146,146,3.3
59147,Choisies,44,0,349,349,7.9
65082,Berbérust-Lias,44,0,420,420,9.5
65163,Escots,44,0,131,131,3
65325,Moumoulous,44,0,994,994,22.6
66010,Ayguatébia-Talau,44,0,0,0,0
70030,Arsans,44,0,222,222,5
70051,La Basse-Vaivre,44,0,280,280,6.4
80243,Domesmont,44,0,172,172,3.9
84128,Sivergues,44,0,897,897,20.4
87147,Saint-Gilles-les-Forêts,44,0,20,20,0.5
2829,Vuillery,43,0,85,85,2
7137,Lavillatte,43,0,336,336,7.8
8233,Imécourt,43,0,1040,1040,24.2
8334,Omicourt,43,0,943,943,21.9
9037,Barjac,43,0,5211,5211,121.2
10047,Blignicourt,43,0,908,908,21.1
11114,Cumiès,43,0,378,378,8.8
11338,Saint-Couat-du-Razès,43,0,566,566,13.2
17215,Lussac,43,0,508,508,11.8
21400,Le Meix,43,0,30,30,0.7
23119,Malleret,43,0,589,589,13.7
24024,Bardou,43,455,81,536,12.5
25487,Renédale,43,0,471,471,11
26091,Chauvac-Laux-Montaux,43,0,2210,2210,51.4
26161,Lemps,43,0,2210,2210,51.4
2B344,Verdèse,43,0,199,199,4.6
31222,Gouaux-de-Luchon,43,0,412,412,9.6
32056,Blanquefort,43,0,546,546,12.7
38551,Villard-Reymond,43,660,2446,3106,72.2
39248,Geraise,43,590,951,1541,35.8
51355,Massiges,43,0,638,638,14.8
55177,Érize-la-Petite,43,0,582,582,13.5
58290,Thaix,43,0,2218,2218,51.6
65348,Ourdis-Cotdoussan,43,0,411,411,9.6
66036,Canaveilles,43,0,1288,1288,30
66040,Casefabre,43,0,58,58,1.3
66201,Tarerach,43,0,1288,1288,30
88242,Houéville,43,0,480,480,11.2
88459,Soncourt,43,0,480,480,11.2
89413,Thorey,43,550,100,650,15.1
89422,Trichey,43,50,100,150,3.5
2660,Rouvroy-sur-Serre,42,0,463,463,11
2715,Serval,42,0,83,83,2
9335,Villeneuve,42,0,5090,5090,121.2
11365,Saint-Sernin,42,585,124,709,16.9
21526,Rochefort-sur-Brévon,42,0,701,701,16.7
25045,Battenans-les-Mines,42,0,2094,2094,49.9
2B244,Popolasca,42,0,158,158,3.8
2B273,Scata,42,0,194,194,4.6
31172,Esparron,42,0,870,870,20.7
31508,Saint-Paul-d'Oueil,42,0,402,402,9.6
31590,Binos,42,0,402,402,9.6
32422,Scieurac-et-Flourès,42,0,774,774,18.4
32431,Sérempuy,42,0,158,158,3.8
52463,Saudron,42,0,156,156,3.7
54285,Juvrecourt,42,0,630,630,15
55128,Courcelles-sur-Aire,42,0,569,569,13.5
55400,Parfondrupt,42,0,759,759,18.1
58054,Champlin,42,0,653,653,15.5
59171,Dehéries,42,0,289,289,6.9
61088,Champ-Haut,42,0,304,304,7.2
65061,Barbachen,42,0,949,949,22.6
65166,Espèche,42,0,125,125,3
65215,Hagedet,42,0,949,949,22.6
66035,Campoussy,42,0,1027,1027,24.5
66090,Jujols,42,0,1258,1258,30
88316,Morville,42,0,15,15,0.4
2688,Saint-Pierre-lès-Franqueville,41,0,731,731,17.8
9033,Bagert,41,0,4968,4968,121.2
9064,Bouan,41,2250,5905,8155,198.9
9096,Château-Verdun,41,0,5905,5905,144
10443,Vougrey,41,0,763,763,18.6
16356,Saint-Sulpice-de-Ruffec,41,200,897,1097,26.8
19167,Confolent-Port-Dieu,41,0,562,562,13.7
21329,Juilly,41,0,871,871,21.2
25483,Reculfoz,41,0,2442,2442,59.6
26363,Valouse,41,0,2107,2107,51.4
2B081,Castiglione,41,0,154,154,3.8
31221,Gouaux-de-Larboust,41,0,392,392,9.6
31548,Signac,41,0,392,392,9.6
32003,Antras,41,0,1445,1445,35.2
33232,Lartigue,41,0,14,14,0.3
34034,Boisset,41,0,155,155,3.8
38414,Sainte-Luce,41,0,429,429,10.5
39380,Nancuise,41,350,1193,1543,37.6
47039,Boussès,41,0,692,692,16.9
51497,Saint-Lumier-la-Populeuse,41,0,241,241,5.9
52234,Hâcourt,41,0,631,631,15.4
54424,Phlin,41,0,243,243,5.9
54457,Remoncourt,41,0,145,145,3.5
55032,Baudrémont,41,0,555,555,13.5
55129,Courouvre,41,0,555,555,13.5
65039,Aspin-Aure,41,0,1971,1971,48.1
65053,Aveux,41,0,268,268,6.5
65421,Sère-Lanso,41,0,392,392,9.6
70069,Betoncourt-Saint-Pancras,41,0,261,261,6.4
70392,Oigney,41,0,124,124,3
80297,Étréjust,41,0,57,57,1.4
88097,Chauffecourt,41,0,589,589,14.4
88179,Fouchécourt,41,0,319,319,7.8
89191,Gland,41,300,95,395,9.6
89225,Lichères-sur-Yonne,41,300,89,389,9.5
2499,Montbavin,40,0,40,40,1
2689,Saint-Pierremont,40,0,202,202,5
8501,Williers,40,0,1416,1416,35.4
9069,Buzan,40,0,4847,4847,121.2
9310,Thouars-sur-Arize,40,0,711,711,17.8
10163,Fuligny,40,0,238,238,6
11250,Montjoi,40,0,542,542,13.6
11335,Sainte-Colombe-sur-Guette,40,0,439,439,11
19189,Saint-Bonnet-les-Tours-de-Merle,40,0,119,119,3
21466,Oigny,40,0,667,667,16.7
25344,Longevelle-lès-Russey,40,0,1103,1103,27.6
25430,Ollans,40,0,1994,1994,49.8
25433,Orgeans-Blanchefontaine,40,0,279,279,7
26372,Vers-sur-Méouge,40,0,2055,2055,51.4
2B206,Penta-Acquatella,40,0,185,185,4.6
31223,Goudex,40,0,829,829,20.7
39236,Francheville,40,0,1063,1063,26.6
39239,La Frasnée,40,0,1164,1164,29.1
51639,La Ville-sous-Orbais,40,0,58,58,1.4
52328,Montcharvot,40,0,789,789,19.7
52367,Ormoy-lès-Sexfontaines,40,0,4394,4394,109.8
54488,Saint-Sauveur,40,0,142,142,3.6
55448,Rupt-devant-Saint-Mihiel,40,0,541,541,13.5
55574,Vouthon-Bas,40,0,782,782,19.6
57539,Pévange,40,0,132,132,3.3
58018,Authiou,40,0,622,622,15.6
58284,Talon,40,0,622,622,15.6
63303,Roche-Charles-la-Mayrand,40,0,260,260,6.5
65014,Antichan,40,0,262,262,6.6
65297,Mansan,40,0,904,904,22.6
65368,Pouy,40,0,1296,1296,32.4
70264,Georfans,40,0,0,0,0
80433,Herly,40,0,48,48,1.2
81085,Lacapelle-Escroux,40,0,708,708,17.7
82009,Balignac,40,0,938,938,23.4
2222,Courbes,39,0,701,701,18
3302,Veauce,39,0,798,798,20.5
4228,Valavoire,39,0,1163,1163,29.8
5033,Chanousse,39,0,1163,1163,29.8
5091,Moydans,39,0,1163,1163,29.8
8056,Beffu-et-le-Morthomme,39,0,944,944,24.2
8430,Stonne,39,0,1381,1381,35.4
9031,Axiat,39,900,5617,6517,167.1
26222,Orcinas,39,0,1360,1360,34.9
34303,Sorbs,39,0,438,438,11.2
39140,Chêne-Sec,39,0,1037,1037,26.6
42045,La Chambonie,39,0,349,349,8.9
43250,Vals-le-Chastel,39,460,355,815,20.9
52101,Champigneulles-en-Bassigny,39,0,600,600,15.4
52174,Doncourt-sur-Meuse,39,0,600,600,15.4
52183,Ecot-la-Combe,39,0,600,600,15.4
54412,Othe,39,0,495,495,12.7
54443,Raon-lès-Leau,39,0,379,379,9.7
55038,Beaulieu-en-Argonne,39,0,528,528,13.5
65064,Bareilles,39,0,1875,1875,48.1
70231,Ferrières-lès-Ray,39,0,200,200,5.1
70411,La Pisseure,39,0,248,248,6.4
71140,Collonge-la-Madeleine,39,0,873,873,22.4
2402,Lanchy,38,0,344,344,9.1
4187,Saint-Lions,38,0,1344,1344,35.4
6087,Les Mujouls,38,0,970,970,25.5
8031,Aure,38,0,919,919,24.2
9143,Illier-et-Laramade,38,0,5473,5473,144
21155,Chaudenay-la-Ville,38,0,578,578,15.2
25501,Rondefontaine,38,0,2263,2263,59.6
26371,Véronne,38,0,0,0,0
31432,Portet-de-Luchon,38,0,364,364,9.6
31498,Saint-Loup-en-Comminges,38,0,787,787,20.7
32275,Monpardiac,38,0,701,701,18.4
50430,Reigneville-Bocage,38,0,1195,1195,31.4
54561,Vennezey,38,0,157,157,4.1
55044,Belrain,38,0,514,514,13.5
55173,Épiez-sur-Meuse,38,0,153,153,4
55210,Gimécourt,38,0,514,514,13.5
65066,Barrancoueu,38,0,1827,1827,48.1
65175,Ferrère,38,0,249,249,6.6
65186,Gaudent,38,0,249,249,6.6
65458,Uz,38,0,1556,1556,40.9
70352,La Montagne,38,0,437,437,11.5
80085,Bernâtre,38,0,148,148,3.9
80381,Gorges,38,0,148,148,3.9
2345,Gibercourt,37,0,0,0,0
8061,La Berlière,37,0,895,895,24.2
9178,Malegoude,37,0,766,766,20.7
9226,Pech,37,2950,5329,8279,223.8
11245,Montgaillard,37,0,57,57,1.5
11247,Monthaut,37,0,487,487,13.2
21141,Champrenault,37,0,786,786,21.2
21144,Charencey,37,0,0,0,0
21197,Corpoyer-la-Chapelle,37,0,0,0,0
26066,Le Chaffal,37,0,2317,2317,62.6
2B067,Carpineto,37,0,171,171,4.6
2B222,Pie-d'Orezza,37,0,171,171,4.6
2B364,Zuani,37,0,282,282,7.6
39111,Charnod,37,0,1077,1077,29.1
43208,Sainte-Marguerite,37,700,337,1037,28
51341,Malmy,37,0,549,549,14.8
51519,Saint-Thomas-en-Argonne,37,0,549,549,14.8
52326,Mirbel,37,0,4064,4064,109.8
54074,Bienville-la-Petite,37,0,555,555,15
55160,Dompierre-aux-Bois,37,0,545,545,14.7
55183,Étraye,37,0,676,676,18.3
57034,Aspach,37,0,241,241,6.5
57500,Neufmoulins,37,0,241,241,6.5
57520,Obreck,37,0,122,122,3.3
65210,Grust,37,0,1515,1515,40.9
65266,Lassales,37,0,1199,1199,32.4
66139,Pézilla-de-Conflent,37,0,905,905,24.5
70151,Chevigney,37,0,187,187,5.1
70571,Visoncourt,37,0,137,137,3.7
78606,Le Tartre-Gaudran,37,0,371,371,10
81282,Senaux,37,0,655,655,17.7
82071,Goas,37,0,867,867,23.4
89248,Menades,37,0,80,80,2.2
8197,Grandham,36,0,871,871,24.2
9134,Gestiès,36,0,5185,5185,144
10026,Bailly-le-Franc,36,0,760,760,21.1
10160,Fravaux,36,0,0,0,0
11100,Corbières,36,0,395,395,11
11265,Niort-de-Sault,36,0,395,395,11
15105,Leyvaux,36,330,8,338,9.4
21145,Charigny,36,0,764,764,21.2
21552,Saint-Hélier,36,0,764,764,21.2
21675,Vianges,36,0,1110,1110,30.8
24176,Faurilles,36,850,67,917,25.5
24570,Verdon,36,160,131,291,8.1
26378,Volvent,36,550,2002,2552,70.9
31348,Moncaup,36,0,1935,1935,53.8
32350,Roquepine,36,0,138,138,3.8
38116,Cognet,36,0,377,377,10.5
39532,Thoissia,36,60,549,609,16.9
48149,Sainte-Eulalie,36,0,370,370,10.3
51138,Châtrices,36,0,535,535,14.9
55192,Fontaines-Saint-Clair,36,0,1302,1302,36.2
65071,Batsère,36,0,108,108,3
65278,Lomné,36,0,108,108,3
80697,Saint-Acheul,36,0,140,140,3.9
88093,Châtas,36,0,350,350,9.7
2266,Dolignon,35,0,386,386,11
9325,Vaychis,35,600,5041,5641,161.2
10183,Juvanzé,35,0,739,739,21.1
10217,Maison-des-Champs,35,0,208,208,5.9
12275,Tauriac-de-Camarès,35,0,1370,1370,39.1
18277,Verneuil,35,226,326,552,15.8
19268,Toy-Viam,35,0,609,609,17.4
21039,Avelanges,35,0,498,498,14.2
21100,Brain,35,0,743,743,21.2
21168,Chevannay,35,0,743,743,21.2
24546,Temple-Laguyon,35,500,612,1112,31.8
26359,Vachères-en-Quint,35,0,1946,1946,55.6
2B082,Castineta,35,0,132,132,3.8
2B241,Poggio-Marinaccio,35,0,162,162,4.6
2B243,Polveroso,35,0,162,162,4.6
31312,Mailholas,35,0,60,60,1.7
52195,Farincourt,35,0,690,690,19.7
55005,Amanty,35,0,684,684,19.5
55018,Autréville-Saint-Lambert,35,0,1266,1266,36.2
65317,Mont,35,0,1683,1683,48.1
65351,Ousté,35,0,334,334,9.5
65450,Tramezaïgues,35,0,1683,1683,48.1
66102,Mantet,35,0,1048,1048,29.9
66220,Valcebollère,35,0,0,0,0
88230,Hardancourt,35,0,175,175,5
89126,Courtoin,35,230,124,354,10.1
2087,Bieuxy,34,0,33,33,1
2278,Éparcy,34,0,667,667,19.6
8332,Oches,34,0,823,823,24.2
9330,Vernaux,34,5500,4897,10397,305.8
11204,Lignairolles,34,0,448,448,13.2
11440,Villetritouls,34,0,221,221,6.5
18071,Contres,34,0,317,317,9.3
21049,Barjon,34,0,24,24,0.7
21097,Boussey,34,0,722,722,21.2
21123,Buxerolles,34,0,567,567,16.7
21147,Charny,34,0,722,722,21.2
26296,Saint-Benoit-en-Diois,34,677,924,1601,47.1
2A158,Mela,34,0,793,793,23.3
2B171,Muracciole,34,0,587,587,17.3
2B291,Stazzona,34,0,157,157,4.6
31068,Billière,34,0,325,325,9.6
32058,Blousson-Sérian,34,0,627,627,18.4
39568,Villerserine,34,100,752,852,25.1
48167,Saint-Laurent-de-Veyrès,34,400,1256,1656,48.7
50571,Sébeville,34,0,184,184,5.4
55222,Gussainville,34,0,614,614,18.1
57653,Silly-en-Saulnois,34,0,1302,1302,38.3
65162,Esconnets,34,0,102,102,3
65171,Estarvielle,34,0,1635,1635,48.1
65478,Viscos,34,0,1392,1392,40.9
66221,Valmanya,34,0,1018,1018,29.9
70396,Oricourt,34,0,11,11,0.3
81184,Montrosier,34,0,481,481,14.1
88038,Battexey,34,0,489,489,14.4
88311,Montmotier,34,0,855,855,25.1
5155,Saint-Pierre-Avez,33,0,984,984,29.8
8161,Exermont,33,0,798,798,24.2
8471,Verrières,33,0,798,798,24.2
10044,Bétignicourt,33,0,697,697,21.1
11020,Auriac,33,0,447,447,13.5
11096,Comus,33,0,363,363,11
15048,Chazelles,33,416,7,423,12.8
21118,Busserotte-et-Montenaille,33,0,23,23,0.7
21662,Velogny,33,0,701,701,21.2
25329,Laval-le-Prieuré,33,0,554,554,16.8
25472,Puessans,33,0,76,76,2.3
31040,Bachos,33,0,316,316,9.6
31290,Lège,33,0,316,316,9.6
39136,Chemenot,33,0,877,877,26.6
39143,Chevrotaine,33,0,960,960,29.1
39359,Montmarlon,33,1000,730,1730,52.4
51452,Rapsécourt,33,0,490,490,14.8
52373,Ozières,33,0,508,508,15.4
52443,Sailly,33,0,122,122,3.7
52474,Silvarouvres,33,0,181,181,5.5
55555,Ville-devant-Belrain,33,0,447,447,13.5
58206,Parigny-la-Rose,33,0,690,690,20.9
60697,Vrocourt,33,0,162,162,4.9
62066,Avondance,33,0,1953,1953,59.2
65140,Cazaux-Debat,33,0,1587,1587,48.1
65199,Germ,33,0,1587,1587,48.1
65381,Sabarros,33,0,99,99,3
72227,Panon,33,0,612,612,18.5
80027,Armancourt,33,0,40,40,1.2
95141,Charmont,33,0,209,209,6.3
9020,Artigues,32,0,4609,4609,144
10072,La Chaise,32,0,190,190,5.9
10337,Saint-Christophe-Dodinicourt,32,0,676,676,21.1
11406,Véraza,32,0,421,421,13.2
18068,Cogny,32,300,298,598,18.7
24384,Saint-Cassien,32,2750,116,2866,89.6
2B116,Focicchia,32,0,120,120,3.8
2B227,Pietricaggio,32,0,230,230,7.2
31019,Artigue,32,0,306,306,9.6
31125,Cathervielle,32,0,306,306,9.6
34253,Saint-Félix-de-l'Héras,32,0,359,359,11.2
38008,Ambel,32,0,335,335,10.5
38428,Saint-Michel-en-Beaumont,32,0,335,335,10.5
39132,La Chaux-en-Bresse,32,200,851,1051,32.8
39221,La Favière,32,250,324,574,17.9
41121,La Madeleine-Villefrouin,32,0,96,96,3
43068,Chazelles,32,0,291,291,9.1
52505,Vaudrecourt,32,0,492,492,15.4
54233,Gondrexon,32,0,114,114,3.6
62708,Riencourt-lès-Bapaume,32,0,159,159,5
70135,Charmes-Saint-Valbert,32,0,97,97,3
70269,Girefontaine,32,0,203,203,6.3
70440,Recologne,32,0,164,164,5.1
80026,Arguel,32,0,44,44,1.4
5182,Villar-Loubière,31,0,2063,2063,66.5
8245,Lançon,31,0,750,750,24.2
11160,Galinagues,31,0,341,341,11
11271,Palairac,31,0,420,420,13.5
15067,Le Fau,31,0,513,513,16.5
15132,Montgreleix,31,5725,226,5951,192
21602,Semond,31,0,517,517,16.7
23034,Brousse,31,0,407,407,13.1
26062,Brette,31,0,1724,1724,55.6
26076,Charens,31,880,1724,2604,84
26090,La Chaudière,31,0,843,843,27.2
26318,Saint-May,31,0,1593,1593,51.4
2B256,Rapaggio,31,0,144,144,4.6
30195,Peyrolles,31,0,1551,1551,50
30213,Revens,31,0,1551,1551,50
31447,Razecueillé,31,0,1666,1666,53.7
52222,Gillaumé,31,0,115,115,3.7
57737,Vulmont,31,0,1187,1187,38.3
65179,Fréchendets,31,0,93,93,3
66191,Sansa,31,0,0,0,0
66197,Souanyas,31,0,928,928,29.9
68190,Lucelle,31,0,832,832,26.8
71308,Montceaux-Ragny,31,0,376,376,12.1
73072,Champ-Laurent,31,0,554,554,17.9
76512,Puisenval,31,0,229,229,7.4
88453,Seraumont,31,0,346,346,11.2
2507,Montgru-Saint-Hilaire,30,0,100,100,3.3
5035,Châteauneuf-d'Oze,30,0,1123,1123,37.4
9053,Bestiac,30,6000,4320,10320,344
9260,Sainte-Foi,30,0,621,621,20.7
11057,Cahuzac,30,0,89,89,3
11094,Clermont-sur-Lauquet,30,0,395,395,13.2
11177,Joucou,30,0,330,330,11
11230,Mérial,30,0,330,330,11
11354,Saint-Martin-des-Puits,30,0,406,406,13.5
11375,Seignalens,30,0,395,395,13.2
23019,Beissat,30,0,411,411,13.7
31335,Mayrègne,30,0,287,287,9.6
45143,Feins-en-Gâtinais,30,0,349,349,11.6
52344,Mouilleron,30,0,372,372,12.4
52489,Thol-lès-Millières,30,0,462,462,15.4
55506,Thillombois,30,0,406,406,13.5
58237,Saint-Didier,30,0,467,467,15.6
62389,Grincourt-lès-Pas,30,0,249,249,8.3
65109,Bramevaque,30,0,196,196,6.5
65118,Caharet,30,0,190,190,6.3
65136,Caubous,30,0,972,972,32.4
65255,Lançon,30,0,1442,1442,48.1
67050,Blancherupt,30,850,2171,3021,100.7
77304,Montenils,30,0,494,494,16.5
80666,Remaisnil,30,0,117,117,3.9
80771,Ugny-l'Équipée,30,0,572,572,19.1
84060,Lagarde-d'Apt,30,0,612,612,20.4
88060,Blémerey,30,0,431,431,14.4
10257,Morembert,29,0,25,25,0.9
11277,Pécharic-et-le-Py,29,0,86,86,3
21262,Faverolles-lès-Lucey,29,0,484,484,16.7
21672,Vesvres,29,0,616,616,21.2
23055,Châtelard,29,0,381,381,13.1
2A064,Cardo-Torgia,29,0,22,22,0.8
2B003,Aiti,29,0,109,109,3.8
31064,Benque-Dessous-et-Dessus,29,0,278,278,9.6
51489,Saint-Jean-devant-Possesse,29,0,170,170,5.9
52012,Annonville,29,0,107,107,3.7
52214,La Genevroye,29,0,3185,3185,109.8
52385,Perrusse,29,0,133,133,4.6
52493,Tornay,29,0,572,572,19.7
52540,Vitry-en-Montagne,29,0,359,359,12.4
55270,Lahayville,29,0,345,345,11.9
61085,Le Champ-de-la-Pierre,29,0,130,130,4.5
61225,Lignères,29,0,210,210,7.2
65204,Gonez,29,0,184,184,6.3
65336,Organ,29,0,939,939,32.4
70496,Tartécourt,29,0,88,88,3
2380,Hinacourt,28,0,0,0,0
9012,Appy,28,780,4032,4812,171.9
9172,Loubaut,28,0,498,498,17.8
9237,Le Puch,28,0,4032,4032,144
9263,Saint-Jean-du-Castillonnais,28,0,3393,3393,121.2
9297,Sor,28,0,3393,3393,121.2
10137,Engente,28,0,0,0,0
10411,La Ville-aux-Bois,28,0,167,167,6
11093,Le Clat,28,0,308,308,11
11224,Massac,28,0,379,379,13.5
11374,Salza,28,0,379,379,13.5
21129,Chambain,28,0,467,467,16.7
21410,Meulson,28,0,467,467,16.7
25401,Montivernage,28,0,1396,1396,49.9
25570,Tressandans,28,0,9,9,0.3
26255,Les Prés,28,465,1557,2022,72.2
2B078,Castellare-di-Mercurio,28,0,105,105,3.8
2B339,Vallica,28,0,393,393,14
31195,Francazal,28,0,1505,1505,53.8
51374,Mondement-Montgivroux,28,0,365,365,13
54529,Tramont-Émy,28,0,928,928,33.1
55162,Domremy-la-Canne,28,0,512,512,18.3
55295,Lisle-en-Barrois,28,0,379,379,13.5
60354,Laverrière,28,0,137,137,4.9
66232,Vira,28,0,685,685,24.5
89207,Jouancy,28,980,135,1115,39.8
8059,Belval-Bois-des-Dames,27,0,653,653,24.2
9320,Urs,27,2280,3888,6168,228.4
11402,Valmigère,27,453,355,808,29.9
21052,Beaulieu,27,0,450,450,16.7
21136,Champagny,27,0,0,0,0
26199,Montferrand-la-Fare,27,0,1387,1387,51.4
2B013,Alzi,27,0,102,102,3.8
39204,Dramelay,27,0,786,786,29.1
39586,Aresches,27,60,597,657,24.3
52005,Aizanville,27,0,148,148,5.5
52549,Vroncourt-la-Côte,27,0,415,415,15.4
54166,Dommartin-la-Chaussée,27,0,161,161,6
55436,Les Roises,27,0,528,528,19.6
58202,Ougny,27,0,1393,1393,51.6
66128,Oreilla,27,0,809,809,30
70144,Chauvirey-le-Vieil,27,0,82,82,3
84110,Saint-Léger-du-Ventoux,27,0,32,32,1.2
88107,Clérey-la-Côte,27,0,302,302,11.2
88518,Viviers-lès-Offroicourt,27,0,10,10,0.4
2251,Cuiry-lès-Iviers,26,0,286,286,11
9195,Monesple,26,0,462,462,17.8
10078,Champ-sur-Barse,26,0,155,155,6
11395,Trassanel,26,0,169,169,6.5
21279,Fontaines-les-Sèches,26,0,506,506,19.5
21312,Gurgy-la-Ville,26,0,434,434,16.7
26152,Jonchères,26,50,1446,1496,57.5
2B338,Valle-d'Orezza,26,0,120,120,4.6
31369,Mont-de-Galié,26,0,249,249,9.6
38549,Villard-Notre-Dame,26,1500,1479,2979,114.6
43252,Varennes-Saint-Honorat,26,0,237,237,9.1
52002,Aigremont,26,0,513,513,19.7
52085,Buxières-lès-Clefmont,26,0,119,119,4.6
61272,Le Ménil-Vicomte,26,0,188,188,7.2
65068,Barthe,26,0,842,842,32.4
65402,Samuran,26,0,170,170,6.5
66209,Thuès-Entre-Valls,26,0,779,779,30
71226,Grevilly,26,0,605,605,23.3
80197,Cizancourt,26,0,496,496,19.1
1019,Armix,25,0,279,279,11.2
2044,Bancigny,25,0,446,446,17.8
4050,Châteaufort,25,1250,745,1995,79.8
26123,Establet,25,0,1390,1390,55.6
26209,Montréal-les-Sources,25,0,1285,1285,51.4
26227,Pelonne,25,0,1285,1285,51.4
26254,Pradelle,25,746,1390,2136,85.4
26267,Rioms,25,0,1285,1285,51.4
26283,Rottier,25,0,1390,1390,55.6
28315,Revercourt,25,0,33,33,1.3
2B005,Alando,25,0,94,94,3.8
2B068,Carticasi,25,0,94,94,3.8
2B156,Mausoléo,25,0,351,351,14
2B157,Mazzola,25,0,94,94,3.8
2B194,Ortale,25,0,179,179,7.2
2B202,Parata,25,0,116,116,4.6
30074,Causse-Bégon,25,0,1251,1251,50
34072,Celles,25,0,281,281,11.2
50374,Neuville-en-Beaumont,25,0,786,786,31.4
52159,Cuves,25,0,2746,2746,109.8
52342,Morionvilliers,25,0,93,93,3.7
52437,Rouelles,25,0,310,310,12.4
57657,Sotzeling,25,0,83,83,3.3
65157,Ens,25,0,1202,1202,48.1
65167,Espieilh,25,0,75,75,3
70070,Betoncourt-sur-Mance,25,0,76,76,3
5051,Étoile-Saint-Cyrice,24,0,715,715,29.8
8325,Noirval,24,0,581,581,24.2
9133,Génat,24,0,93,93,3.9
9222,Orus,24,0,3456,3456,144
9304,Suzan,24,0,2908,2908,121.2
11031,Belfort-sur-Rebenty,24,0,264,264,11
11358,Saint-Martin-Lys,24,0,264,264,11
15247,Valjouze,24,0,5,5,0.2
21157,Chaugey,24,0,400,400,16.7
25161,Consolation-Maisonnettes,24,0,284,284,11.8
26075,La Charce,24,0,1233,1233,51.4
26286,Roussieux,24,0,1233,1233,51.4
2B164,Monacia-d'Orezza,24,0,111,111,4.6
43009,Arlet,24,375,219,594,24.8
52503,Valleroy,24,0,473,473,19.7
55311,Maizeray,24,0,311,311,13
76274,La Fontelaye,24,0,194,194,8.1
88265,Lemmecourt,24,0,268,268,11.2
88374,Rapey,24,0,345,345,14.4
88493,Varmonzey,24,0,345,345,14.4
2609,Ployart-et-Vaurseine,23,0,165,165,7.2
10105,Courcelles-sur-Voire,23,0,486,486,21.1
11223,Mas-des-Cours,23,0,149,149,6.5
11229,Mazuby,23,0,253,253,11
11414,Villar-en-Val,23,0,149,149,6.5
21694,Villeferry,23,0,488,488,21.2
26012,Arnayon,23,0,1279,1279,55.6
2B015,Ampriani,23,0,175,175,7.6
34231,Romiguières,23,0,258,258,11.2
50353,Le Mont-Saint-Michel,23,0,566,566,24.6
51034,Bannay,23,0,33,33,1.4
55103,Charpentry,23,0,240,240,10.4
55536,Vauquois,23,0,240,240,10.4
65034,Arrodets,23,0,69,69,3
65203,Gez-ez-Angles,23,0,220,220,9.6
65208,Grailhen,23,0,1106,1106,48.1
66157,Railleu,23,0,0,0,0
89049,Bois-d'Arcy,23,450,50,500,21.7
9083,Castéras,22,0,391,391,17.8
10273,Ortillon,22,0,19,19,0.9
11219,Marsa,22,0,242,242,11
11391,La Tourette-Cabardès,22,0,284,284,12.9
25402,Montjoie-le-Château,22,0,153,153,7
26130,Eyroles,22,0,1130,1130,51.4
26228,Pennes-le-Sec,22,1900,1223,3123,142
26242,Le Poët-en-Percip,22,0,1130,1130,51.4
26266,Rimon-et-Savel,22,500,598,1098,49.9
26351,Les Tonils,22,0,767,767,34.9
2B052,Campana,22,0,102,102,4.6
31015,Argut-Dessous,22,0,211,211,9.6
31465,Saccourvielle,22,0,211,211,9.6
39585,Vulvoz,22,0,81,81,3.7
43260,Le Vernet,22,170,915,1085,49.3
52137,Colmier-le-Bas,22,0,272,272,12.4
55140,Cunel,22,0,796,796,36.2
62605,Neulette,22,0,348,348,15.8
65102,Bouilh-Devant,22,0,497,497,22.6
65364,Pintac,22,0,497,497,22.6
70471,Sainte-Reine,22,0,111,111,5
2B137,Lano,21,0,79,79,3.8
39428,Plénisette,21,250,213,463,22
51280,Gratreuil,21,0,312,312,14.9
55344,Montbras,21,0,85,85,4
65359,Peyriguère,21,0,133,133,6.3
66047,Caudiès-de-Conflent,21,0,0,0,0
83022,Brenon,21,0,82,82,3.9
9311,Tignac,20,400,2880,3280,164
25533,Saraz,20,0,0,0,0
26147,Gumiane,20,0,1112,1112,55.6
31242,Jurvielle,20,0,191,191,9.6
31549,Sode,20,0,191,191,9.6
38031,Beaufin,20,0,209,209,10.4
55033,Baulny,20,0,209,209,10.4
2129,Bruys,19,0,37,37,1.9
9156,Larnat,19,3750,2736,6486,341.4
11062,Campagna-de-Sault,19,0,209,209,11
25072,Bonnal,19,0,6,6,0.3
26374,Villebois-les-Pins,19,0,566,566,29.8
2B053,Campi,19,0,145,145,7.6
2B216,Piazzali,19,0,136,136,7.2
65469,Viey,19,0,778,778,40.9
71125,Chérizet,19,0,132,132,6.9
9152,Lapège,18,0,69,69,3.8
26375,Villefranche-le-Château,18,0,925,925,51.4
2B214,Piano,18,0,83,83,4.6
2B234,Piobetta,18,0,129,129,7.2
54516,They-sous-Vaudemont,18,0,0,0,0
65443,Thuy,18,0,114,114,6.3
9197,Montaillou,17,0,2448,2448,144
21303,Les Goulles,17,0,284,284,16.7
26017,Aucelon,17,0,945,945,55.6
28268,Morainville,17,0,99,99,5.8
2B221,Piedipartino,17,0,79,79,4.6
50587,Taillepied,17,236,535,771,45.4
52219,Germisay,17,0,63,63,3.7
52546,Voncourt,17,0,335,335,19.7
63169,La Godivelle,17,0,124,124,7.3
65134,Casterets,17,0,551,551,32.4
76428,Le Mesnil-Durdent,17,0,110,110,6.5
2735,Tannières,16,0,32,32,2
21402,Menesble,16,0,267,267,16.7
25573,Urtière,16,0,111,111,6.9
2B321,Tarrano,16,0,115,115,7.2
38286,Oulles,16,200,910,1110,69.4
39343,Monnetay,16,1080,466,1546,96.6
52179,Doulevant-le-Petit,16,0,145,145,9.1
65180,Fréchet-Aure,16,0,769,769,48.1
66086,Glorianes,16,0,22,22,1.4
70437,Ranzevelle,16,0,48,48,3
21055,Beaunotte,15,0,250,250,16.7
51255,Fontaine-en-Dormois,15,0,223,223,14.9
57292,Hannocourt,15,0,50,50,3.3
60283,Gouy-les-Groseillers,15,0,338,338,22.5
4009,Archail,14,0,587,587,41.9
9088,Caychax,14,400,2016,2416,172.6
9162,Lercoul,14,3200,2016,5216,372.6
11389,Terroles,14,560,184,744,53.1
31129,Cazarilh-Laspènes,14,0,134,134,9.6
38241,Monestier-d'Ambel,14,0,147,147,10.5
62396,Guinecourt,14,0,302,302,21.6
65309,Mazouau,14,0,42,42,3
65349,Ourdon,14,0,134,134,9.6
11135,La Fajolle,13,0,143,143,11
18202,Saint-Céols,13,0,99,99,7.6
31081,Bourg-d'Oueil,13,0,124,124,9.5
55055,Blanzée,13,0,235,235,18.1
58169,Moissy-Moulinot,13,0,202,202,15.5
65038,Artigues,13,0,124,124,9.5
65379,Ris,13,0,625,625,48.1
21471,Orret,12,0,200,200,16.7
26150,Izon-la-Bruisse,12,0,617,617,51.4
52157,Curmont,12,0,1318,1318,109.8
65023,Ardengost,12,0,577,577,48.1
72214,Nauvay,12,0,223,223,18.6
5094,Nossage-et-Bénévent,11,0,328,328,29.8
8300,Le Mont-Dieu,11,0,0,0,0
11082,Caunette-sur-Lauquet,11,0,145,145,13.2
31046,Baren,11,0,105,105,9.5
31146,Cirès,11,0,105,105,9.5
52004,Aingoulaincourt,11,0,41,41,3.7
57682,Turquestein-Blancrupt,11,0,72,72,6.5
2B106,Érone,10,0,38,38,3.8
4191,Saint-Martin-lès-Seyne,9,0,377,377,41.9
25130,Châteauvieux-les-Fossés,9,0,66,66,7.3
57470,Molring,9,0,30,30,3.3
80528,Méréaucourt,9,0,12,12,1.3
26018,Aulan,8,0,411,411,51.4
31559,Trébons-de-Luchon,8,0,77,77,9.6
39324,Mérona,8,500,233,733,91.6
55394,Ornes,8,0,496,496,62
83147,Vérignon,8,0,31,31,3.9
5066,La Haute-Beaume,7,0,262,262,37.4
26245,Pommerol,7,0,360,360,51.4
80270,Épécamps,7,0,27,27,3.9
9287,Senconac,6,150,0,150,25
52109,Charmes-en-l'Angle,6,0,22,22,3.7
4107,Majastres,5,0,210,210,42
11147,Fontanès-de-Sault,5,0,55,55,11
88288,Maroncourt,5,0,72,72,14.4
26030,La Bâtie-des-Fonds,4,400,222,622,155.5
31127,Caubous,3,0,29,29,9.7
51470,Rouvroy-Ripont,3,0,45,45,15
26274,Rochefourchat,2,0,111,111,55.5
54310,Leménil-Mitry,2,0,0,0,0
55039,Beaumont-en-Verdunois,0,0,0,0,
55050,Bezonvaux,0,0,0,0,
55139,Cumières-le-Mort-Homme,0,0,0,0,
55189,Fleury-devant-Douaumont,0,0,0,0,
55239,Haumont-près-Samogneux,0,0,0,0,
55307,Louvemont-Côte-du-Poivre,0,0,0,0,
